zip,tot_pop,tot_pop_his,tot_pop_not_his,tot_pop_wht,tot_pop_blk,tot_pop_ntv,tot_pop_asn,tot_pop_isl,tot_pop_otr
601,17242,17185,57,37,1,0,0,0,9
602,37548,37278,270,213,10,3,10,0,13
603,49804,48996,808,584,80,5,49,1,29
606,5009,4974,35,26,1,0,2,0,1
610,25731,25489,242,179,19,0,5,4,15
611,1671,1654,17,12,0,0,2,0,2
612,62425,61908,517,374,46,0,38,0,38
616,9828,9786,42,27,7,0,0,0,5
617,22541,22430,111,70,8,12,3,0,11
622,7838,7702,136,110,16,0,2,0,3
623,39320,38887,433,317,25,3,32,0,36
624,21709,21598,111,69,20,0,8,0,10
627,32873,32570,303,250,8,3,5,0,21
631,1414,1407,7,4,0,0,0,0,2
636,555,545,10,9,1,0,0,0,0
637,23124,22996,128,92,11,1,4,0,11
638,18109,18004,105,60,5,3,14,0,18
641,24292,24113,179,147,8,2,9,3,7
646,36272,35056,1216,926,67,4,88,2,37
647,4611,4574,37,30,2,0,0,0,4
650,13637,13566,71,45,7,0,4,0,9
652,4020,4005,15,10,0,0,2,0,2
653,9244,9156,88,65,12,0,0,0,6
656,17965,17903,62,29,3,0,1,2,8
659,37421,37111,310,211,45,2,21,0,7
660,15448,15333,115,75,15,1,7,0,9
662,40770,40232,538,399,42,1,23,1,35
664,15066,14987,79,57,10,0,3,0,8
667,23522,23342,180,130,20,0,7,1,18
669,27833,27635,198,116,9,5,9,0,47
670,8828,8756,72,44,7,0,4,0,5
674,39345,39054,291,196,31,0,20,0,31
676,36706,36566,140,77,23,2,14,0,13
677,15379,14600,779,691,24,6,11,0,18
678,25410,25206,204,161,8,0,7,2,8
680,46056,45650,406,290,44,4,31,0,15
682,28299,27719,580,410,64,0,53,0,27
683,29788,29571,217,145,27,1,16,0,15
685,40294,40050,244,171,15,4,5,0,38
687,28727,28604,123,86,1,2,6,1,14
688,12443,12375,68,49,9,0,5,0,4
690,5326,5261,65,44,9,0,6,0,3
692,32873,32457,416,248,57,5,44,0,50
693,56095,55690,405,279,31,10,13,0,24
694,231,228,3,3,0,0,0,0,0
698,33774,33590,184,131,10,3,15,2,10
703,25332,25203,129,89,12,1,5,0,12
704,6865,6786,79,60,13,0,0,0,0
705,24467,24239,228,141,19,0,3,0,37
707,10544,10485,59,31,19,0,2,0,1
714,15802,15667,135,69,26,1,7,0,18
715,2299,2283,16,9,2,0,1,0,2
716,28423,28140,283,195,15,3,36,0,18
717,14199,14033,166,100,22,0,12,0,16
718,23290,23095,195,135,16,0,14,0,17
719,30063,29948,115,87,11,2,1,0,4
720,20331,20245,86,57,14,6,3,0,4
723,15983,15876,107,66,17,0,0,0,8
725,77223,76642,581,335,67,9,34,4,80
727,54207,53775,432,250,36,2,54,2,50
728,36675,36369,306,218,26,1,31,0,14
729,47393,47071,322,145,93,3,26,0,24
730,30521,30289,232,158,25,8,9,0,15
731,12292,12205,87,58,8,1,5,1,10
735,11299,11092,207,144,24,4,11,0,18
736,45833,45561,272,176,28,6,20,2,14
738,30706,30183,523,285,100,14,25,2,60
739,34964,34780,184,134,16,0,0,0,23
740,1492,1443,49,27,12,0,2,0,7
741,3526,3479,47,16,22,0,0,0,4
745,47718,47130,588,388,93,6,34,0,38
751,19369,19231,138,106,10,0,0,0,17
754,36673,36506,167,107,3,4,13,0,25
757,20183,20070,113,61,11,2,14,1,12
765,8249,7586,663,533,47,15,3,0,55
766,22354,22268,86,66,3,5,1,0,6
767,30646,30474,172,119,12,1,8,2,18
769,34163,33962,201,95,17,3,12,3,51
771,34761,34563,198,125,27,0,16,0,18
772,17936,17836,100,24,61,1,8,0,4
773,17772,17255,517,384,61,6,21,3,21
775,1792,1599,193,176,0,0,3,0,4
777,37717,37489,228,137,32,5,1,0,43
778,40585,40281,304,190,41,11,9,0,28
780,14934,14830,104,68,12,1,13,0,1
782,17965,17889,76,43,8,0,1,0,19
783,34093,33924,169,94,20,0,9,10,28
784,36313,36075,238,137,18,2,20,3,34
786,273,273,0,0,0,0,0,0,0
791,47260,46319,941,718,71,0,74,0,32
794,28791,28716,75,47,6,1,5,2,11
795,43745,43504,241,148,39,1,10,0,28
901,6218,5637,581,450,39,0,48,4,20
906,165,116,49,26,4,0,13,0,0
907,16864,15382,1482,1049,115,2,218,1,35
909,6987,6647,340,230,55,2,21,0,20
911,7496,6673,823,653,43,4,62,0,17
912,5786,5630,156,80,43,2,10,0,7
913,7261,6999,262,210,24,1,7,0,10
915,25075,24744,331,123,141,4,8,0,20
917,17319,17064,255,122,55,7,29,1,9
918,17439,17060,379,216,38,2,78,0,19
920,14798,14576,222,96,66,4,26,0,9
921,32062,31680,382,206,73,1,41,1,31
923,23607,23310,297,139,90,7,14,0,13
924,49654,49109,545,298,107,2,49,0,37
925,5501,5365,136,50,36,2,22,0,13
926,96732,95566,1166,741,125,12,133,0,79
927,14297,14017,280,195,17,4,37,0,8
934,218,158,60,38,13,0,4,0,2
949,67453,66680,773,485,131,1,72,5,40
950,6,6,0,0,0,0,0,0,0
951,430,427,3,0,3,0,0,0,0
952,8671,8615,56,15,22,1,0,0,15
953,66369,65980,389,230,38,4,38,3,38
956,72353,71796,557,352,75,5,27,1,55
957,40540,40217,323,186,36,8,43,0,36
959,43625,42894,731,505,75,4,63,2,39
960,2891,2840,51,40,8,0,1,0,2
961,28062,27725,337,216,29,5,48,1,13
962,19741,19579,162,93,36,0,13,2,14
965,6168,5764,404,207,162,3,9,0,18
966,16977,16649,328,238,25,3,17,1,20
968,3722,3618,104,65,7,1,23,0,3
969,38838,38097,741,506,62,4,82,3,34
971,28517,28246,271,177,22,0,32,1,16
976,59879,59331,548,352,68,0,34,3,38
979,14929,14115,814,614,70,1,69,0,13
982,14182,14025,157,85,26,0,21,0,13
983,31889,31454,435,284,71,2,31,0,32
985,31250,30906,344,185,73,3,29,4,32
987,58427,57840,587,342,69,4,100,4,43
1001,16984,1150,15834,14370,353,23,491,2,51
1002,27558,2729,24829,17439,1389,46,4330,5,197
1003,13253,1158,12095,8009,878,14,2674,10,8
1005,4900,153,4747,4455,46,7,30,3,24
1007,15423,660,14763,13370,269,6,367,4,63
1008,1317,31,1286,1236,0,2,4,0,4
1009,980,46,934,859,7,0,14,0,5
1010,3711,119,3592,3325,27,9,31,0,5
1011,1201,42,1159,1101,0,9,2,0,2
1012,519,13,506,483,0,0,1,0,5
1013,23656,7534,16122,13728,1059,32,330,9,113
1020,29781,5195,24586,21791,967,48,547,21,102
1022,2158,313,1845,1570,181,11,32,0,1
1026,1011,24,987,920,4,1,3,0,8
1027,17896,1158,16738,15339,184,30,424,9,71
1028,16417,893,15524,13989,387,2,607,1,37
1029,714,5,709,682,0,0,6,0,0
1030,11708,677,11031,10197,176,5,236,1,36
1031,1406,33,1373,1278,10,8,6,1,7
1032,483,18,465,453,0,0,0,0,1
1033,6092,283,5809,5347,80,6,185,0,6
1034,1977,49,1928,1821,10,6,16,0,0
1035,5325,320,5005,4346,71,5,351,1,14
1036,4966,181,4785,4552,36,7,34,0,4
1037,706,21,685,645,3,1,0,0,5
1038,2522,49,2473,2365,16,6,12,1,7
1039,1511,45,1466,1376,19,5,7,1,4
1040,38238,19597,18641,16084,1098,39,390,24,169
1050,2467,104,2363,2210,12,1,16,0,13
1053,2031,96,1935,1777,49,3,19,0,12
1054,1889,79,1810,1626,28,2,36,1,15
1056,21002,1743,19259,17770,469,17,244,1,48
1057,8152,248,7904,7464,54,16,57,2,44
1060,14461,1432,13029,11164,390,20,608,10,101
1062,10910,900,10010,8956,226,10,245,0,51
1063,2106,259,1847,1115,164,1,415,0,10
1066,215,15,200,181,5,2,7,1,3
1068,1904,71,1833,1722,17,3,18,0,4
1069,8428,489,7939,7240,153,21,138,1,15
1070,577,23,554,519,2,1,2,0,1
1071,1486,42,1444,1378,12,4,2,0,0
1072,1366,54,1312,1208,8,1,9,0,7
1073,6224,206,6018,5707,24,0,55,1,16
1074,584,42,542,495,9,1,11,0,0
1075,18168,1310,16858,14692,444,15,934,3,82
1077,9237,325,8912,8408,45,13,85,4,18
1079,701,53,648,609,7,3,4,0,0
1080,2400,208,2192,2023,65,1,16,0,6
1081,1684,41,1643,1551,4,9,1,0,20
1082,10565,785,9780,8978,137,30,74,10,45
1083,2549,111,2438,2274,22,1,17,0,15
1084,185,10,175,171,0,1,0,0,0
1085,41529,3950,37579,34208,710,68,945,13,153
1088,598,17,581,533,4,0,8,0,3
1089,28835,4020,24815,20751,1017,35,1841,8,105
1092,1343,59,1284,1211,5,2,2,0,0
1093,290,5,285,277,2,0,2,0,0
1094,60,3,57,54,1,0,0,0,0
1095,14694,785,13909,12642,365,8,347,1,49
1096,2509,63,2446,2319,8,3,9,0,10
1097,130,14,116,109,1,0,0,0,2
1098,1147,27,1120,1067,0,0,6,0,3
1103,2545,1376,1169,603,434,7,48,0,18
1104,23598,14159,9439,5815,2594,29,264,7,102
1105,12051,7821,4230,1539,2193,27,111,1,83
1106,16165,684,15481,13394,246,4,1255,6,92
1107,11252,8846,2406,1232,861,8,84,4,46
1108,27671,12850,14821,7015,4785,52,1971,7,162
1109,30968,13418,17550,5958,9771,62,421,38,195
1118,14296,3599,10697,7346,1969,17,779,1,77
1119,14393,4478,9915,6083,2908,18,293,9,71
1128,2647,476,2171,1701,266,6,78,1,5
1129,7024,1685,5339,3584,1189,12,238,5,41
1144,0,0,0,0,0,0,0,0,0
1151,9150,4074,5076,2997,1556,21,120,2,56
1201,45494,3574,41920,35619,2858,68,640,6,309
1220,8166,226,7940,7353,103,7,41,0,17
1222,835,54,781,722,5,3,4,0,2
1223,2430,78,2352,2242,10,1,9,0,5
1224,217,7,210,180,9,0,5,0,2
1225,3258,79,3179,2995,22,2,31,5,0
1226,6324,160,6164,5807,56,2,60,0,16
1229,189,16,173,167,1,0,0,0,4
1230,8907,675,8232,7463,164,13,222,2,43
1235,2733,39,2694,2577,10,2,10,0,10
1236,1513,86,1427,1331,16,0,12,0,4
1237,2365,65,2300,2145,28,5,24,0,6
1238,5722,292,5430,5033,60,6,134,2,23
1240,4692,206,4486,4204,49,4,102,2,9
1242,449,17,432,412,1,0,0,0,7
1243,175,4,171,167,0,0,0,0,0
1244,287,5,282,267,2,2,0,0,0
1245,933,27,906,839,14,4,12,0,1
1247,15147,615,14532,13171,323,22,110,1,80
1253,808,22,786,752,3,6,3,0,4
1254,946,28,918,860,4,0,19,0,6
1255,959,18,941,890,6,2,2,0,3
1256,645,8,637,592,14,0,1,0,3
1257,2140,106,2034,1918,20,2,6,0,4
1258,160,1,159,145,0,0,6,0,1
1259,643,15,628,605,2,2,4,0,2
1260,233,14,219,205,0,0,5,0,1
1262,1758,71,1687,1613,20,0,14,0,9
1264,219,10,209,196,1,1,3,0,0
1266,1208,50,1158,1089,9,1,7,0,6
1267,7876,470,7406,6224,249,10,505,0,51
1270,755,17,738,699,4,0,1,0,3
1301,18042,1484,16558,14918,398,33,287,4,117
1330,1500,30,1470,1397,4,3,3,0,11
1331,13656,725,12931,12045,121,19,93,4,58
1337,2562,34,2528,2417,9,0,13,0,6
1338,127,4,123,110,0,0,1,0,4
1339,1487,38,1449,1321,7,4,12,0,4
1340,1803,54,1749,1643,9,0,9,0,4
1341,1539,23,1516,1460,2,2,17,0,4
1342,1538,156,1382,1179,63,1,24,3,9
1343,165,6,159,142,1,0,1,0,1
1344,1665,33,1632,1496,7,9,4,0,6
1346,352,10,342,314,1,1,4,0,0
1347,204,9,195,171,10,0,0,0,2
1349,827,33,794,733,12,0,8,0,2
1350,118,2,116,105,2,0,2,0,0
1351,2293,46,2247,2087,7,9,30,0,12
1354,1546,52,1494,1353,16,4,23,2,7
1355,879,27,852,796,4,2,7,0,3
1360,2871,77,2794,2619,6,5,15,0,11
1364,7665,315,7350,6721,98,11,74,0,31
1366,1187,37,1150,1087,3,0,4,0,18
1367,506,13,493,453,3,1,7,0,0
1368,1283,25,1258,1189,4,1,9,0,3
1370,3932,124,3808,3584,24,9,19,0,16
1373,4526,149,4377,4087,33,5,63,0,12
1375,3639,204,3435,2692,107,2,441,0,30
1376,5324,446,4878,4451,80,12,51,0,29
1378,780,21,759,707,0,5,8,0,8
1379,774,26,748,675,10,0,8,0,8
1380,82,1,81,74,2,0,0,0,2
1420,41940,12611,29329,22909,2579,80,1508,14,331
1430,6303,195,6108,5723,41,15,53,0,26
1431,3193,123,3070,2913,18,3,16,1,12
1432,8221,514,7707,6351,348,9,423,2,79
1434,1652,286,1366,813,378,21,94,0,10
1436,3208,128,3080,2879,45,3,17,3,12
1438,414,14,400,370,8,0,3,0,7
1440,21577,2376,19201,16932,703,52,400,8,124
1450,11298,431,10867,9637,137,9,579,3,55
1451,5461,163,5298,4617,57,7,364,0,34
1452,4328,125,4203,3965,17,9,29,0,24
1453,43752,8264,35488,28018,2821,47,1380,9,868
1460,10141,328,9813,8428,128,12,826,4,57
1462,11818,674,11144,10117,186,13,210,0,69
1463,11621,378,11243,10275,138,16,234,1,97
1464,7427,780,6647,5488,575,11,200,6,42
1468,4309,126,4183,3978,44,1,23,0,18
1469,7055,312,6743,6236,93,10,76,1,53
1473,8213,357,7856,7387,86,10,93,0,36
1474,2072,89,1983,1830,4,1,25,0,12
1475,10304,566,9738,8935,133,6,139,2,37
1501,16731,878,15853,14290,291,11,545,0,85
1503,3158,127,3031,2796,18,0,38,3,17
1504,9208,371,8837,8248,91,8,99,1,53
1505,4849,148,4701,4210,28,7,250,0,47
1506,3439,122,3317,3130,19,3,18,0,5
1507,13315,539,12776,12039,118,13,143,3,49
1510,15428,2596,12832,10943,387,23,237,0,288
1515,2224,95,2129,2002,21,1,33,0,1
1516,8962,281,8681,8146,57,9,85,2,47
1518,3176,158,3018,2747,45,9,67,1,6
1519,7254,265,6989,6117,103,7,403,0,40
1520,16394,665,15729,14198,346,14,600,2,59
1521,2603,81,2522,2372,12,8,30,0,3
1522,3464,162,3302,3010,49,1,81,0,13
1523,8377,946,7431,6290,561,13,148,0,70
1524,6621,411,6210,5572,167,16,163,1,34
1525,73,2,71,66,0,0,0,0,0
1527,13799,625,13174,11762,344,7,442,5,77
1529,3174,86,3088,2915,26,0,26,0,16
1531,996,15,981,939,4,1,4,0,5
1532,15741,623,15118,11922,219,19,1863,4,198
1534,6233,293,5940,5471,79,6,93,0,32
1535,4735,195,4540,4276,28,9,29,0,10
1536,7514,321,7193,6018,172,3,688,0,52
1537,2141,113,2028,1853,28,2,40,0,26
1540,11032,673,10359,9606,169,11,108,1,53
1541,3495,107,3388,3192,27,1,39,0,7
1542,2366,153,2213,1978,57,2,56,0,10
1543,9049,390,8659,7993,127,8,156,4,44
1545,38316,1610,36706,24259,912,36,9418,5,376
1550,17740,6409,11331,10059,338,57,314,3,58
1560,4896,276,4620,3468,98,0,843,0,46
1561,64,23,41,19,8,0,8,0,3
1562,11992,989,11003,10157,238,27,92,8,40
1564,7985,297,7688,7230,78,3,71,3,46
1566,6691,266,6425,5880,91,8,130,12,31
1568,7900,267,7633,6844,62,0,337,5,55
1569,14193,455,13738,12782,108,19,167,4,105
1570,17776,2479,15297,13462,702,35,323,4,109
1571,11921,1483,10438,9617,188,16,140,0,58
1581,21567,1294,20273,12980,449,22,5575,0,267
1583,7652,554,7098,6369,245,5,147,0,56
1585,4899,167,4732,4471,26,2,31,0,16
1588,10106,535,9571,8821,118,8,113,2,45
1590,9279,253,9026,8464,76,5,98,2,38
1602,25382,3339,22043,16901,2387,35,1502,3,200
1603,22417,6449,15968,9096,2866,23,2814,6,247
1604,41301,9070,32231,20257,6233,78,2721,3,791
1605,29218,9002,20216,11582,5110,41,1786,7,397
1606,21651,2805,18846,13780,2688,44,1017,7,347
1607,9378,2094,7284,4171,2065,8,431,1,161
1608,4996,1882,3114,1690,768,10,452,0,35
1609,23870,5030,18840,13939,2304,49,1508,8,170
1610,28717,11112,17605,9934,3987,48,2340,13,294
1611,2277,267,2010,1648,155,1,39,1,29
1612,5051,307,4744,4283,176,8,71,0,38
1701,33005,2652,30353,23177,1505,29,2675,7,933
1702,39515,9525,29990,15781,2756,55,2579,10,4523
1718,688,28,660,359,38,2,223,0,3
1719,5506,218,5288,3694,119,1,1186,1,38
1720,23232,879,22353,14746,530,15,5790,4,227
1721,18832,1157,17675,12891,514,29,2458,2,649
1730,14566,510,14056,10696,374,15,2312,0,63
1731,1555,314,1241,890,154,4,42,8,17
1740,5665,149,5516,4903,16,0,269,0,49
1741,5237,166,5071,4129,35,0,594,2,29
1742,18545,870,17675,15163,466,2,1171,4,90
1745,433,19,414,322,1,0,60,0,19
1746,14996,512,14484,12621,172,7,931,2,167
1747,6017,264,5753,5279,48,6,106,0,69
1748,18758,733,18025,13733,183,8,3342,1,120
1749,20092,1263,18829,15797,365,9,576,3,549
1752,41793,6631,35162,24696,1294,50,2450,3,2657
1754,10730,597,10133,8911,210,6,363,1,125
1756,6228,181,6047,5644,39,5,105,0,40
1757,30479,3749,26730,20129,689,32,677,1,2023
1760,36659,1740,34919,27749,758,42,4394,1,407
1770,4401,149,4252,3594,27,2,335,1,36
1772,10017,354,9663,7564,105,3,1458,7,92
1773,5651,236,5415,4536,79,8,435,4,60
1775,7190,259,6931,6161,65,3,311,0,44
1776,18934,687,18247,15321,239,2,1697,5,119
1778,14132,557,13575,10836,131,8,1903,6,65
1801,40891,2606,38285,29750,2160,36,3460,6,758
1803,26074,1003,25071,18299,1203,15,4608,2,156
1810,35621,1985,33636,25960,689,18,5496,3,173
1821,30909,1076,29833,24912,1097,36,2533,2,279
1824,26881,1061,25820,21247,553,19,2943,3,155
1826,32689,2460,30229,24933,1844,20,1995,2,272
1827,3358,103,3255,2896,30,0,161,0,26
1830,27553,6363,21190,18518,1027,45,413,4,245
1832,25656,7777,17879,15093,978,61,591,5,226
1833,8410,245,8165,7696,35,7,100,0,21
1834,6752,192,6560,6229,37,6,65,2,25
1835,14578,1858,12720,11317,497,8,297,4,96
1840,7121,5879,1242,799,197,7,75,0,80
1841,53654,46294,7360,4982,1205,73,343,5,379
1843,28346,20716,7630,5194,686,16,1129,4,201
1844,52970,15550,37420,31372,2172,53,2090,3,383
1845,31855,2474,29381,25134,783,22,2216,6,171
1850,16670,5156,11514,6790,2014,19,1587,6,296
1851,32691,5331,27360,9307,2617,24,13326,10,536
1852,36708,8153,28555,17585,2620,47,4910,11,1121
1854,29561,6423,23138,13267,2324,21,5741,29,542
1860,6723,197,6526,6128,47,4,49,0,25
1862,11430,714,10716,8654,538,8,1060,1,94
1863,9536,448,9088,7174,329,7,1124,0,72
1864,15554,466,15088,13769,131,18,589,1,80
1867,25522,687,24835,22258,316,23,1350,4,138
1876,31105,1237,29868,26734,724,13,1290,3,171
1879,12368,565,11803,9968,335,8,970,1,100
1880,27071,1143,25928,23214,410,21,1139,1,196
1886,24618,633,23985,17504,219,23,5273,3,82
1887,23349,694,22655,20132,302,15,1257,9,130
1890,22970,773,22197,17133,218,4,3686,6,165
1901,2794,1091,1703,919,615,7,58,1,28
1902,50725,25496,25229,13786,5892,52,3276,15,587
1904,19944,5124,14820,11571,1402,24,897,5,175
1905,27761,12840,14921,8247,2824,32,2593,7,286
1906,28619,2601,26018,21485,1077,25,1408,3,575
1907,15148,1013,14135,12977,256,8,324,5,108
1908,3334,102,3232,3033,37,1,52,0,14
1913,17366,675,16691,15572,215,32,167,5,74
1915,42341,2694,39647,35799,915,26,923,9,290
1921,8263,279,7984,7251,48,3,226,1,71
1922,3134,90,3044,2899,16,0,32,0,14
1923,27987,1243,26744,24421,522,23,650,1,176
1929,3618,99,3519,3345,16,0,35,0,13
1930,29729,1386,28343,26256,294,33,332,16,279
1937,100,2,98,95,3,0,0,0,0
1938,13785,408,13377,12551,82,3,215,1,94
1940,13326,416,12910,11525,111,1,767,0,74
1944,5395,120,5275,5034,7,1,57,0,27
1945,20462,771,19691,18575,154,18,270,1,80
1949,9779,722,9057,8240,168,7,331,0,68
1950,18289,461,17828,16666,130,7,252,3,112
1951,3582,66,3516,3327,11,3,38,0,17
1952,9236,274,8962,8359,60,19,133,2,35
1960,54155,5399,48756,41856,1774,55,1311,5,1050
1965,329,3,326,312,1,1,6,1,0
1966,6992,172,6820,6512,50,0,67,0,36
1969,6161,135,6026,5715,25,0,85,0,40
1970,44451,8782,35669,30452,1827,57,1255,11,330
1982,7618,199,7419,6772,56,7,310,0,23
1983,6569,270,6299,5911,43,4,118,0,27
1984,4979,227,4752,4354,84,3,198,2,16
1985,4500,144,4356,4104,9,10,48,0,36
2019,16945,753,16192,14471,297,21,503,3,177
2021,24370,1077,23293,17772,2224,16,2139,11,190
2025,8381,191,8190,7777,29,11,98,0,23
2026,25364,2125,23239,19775,1501,15,951,5,167
2030,5923,166,5757,4786,48,4,600,0,27
2032,4853,209,4644,3779,109,2,548,1,43
2035,18618,705,17913,15573,766,12,834,2,121
2038,33261,1221,32040,28305,635,21,1829,16,194
2043,24272,537,23735,22217,142,10,549,0,93
2045,10072,223,9849,9236,73,16,107,5,58
2047,371,2,369,348,4,0,3,0,2
2048,23860,844,23016,19773,948,16,1315,3,109
2050,25956,499,25457,24187,135,20,213,6,193
2052,12799,406,12393,11197,141,6,490,2,51
2053,13115,412,12703,11579,174,21,377,4,113
2054,8460,290,8170,7446,111,13,234,1,52
2056,11662,602,11060,9809,596,14,306,0,32
2061,11351,252,11099,10354,64,1,269,2,71
2062,31611,2324,29287,22932,2299,32,2351,3,373
2066,18561,290,18271,17344,57,11,122,3,133
2067,18553,603,17950,12396,736,15,3922,1,133
2071,968,26,942,868,8,0,28,0,14
2072,29281,1924,27357,17871,5075,33,1585,6,807
2081,20584,882,19702,17224,693,22,835,3,204
2090,16266,464,15802,13462,263,2,1478,0,75
2093,12178,307,11871,10908,156,13,333,2,51
2108,4228,256,3972,3405,133,0,252,0,28
2109,3921,205,3716,3245,71,5,238,1,25
2110,2921,132,2789,2242,35,1,405,3,18
2111,9716,745,8971,3890,450,10,4270,5,37
2113,7126,341,6785,6184,63,4,283,4,25
2114,14469,1038,13431,10211,574,10,1977,2,116
2115,31604,3216,28388,17707,2541,32,6462,35,365
2116,23408,1657,21751,15859,1209,22,3742,5,123
2118,29073,5191,23882,13769,4511,45,4307,8,190
2119,29175,9290,19885,3488,12421,72,1079,5,682
2120,17578,3697,13881,6256,2924,11,3813,6,143
2121,28766,9831,18935,938,15050,96,366,5,599
2122,24385,3607,20778,8044,4999,50,4860,3,745
2124,50972,10258,40714,8973,23254,147,4110,16,931
2125,34926,7039,27887,10567,7644,57,4466,12,1639
2126,22734,4035,18699,936,16054,52,254,11,209
2127,37939,3893,34046,29148,1532,38,2070,7,192
2128,43066,21700,21366,15760,1403,45,1919,13,678
2129,19120,2075,17045,13626,990,16,1646,4,98
2130,38284,7512,30772,21608,3790,41,3114,13,293
2131,30544,7627,22917,14174,6138,26,1031,3,271
2132,27111,2578,24533,19486,1736,25,2183,2,169
2133,56,7,49,42,0,0,1,0,0
2134,21707,2985,18722,10985,1003,21,5346,9,304
2135,47232,4969,42263,29452,2157,38,7994,27,706
2136,35102,8711,26391,7250,16552,56,684,13,375
2138,37982,3028,34954,23168,2586,47,6788,23,261
2139,39525,3936,35589,20273,4693,60,7963,16,357
2140,21447,1511,19936,11603,3341,19,3746,5,157
2141,15130,1842,13288,8348,1169,14,2802,5,187
2142,4499,442,4057,2245,233,14,1382,0,33
2143,26022,2317,23705,17792,948,12,3018,4,379
2144,25497,1528,23969,19084,1165,29,2264,4,153
2145,27520,5045,22475,14985,1985,39,2790,4,751
2148,66274,6893,59381,26517,9429,76,17122,14,1836
2149,49075,13990,35085,16729,6929,55,3692,10,3110
2150,40721,26789,13932,8228,2657,69,1296,8,649
2151,62252,23212,39040,27963,2922,64,3434,17,1593
2152,19316,2413,16903,15245,412,25,289,5,203
2155,61483,3953,57530,40763,4946,43,7262,18,1159
2163,1391,152,1239,621,110,0,429,3,1
2169,62140,3697,58443,35234,4220,94,15504,9,838
2170,19950,744,19206,9529,564,6,8519,2,73
2171,19539,774,18765,10292,661,17,7171,5,104
2176,29817,1353,28464,23736,938,17,2215,7,234
2180,23244,980,22264,18930,642,16,1510,2,191
2184,39143,1860,37283,27425,1275,34,6739,9,440
2186,28637,1400,27237,20315,3585,42,1787,8,212
2188,15133,701,14432,11273,904,20,1209,2,272
2189,15123,833,14290,11309,999,36,851,1,271
2190,18910,721,18189,14959,573,24,1424,6,302
2191,8271,309,7962,6924,173,2,507,0,75
2199,1574,82,1492,1151,32,0,255,0,3
2203,0,0,0,0,0,0,0,0,0
2205,10,6,4,3,0,0,0,0,1
2210,5808,319,5489,4508,167,2,497,1,68
2215,26926,2610,24316,14426,1405,41,7135,27,198
2301,69418,8503,60915,17100,23922,140,1528,16,5314
2302,36202,4254,31948,12284,11734,92,714,12,1999
2322,4777,311,4466,3036,887,5,196,0,106
2324,25676,1072,24604,21173,1534,41,464,1,249
2325,3025,199,2826,2174,445,2,75,0,31
2330,11645,233,11412,10597,104,15,72,2,110
2332,16090,346,15744,14913,67,15,220,0,57
2333,14382,367,14015,12725,380,20,126,3,124
2338,7749,143,7606,7187,66,16,30,2,66
2339,14833,277,14556,13627,112,6,269,1,114
2341,10367,199,10168,9501,89,2,101,0,112
2343,11364,815,10549,7470,1648,14,529,2,225
2346,24245,597,23648,21601,461,38,214,4,220
2347,11523,257,11266,10513,101,6,144,2,71
2350,272,6,266,248,1,0,4,0,5
2351,17085,665,16420,14026,661,26,426,9,385
2356,12767,462,12305,10842,492,9,380,4,121
2357,1906,94,1812,1663,55,6,48,0,5
2359,18361,319,18042,16984,112,17,177,5,120
2360,61134,1782,59352,53953,1088,105,676,5,759
2364,13708,275,13433,12572,122,9,170,3,92
2366,83,11,72,59,1,1,3,0,6
2367,2930,37,2893,2755,21,10,13,2,13
2368,35025,3806,31219,9303,14674,72,4501,5,729
2370,17803,611,17192,14696,602,20,350,1,454
2375,10373,399,9974,8269,726,14,385,1,106
2379,7697,247,7450,6691,248,12,82,1,50
2382,15121,538,14583,13008,435,12,203,2,203
2420,15502,475,15027,8801,145,13,5225,0,103
2421,18950,706,18244,10718,315,8,6180,0,134
2445,22499,1627,20872,14761,839,24,3906,7,152
2446,31957,2107,29850,20886,839,13,6367,5,162
2451,17953,2159,15794,11596,1189,19,2332,6,126
2452,15340,1688,13652,9866,1361,5,1790,5,261
2453,31854,6869,24985,17859,1892,49,3793,9,274
2457,1560,148,1412,784,94,1,405,0,94
2458,12817,816,12001,8881,291,9,1966,2,145
2459,19017,751,18266,13479,460,5,3325,15,145
2460,9204,511,8693,6593,234,2,1294,0,96
2461,7430,392,7038,4931,183,10,1548,0,28
2462,1569,57,1512,1094,36,0,314,4,8
2464,3193,152,3041,1903,133,2,808,0,22
2465,12415,737,11678,9011,343,5,1641,2,119
2466,8434,496,7938,5803,233,7,1449,1,68
2467,22626,1254,21372,15306,1180,32,3852,7,190
2468,5713,209,5504,4404,59,4,700,1,44
2472,35392,2724,32668,25867,1215,35,3357,1,520
2474,28551,1331,27220,21466,652,14,3500,3,156
2476,17757,806,16951,13347,400,14,2142,3,126
2478,27286,1271,26015,18989,519,13,5035,5,176
2481,17280,933,16347,12842,331,5,2444,5,57
2482,10710,442,10268,8027,163,3,1535,4,75
2492,21359,784,20575,17716,252,4,1699,3,125
2493,11851,486,11365,8768,241,9,1892,1,54
2494,10732,439,10293,8297,200,6,1334,0,67
2532,13411,297,13114,11933,172,55,192,3,165
2534,899,30,869,791,14,7,15,4,4
2535,1651,45,1606,1386,20,99,12,0,14
2536,19993,531,19462,16926,466,135,315,5,379
2537,6178,130,6048,5666,30,9,59,2,60
2538,4428,188,4240,3600,113,20,29,3,97
2539,5168,146,5022,4248,114,13,45,1,158
2540,8450,203,8247,7396,161,33,152,2,124
2542,793,117,676,536,85,0,11,0,6
2543,756,22,734,651,10,0,21,0,10
2553,164,1,163,138,5,0,7,0,1
2554,13517,2257,11260,9259,991,19,257,2,145
2556,3338,72,3266,3058,29,1,50,0,7
2557,2372,79,2293,1708,219,27,31,5,83
2558,2178,67,2111,1716,67,16,12,0,87
2559,3388,57,3331,3084,30,31,34,1,23
2561,712,9,703,631,8,2,31,0,12
2562,3204,58,3146,2911,28,4,55,0,27
2563,10070,251,9819,9181,42,20,186,1,55
2564,703,50,653,600,15,0,6,0,4
2568,8172,214,7958,6135,374,52,76,1,334
2571,10858,313,10545,8943,250,40,112,0,312
2575,3167,47,3120,2692,65,11,20,2,111
2576,3957,119,3838,3197,91,14,27,0,109
2584,35,5,30,30,0,0,0,0,0
2601,16487,1683,14804,9229,1559,110,452,15,973
2630,1956,43,1913,1798,11,9,23,0,2
2631,10178,286,9892,9265,151,16,104,6,42
2632,11475,383,11092,9452,349,32,167,4,207
2633,4664,179,4485,4229,118,1,29,0,21
2635,3632,104,3528,3196,47,18,55,0,36
2637,267,2,265,250,0,2,2,0,2
2638,2968,51,2917,2751,44,3,30,0,15
2639,3238,152,3086,2523,266,14,40,2,43
2641,332,3,329,320,3,1,1,0,0
2642,5752,129,5623,5184,189,3,41,0,25
2643,13,1,12,5,0,0,2,0,2
2644,3954,91,3863,3510,43,9,105,0,27
2645,10436,327,10109,9145,260,21,93,0,133
2646,1926,29,1897,1757,44,2,9,0,33
2647,136,9,127,121,1,0,1,0,0
2648,7325,200,7125,6456,107,27,80,5,81
2649,15060,403,14657,12709,347,405,169,1,197
2650,829,5,824,792,12,2,11,0,0
2652,1402,43,1359,1261,48,2,4,0,8
2653,6307,148,6159,5810,85,13,55,2,32
2655,3591,100,3491,3177,45,6,47,0,50
2657,3664,187,3477,3116,197,11,33,0,15
2659,1100,24,1076,1027,11,1,10,0,5
2660,6662,186,6476,5868,243,13,39,0,62
2663,257,2,255,228,6,0,5,0,6
2664,9935,365,9570,8062,475,16,182,4,207
2666,1052,23,1029,938,26,1,12,0,8
2667,3309,75,3234,3006,40,3,30,4,24
2668,3222,60,3162,2954,25,20,16,0,20
2670,1463,32,1431,1291,49,2,15,1,19
2671,1216,39,1177,1053,44,8,4,0,8
2672,297,29,268,201,13,2,3,0,15
2673,8892,643,8249,6692,410,23,144,3,257
2675,6712,152,6560,6026,102,6,73,0,47
2702,4267,92,4175,3927,32,1,39,0,13
2703,46389,4128,42261,35048,2557,71,2173,8,403
2713,39,1,38,37,0,0,0,0,0
2715,4036,125,3911,3598,48,3,32,0,44
2717,4951,102,4849,4515,47,5,23,0,39
2718,6882,310,6572,5627,385,2,63,4,86
2719,15924,501,15423,14328,111,34,202,2,130
2720,31209,3251,27958,23633,1654,60,660,3,327
2721,28075,4105,23970,19244,1349,48,877,8,478
2723,16084,2570,13514,10778,824,36,473,4,276
2724,18050,2635,15415,12562,816,41,462,2,280
2725,2632,60,2572,2402,30,11,28,0,11
2726,15671,374,15297,14393,122,24,189,1,98
2738,5347,225,5122,4558,83,14,73,0,112
2739,6508,149,6359,5956,25,17,55,4,56
2740,45166,10069,35097,24439,2684,165,550,25,2111
2743,10434,256,10178,9572,49,22,62,0,90
2744,13055,4151,8904,6856,551,18,71,0,368
2745,25336,3336,22000,18800,729,40,257,2,536
2746,17355,6936,10419,7330,821,42,125,4,659
2747,22326,1085,21241,18205,933,29,652,1,221
2748,11888,310,11578,10726,85,10,207,1,124
2760,28716,1160,27556,23772,882,29,1700,1,166
2762,9945,434,9511,8513,286,5,354,10,41
2763,2118,90,2028,1797,24,0,108,0,5
2764,4081,98,3983,3665,67,4,29,0,30
2766,19202,596,18606,16849,461,15,469,0,115
2767,15376,466,14910,12897,708,7,428,3,120
2769,12521,319,12202,11438,89,16,198,0,67
2770,5560,92,5468,5156,33,5,29,0,43
2771,15512,558,14954,13507,204,26,443,2,138
2777,17133,375,16758,15780,92,14,168,2,56
2779,6764,144,6620,6162,64,4,57,0,47
2780,52299,4389,47910,37540,4411,92,656,15,1262
2790,16458,335,16123,15390,72,24,118,6,81
2791,312,14,298,287,0,0,3,0,1
2802,814,31,783,739,4,1,14,0,2
2804,2782,65,2717,2562,4,24,15,0,8
2806,17153,623,16530,14636,150,5,924,0,54
2807,1410,66,1344,1271,17,1,5,0,8
2808,2332,63,2269,2042,23,33,41,4,5
2809,22493,959,21534,20067,406,55,231,1,70
2812,1220,20,1200,1121,5,3,11,0,5
2813,8021,152,7869,7338,37,107,50,1,31
2814,7549,208,7341,6954,35,4,35,0,35
2815,247,8,239,215,3,1,2,0,0
2816,33206,1167,32039,29841,296,61,438,6,117
2817,6528,148,6380,5828,51,12,181,0,39
2818,19907,752,19155,17113,224,13,1011,3,84
2822,5960,176,5784,5446,25,20,67,1,30
2823,151,0,151,146,1,0,0,0,0
2824,404,34,370,350,5,0,6,0,0
2825,5265,116,5149,4889,30,8,42,0,23
2826,822,27,795,741,6,0,2,0,5
2827,2224,59,2165,2040,15,1,25,1,2
2828,7469,274,7195,6807,53,3,133,0,35
2829,122,0,122,122,0,0,0,0,0
2830,6474,206,6268,5970,30,9,43,1,35
2831,3860,118,3742,3551,28,2,29,0,10
2832,4887,134,4753,4477,18,33,40,0,27
2833,469,13,456,443,2,1,2,0,0
2835,5559,126,5433,5174,39,7,43,0,21
2836,158,4,154,125,13,0,2,0,0
2837,3616,65,3551,3402,8,0,14,1,20
2838,3801,300,3501,3018,150,0,95,1,30
2839,1870,40,1830,1745,5,0,9,0,2
2840,23902,2832,21070,17721,1228,163,370,2,226
2841,1220,130,1090,795,136,5,67,11,12
2842,17115,1366,15749,13119,814,43,570,20,181
2852,23579,904,22675,20799,301,127,464,12,84
2857,8339,229,8110,7694,30,4,82,0,40
2858,580,17,563,534,8,0,4,0,1
2859,6701,282,6419,6080,44,10,27,6,8
2860,47894,13285,34609,17364,7114,153,741,18,2483
2861,27833,5464,22369,17136,2033,54,352,18,663
2863,22596,14760,7836,4146,1337,36,121,7,689
2864,36376,2687,33689,29897,677,42,1458,6,259
2865,17902,1170,16732,14668,302,29,806,1,153
2871,17640,645,16995,15561,271,32,302,8,68
2872,231,3,228,213,2,0,0,0,3
2873,266,9,257,238,2,2,1,0,0
2874,6137,144,5993,5619,35,17,95,3,16
2875,350,4,346,321,3,2,4,1,0
2876,753,36,717,670,9,1,6,0,8
2878,16359,425,15934,14929,147,15,177,7,67
2879,20982,630,20352,18489,253,290,366,0,96
2881,8443,711,7732,6513,407,17,590,4,14
2882,12919,270,12649,11925,70,58,174,7,56
2885,11147,361,10786,9968,176,25,124,0,45
2886,29373,1625,27748,24758,521,53,1148,3,185
2888,19578,1462,18116,16206,461,36,497,3,72
2889,28277,1775,26502,23856,514,68,717,7,97
2891,21803,1024,20779,18992,198,136,594,13,56
2892,5420,120,5300,4908,36,35,50,1,43
2893,31030,2674,28356,24883,807,120,818,9,171
2894,814,29,785,716,4,7,13,0,4
2895,43269,9091,34178,25827,2992,137,2466,18,360
2896,11154,449,10705,10073,118,4,143,1,50
2898,1887,40,1847,1744,15,4,21,1,7
2903,13264,2501,10763,7217,1134,56,1573,7,116
2904,31542,7212,24330,16905,3992,136,1096,7,568
2905,26334,11777,14557,8845,3099,135,1053,17,301
2906,25559,1888,23671,18134,1177,47,2343,14,378
2907,29827,18823,11004,3390,4331,192,1912,8,297
2908,38507,16765,21742,12162,5687,182,1502,9,407
2909,46119,28625,17494,9026,4562,197,1842,9,350
2910,21907,4776,17131,12474,1318,71,2085,1,186
2911,16384,2514,13870,11297,1223,41,408,2,163
2912,4739,418,4321,2412,329,15,1228,7,51
2914,22140,2047,20093,15242,1446,76,440,4,809
2915,16603,792,15811,13613,582,40,428,1,227
2916,8350,476,7874,6788,322,31,114,0,126
2917,14738,557,14181,11794,219,21,1524,4,116
2918,3125,296,2829,2537,121,0,60,2,16
2919,29473,3839,25634,22679,954,33,880,7,131
2920,37791,7628,30163,24504,1946,94,2305,13,182
2921,12406,572,11834,10540,197,17,697,1,59
3031,11763,374,11389,10616,71,7,204,2,71
3032,5930,128,5802,5489,13,8,72,1,25
3033,5639,150,5489,5013,32,5,116,4,35
3034,4066,83,3983,3752,21,0,53,0,24
3036,5251,138,5113,4882,0,2,44,2,23
3037,4802,85,4717,4502,9,1,13,0,14
3038,34482,1592,32890,30357,385,47,530,6,171
3042,7146,132,7014,6553,25,13,82,0,35
3043,1610,21,1589,1513,3,2,7,0,3
3044,4739,108,4631,4411,17,7,18,3,25
3045,14107,379,13728,12905,127,25,157,4,37
3046,3005,53,2952,2786,19,3,18,0,10
3047,1727,39,1688,1584,15,0,11,1,8
3048,3353,116,3237,3042,6,6,22,0,10
3049,8342,240,8102,7332,45,8,353,2,27
3051,25394,1151,24243,22125,313,27,713,10,113
3052,8478,264,8214,7760,53,14,74,0,35
3053,25646,955,24691,22958,203,16,493,11,91
3054,26622,990,25632,23540,245,35,595,8,168
3055,16120,593,15527,14212,225,18,239,4,83
3057,2612,92,2520,2329,18,3,31,0,18
3060,31251,7396,23855,19654,1024,57,1378,8,275
3062,28966,1726,27240,21244,584,28,4088,6,237
3063,16036,1384,14652,12023,414,24,1243,9,179
3064,15069,2181,12888,11304,361,21,403,6,126
3070,6134,129,6005,5634,46,13,28,1,36
3071,5198,143,5055,4782,26,5,29,1,35
3076,14222,567,13655,12656,114,13,328,0,61
3077,10684,243,10441,9811,56,24,71,0,26
3079,30095,1955,28140,25724,298,37,1068,5,111
3082,1621,41,1580,1482,0,5,8,0,12
3084,1382,25,1357,1287,4,1,12,2,5
3086,3982,104,3878,3647,9,0,16,3,20
3087,15817,503,15314,13876,94,14,687,1,70
3101,3885,571,3314,2665,280,5,169,2,26
3102,33396,3377,30019,25457,1544,75,1320,7,150
3103,38039,6601,31438,25486,2360,76,1750,7,176
3104,34324,2848,31476,27017,1593,67,1181,12,167
3106,14799,504,14295,12957,167,21,502,8,42
3109,10580,513,10067,8970,226,11,464,1,39
3110,23322,748,22574,20087,181,26,1313,5,82
3215,510,11,499,467,4,0,7,0,6
3216,2327,24,2303,2171,2,6,11,1,8
3217,1938,36,1902,1796,1,0,15,3,12
3218,1116,16,1100,1049,3,3,5,0,4
3220,7368,148,7220,6799,24,8,61,3,16
3221,2307,49,2258,2176,1,5,7,1,5
3222,5743,87,5656,5317,19,22,50,0,25
3223,3410,79,3331,3105,20,5,21,0,15
3224,2368,70,2298,2163,14,3,9,0,12
3225,3799,66,3733,3519,10,3,13,2,13
3226,1145,11,1134,1078,8,0,7,0,5
3227,1113,17,1096,1056,0,4,3,0,1
3229,5919,133,5786,5508,21,7,34,0,32
3230,1256,15,1241,1157,2,3,3,0,11
3231,85,5,80,78,0,0,0,0,0
3233,115,2,113,108,0,0,3,0,0
3234,4817,78,4739,4500,18,0,21,0,15
3235,8856,220,8636,8021,55,17,52,1,31
3237,2478,29,2449,2303,6,3,7,0,5
3238,44,5,39,30,0,0,0,0,4
3240,1385,18,1367,1280,4,3,6,1,6
3241,953,9,944,915,3,0,4,0,1
3242,6185,217,5968,5333,226,25,84,17,6
3243,1076,19,1057,1000,2,1,7,0,2
3244,8001,199,7802,7295,41,19,43,2,26
3245,2017,28,1989,1883,9,3,19,1,5
3246,16905,460,16445,15211,179,55,235,3,22
3249,7698,153,7545,7183,21,12,61,2,32
3251,1631,42,1589,1472,5,1,59,0,3
3253,6558,133,6425,6110,24,8,57,0,10
3254,4910,105,4805,4574,13,8,36,0,31
3255,2158,15,2143,2039,2,1,15,0,15
3256,2373,32,2341,2193,7,1,13,0,19
3257,4513,82,4431,4151,45,8,51,2,13
3258,2625,37,2588,2463,7,7,3,0,10
3259,236,1,235,226,0,0,1,0,0
3260,798,6,792,749,1,7,10,3,0
3261,4685,88,4597,4340,16,10,39,3,9
3262,1362,20,1342,1254,2,0,16,0,7
3263,4094,100,3994,3666,30,18,20,0,5
3264,7054,257,6797,6151,71,21,177,3,33
3266,2098,16,2082,1958,1,4,8,0,7
3268,1236,11,1225,1167,0,1,2,0,3
3269,3026,59,2967,2820,13,3,18,0,10
3273,259,11,248,226,4,0,3,5,0
3275,11946,275,11671,10857,99,20,107,2,47
3276,8766,162,8604,8000,48,16,116,1,36
3278,3126,81,3045,2856,28,16,22,2,22
3279,781,9,772,730,4,2,3,0,7
3280,1195,18,1177,1111,3,0,1,0,9
3281,9092,173,8919,8446,27,18,32,1,41
3282,845,12,833,791,0,0,3,0,2
3284,902,19,883,833,4,1,5,0,9
3285,2708,56,2652,2512,8,5,21,3,5
3287,1407,20,1387,1304,10,1,10,0,5
3290,5129,92,5037,4735,18,1,41,1,30
3291,73,11,62,48,2,0,6,0,3
3293,72,0,72,69,0,0,1,0,0
3301,33352,1042,32310,27969,1375,81,1447,9,165
3303,16516,448,16068,14688,298,38,364,7,45
3304,8229,191,8038,7580,17,5,120,1,36
3307,5600,80,5520,5172,54,11,28,0,12
3431,24978,721,24257,22281,282,34,550,9,94
3440,2726,54,2672,2488,6,4,15,0,13
3441,354,11,343,315,6,6,2,0,2
3442,1501,29,1472,1371,12,5,3,0,20
3443,616,3,613,596,2,0,3,0,0
3444,1508,50,1458,1351,4,3,22,2,15
3445,666,9,657,607,4,2,8,0,2
3446,6351,124,6227,5780,33,7,107,1,25
3447,2351,51,2300,2135,9,9,11,1,13
3448,752,24,728,683,4,4,3,0,5
3449,1763,25,1738,1641,5,1,11,0,16
3450,975,15,960,915,2,1,9,0,7
3451,3948,59,3889,3537,28,9,47,24,13
3452,5320,125,5195,4800,22,11,95,0,29
3455,2132,23,2109,1972,9,3,12,2,19
3456,749,16,733,680,1,1,4,0,3
3457,803,17,786,750,1,1,1,0,2
3458,6794,260,6534,6140,34,6,62,4,33
3461,6476,199,6277,5811,160,17,71,5,16
3462,1710,20,1690,1586,7,5,10,0,8
3464,1194,17,1177,1106,5,1,9,0,7
3465,2130,37,2093,1971,19,7,28,0,2
3466,1226,16,1210,1132,0,3,10,0,8
3467,1706,23,1683,1615,5,2,9,0,7
3470,4993,129,4864,4540,25,15,34,1,17
3561,6005,213,5792,5446,23,13,62,1,25
3570,9429,346,9083,8198,405,36,63,1,14
3574,2514,62,2452,2285,5,6,29,1,16
3575,107,4,103,90,0,0,7,0,1
3576,2939,57,2882,2741,10,4,23,2,7
3579,458,5,453,445,0,2,1,0,1
3580,1344,16,1328,1264,7,3,14,0,7
3581,3053,46,3007,2869,14,8,28,0,5
3582,2337,31,2306,2198,6,3,4,0,4
3583,1038,11,1027,981,0,0,5,0,0
3584,3490,53,3437,3245,23,12,23,0,13
3585,2626,50,2576,2453,4,4,7,1,2
3586,654,20,634,609,1,0,2,0,6
3588,1664,32,1632,1587,1,2,6,0,1
3590,910,7,903,860,5,1,0,0,4
3592,1094,9,1085,1054,3,3,1,0,3
3593,329,12,317,307,0,0,2,0,0
3595,713,7,706,668,2,0,7,0,1
3597,374,7,367,351,5,1,0,0,0
3598,3393,45,3348,3093,20,13,23,0,18
3601,376,5,371,339,4,3,6,1,3
3602,2599,46,2553,2417,3,4,8,0,9
3603,5127,79,5048,4720,22,17,21,0,12
3604,15,0,15,12,1,0,0,0,0
3605,1104,28,1076,1004,2,6,4,0,1
3607,314,7,307,288,3,0,2,0,3
3608,2811,64,2747,2589,17,5,15,1,2
3609,807,20,787,742,1,0,1,0,5
3740,1071,13,1058,1005,8,4,4,0,3
3741,4071,60,4011,3700,17,7,44,0,7
3743,13540,286,13254,12082,80,59,170,3,45
3745,1616,18,1598,1494,7,1,9,0,9
3748,4626,101,4525,4241,27,6,42,3,26
3750,938,22,916,812,3,1,44,0,8
3751,399,17,382,352,1,0,7,0,5
3752,784,9,775,744,3,1,1,0,4
3753,3476,65,3411,3152,13,13,56,1,18
3755,10926,639,10287,8500,207,39,949,0,35
3765,487,5,482,471,0,0,1,0,0
3766,9838,374,9464,8022,225,14,689,4,43
3768,1736,30,1706,1565,10,0,33,2,5
3770,583,19,564,497,8,0,17,0,6
3771,864,7,857,819,11,0,0,0,4
3773,7801,145,7656,7134,19,21,43,1,21
3774,1808,24,1784,1703,3,4,7,1,1
3777,1237,9,1228,1162,3,0,1,0,6
3779,769,3,766,724,3,0,8,0,0
3780,475,9,466,436,5,0,2,0,3
3781,1876,34,1842,1723,6,2,28,0,6
3782,3030,50,2980,2785,8,6,30,0,25
3784,4444,196,4248,3430,59,8,487,0,32
3785,2245,43,2202,2097,11,5,20,0,1
3801,22767,760,22007,19823,235,36,1018,7,82
3809,3644,41,3603,3454,9,6,23,0,13
3810,2246,26,2220,2080,5,7,20,0,15
3811,7081,198,6883,6614,24,0,96,0,17
3812,936,21,915,875,1,3,2,0,3
3813,3681,58,3623,3424,7,7,51,1,14
3814,2357,30,2327,2166,14,8,20,0,8
3816,1304,24,1280,1232,0,0,5,0,8
3817,452,6,446,414,3,1,3,0,1
3818,3478,67,3411,3194,5,21,32,0,13
3819,4208,100,4108,3901,27,8,28,1,5
3820,32800,1050,31750,27842,524,39,1793,5,134
3823,1928,25,1903,1741,6,2,73,1,11
3824,15498,654,14844,13052,207,51,825,10,14
3825,9326,175,9151,8567,39,8,106,0,24
3826,2693,75,2618,2487,9,7,12,0,9
3827,3307,73,3234,3077,10,1,19,0,24
3830,1611,20,1591,1515,3,2,10,0,2
3832,405,3,402,387,0,0,0,3,3
3833,22662,521,22141,20535,151,23,499,5,75
3835,6758,118,6640,6143,46,33,48,4,25
3836,1689,12,1677,1607,0,0,7,0,4
3837,1471,16,1455,1368,6,2,8,0,11
3838,1150,11,1139,1088,3,2,10,0,5
3839,4058,112,3946,3670,26,6,57,0,18
3840,4076,92,3984,3712,36,0,91,4,14
3841,6486,187,6299,5991,26,3,53,0,26
3842,16048,382,15666,14873,49,14,207,5,51
3844,2428,42,2386,2224,14,2,43,2,8
3845,1093,9,1084,1055,6,0,2,0,1
3846,995,9,986,960,2,0,3,0,3
3847,326,5,321,302,0,0,1,0,2
3848,6202,146,6056,5757,32,12,22,2,27
3849,1446,39,1407,1346,3,2,3,1,9
3850,340,2,338,327,0,0,3,0,2
3851,3891,53,3838,3594,15,13,35,1,14
3852,591,9,582,544,3,0,0,0,3
3853,769,7,762,747,0,0,1,0,2
3854,1000,27,973,942,3,0,9,0,0
3855,2693,31,2662,2533,8,5,11,0,6
3856,1769,28,1741,1651,1,1,23,0,7
3857,9430,301,9129,8309,84,8,339,13,21
3858,4820,148,4672,4408,28,6,33,0,26
3860,3910,73,3837,3648,15,5,54,0,6
3861,4499,122,4377,3974,25,4,160,2,19
3862,4597,79,4518,4250,23,7,86,0,18
3864,1999,23,1976,1838,11,2,13,0,6
3865,7830,327,7503,7120,54,7,72,0,30
3867,22369,758,21611,19822,259,39,376,10,44
3868,6065,146,5919,5512,42,12,85,0,8
3869,2456,72,2384,2265,15,3,13,1,3
3870,5234,101,5133,4921,7,1,31,0,44
3871,250,5,245,241,0,0,3,0,0
3872,3981,40,3941,3763,15,8,16,1,15
3873,6557,188,6369,6064,22,4,34,4,35
3874,8542,199,8343,7814,68,18,77,3,29
3875,973,13,960,929,7,2,1,0,8
3878,11919,508,11411,9690,198,29,864,6,59
3882,1682,25,1657,1572,4,9,11,0,7
3883,300,6,294,287,1,0,0,0,0
3884,4230,65,4165,3952,13,3,20,2,18
3885,7660,167,7493,6958,16,4,235,0,31
3886,1977,20,1957,1864,2,5,15,0,19
3887,2151,27,2124,2010,9,6,8,0,7
3890,177,7,170,156,0,0,2,0,2
3894,6382,104,6278,6008,15,9,45,0,26
3897,55,0,55,52,0,0,1,0,1
3901,7937,147,7790,7266,46,13,121,2,25
3902,2362,66,2296,2175,13,3,30,0,5
3903,6717,140,6577,6159,43,9,52,0,33
3904,8148,338,7810,7128,131,12,111,16,35
3905,1922,71,1851,1763,8,1,10,6,11
3906,4990,68,4922,4612,23,9,49,1,26
3907,1577,27,1550,1484,14,2,8,0,10
3908,7468,133,7335,6870,33,14,58,1,23
3909,10938,199,10739,10248,45,7,96,0,27
3910,116,4,112,98,0,0,4,0,2
3911,307,2,305,292,2,0,3,0,0
4001,2665,32,2633,2520,6,1,15,5,4
4002,7589,98,7491,7036,63,25,54,1,19
4003,363,3,360,344,3,1,1,0,0
4005,24581,605,23976,21793,587,115,459,7,86
4006,100,3,97,81,0,0,2,0,2
4008,3047,61,2986,2788,7,9,17,0,13
4009,5298,108,5190,4876,29,9,28,1,25
4010,1631,31,1600,1521,0,2,6,0,10
4011,21756,783,20973,18866,366,59,495,7,105
4015,3646,61,3585,3333,25,7,14,1,20
4017,396,4,392,378,1,3,2,0,1
4019,72,0,72,68,0,0,0,0,0
4020,1508,17,1491,1428,4,4,5,0,5
4021,6729,118,6611,6276,41,1,72,3,4
4022,1197,16,1181,1122,2,5,7,0,4
4024,572,1,571,529,2,0,5,0,2
4027,6469,85,6384,6024,21,24,37,0,29
4029,1917,29,1888,1779,6,3,9,0,8
4030,2239,27,2212,2114,8,5,8,1,9
4032,8737,167,8570,7891,56,24,196,2,39
4037,3762,78,3684,3444,16,10,27,4,12
4038,18336,339,17997,16589,293,52,298,8,58
4039,7922,126,7796,7318,30,3,75,1,34
4040,2853,31,2822,2638,15,11,15,1,10
4041,1609,18,1591,1493,6,9,3,0,7
4042,4745,59,4686,4416,17,17,11,1,25
4043,11536,185,11351,10749,53,17,167,1,40
4046,7893,106,7787,7425,17,24,43,1,30
4047,1791,23,1768,1677,5,9,9,1,3
4048,3188,68,3120,2911,16,17,6,0,5
4049,3892,52,3840,3593,9,14,8,4,14
4050,234,1,233,227,1,1,0,0,0
4051,1095,13,1082,1020,4,0,3,1,9
4055,3925,61,3864,3627,13,4,20,0,10
4056,167,12,155,140,1,1,3,0,2
4057,120,8,112,95,5,1,3,0,0
4061,3437,62,3375,3187,11,15,15,0,11
4062,18464,365,18099,16722,328,67,222,6,47
4063,508,6,502,467,8,4,4,0,4
4064,8452,194,8258,7751,58,23,124,5,30
4066,579,6,573,552,0,0,4,0,2
4068,1600,23,1577,1493,2,2,6,0,7
4069,1566,14,1552,1471,8,2,4,0,7
4071,4915,81,4834,4558,20,5,26,0,13
4072,20381,445,19936,18346,326,43,368,2,53
4073,17283,366,16917,15421,233,65,323,2,49
4074,21952,419,21533,19395,346,47,951,5,62
4076,2927,33,2894,2746,12,6,12,0,7
4079,4089,77,4012,3828,9,10,32,0,13
4083,4699,93,4606,4276,45,19,68,0,2
4084,8253,143,8110,7701,40,14,43,5,20
4085,1991,23,1968,1834,8,1,21,0,0
4086,9560,169,9391,8852,76,15,119,0,21
4087,2269,30,2239,2107,7,4,17,0,9
4088,1533,20,1513,1439,3,2,3,1,9
4090,11314,172,11142,10601,77,18,109,1,24
4091,942,14,928,877,1,1,1,1,1
4092,20400,549,19851,16594,1533,61,735,4,78
4093,8376,112,8264,7750,58,25,91,0,18
4095,1481,17,1464,1390,9,1,2,0,4
4096,8990,190,8800,8147,95,17,167,3,40
4097,4072,81,3991,3782,22,7,25,2,9
4101,18109,807,17302,13222,2746,48,405,6,112
4102,18002,893,17109,14247,1291,42,662,6,64
4103,31185,899,30286,24871,2878,54,1114,15,150
4105,12406,271,12135,11177,91,24,372,2,47
4106,26641,920,25721,22099,1530,64,905,14,130
4107,9575,247,9328,8734,55,0,194,3,28
4108,907,40,867,830,5,6,3,0,4
4109,133,0,133,128,0,0,2,0,0
4110,1752,35,1717,1634,8,1,23,0,10
4210,24061,582,23479,20903,1053,78,237,9,76
4216,666,4,662,618,0,2,0,0,1
4217,3283,39,3244,3072,6,9,22,1,4
4219,1544,20,1524,1450,3,0,8,1,3
4220,3186,32,3154,2968,22,9,8,0,9
4221,1125,16,1109,1037,6,1,7,0,3
4222,4173,44,4129,3931,8,3,22,4,16
4224,2746,35,2711,2560,10,15,22,0,7
4226,88,2,86,86,0,0,0,0,0
4227,22,0,22,20,0,0,0,0,0
4231,276,1,275,259,1,0,2,0,2
4234,27,0,27,26,0,0,0,0,0
4236,4376,41,4335,4134,18,11,12,1,5
4237,286,1,285,270,0,1,3,0,0
4238,1223,8,1215,1141,7,3,3,0,3
4239,4620,43,4577,4354,18,10,19,0,14
4240,37121,918,36203,28621,5108,143,431,27,173
4250,4813,82,4731,4398,58,23,27,3,13
4252,4876,87,4789,4452,34,15,32,3,24
4253,2127,21,2106,2003,15,3,8,2,1
4254,3060,50,3010,2801,8,9,13,0,7
4255,730,16,714,668,3,0,2,0,3
4256,3107,28,3079,2852,17,10,13,0,7
4257,2756,50,2706,2536,20,4,20,0,8
4258,2766,35,2731,2604,10,1,12,0,7
4259,3179,50,3129,2969,8,5,8,1,11
4260,5676,101,5575,5282,26,18,26,0,18
4261,488,9,479,467,0,1,0,0,0
4263,2262,41,2221,2081,15,10,3,0,4
4265,903,35,868,822,4,3,4,0,1
4267,31,0,31,31,0,0,0,0,0
4268,5077,76,5001,4632,15,11,42,0,8
4270,6082,76,6006,5635,17,38,19,3,2
4271,44,0,44,30,1,0,3,0,3
4274,5906,77,5829,5515,18,29,22,0,16
4275,464,2,462,451,0,1,1,0,0
4276,5858,125,5733,5347,36,22,12,2,13
4280,6674,79,6595,6207,42,17,37,1,8
4281,5135,99,5036,4751,20,14,34,3,9
4282,5817,137,5680,5373,32,30,26,0,19
4284,1113,8,1105,1049,5,3,2,1,7
4285,376,4,372,360,0,0,1,0,0
4286,8,1,7,3,0,0,0,0,4
4287,3136,55,3081,2948,9,11,7,2,5
4289,1775,37,1738,1601,2,13,7,0,8
4290,1488,13,1475,1401,5,7,4,0,8
4292,986,9,977,900,1,5,0,0,2
4294,3862,43,3819,3609,11,19,16,1,9
4330,26322,620,25702,23593,234,129,467,12,83
4341,70,3,67,62,1,1,0,0,0
4342,1725,8,1717,1649,7,2,5,0,5
4344,2995,55,2940,2762,25,9,29,1,3
4345,12052,194,11858,11070,65,44,45,0,54
4346,1743,41,1702,1584,9,5,6,0,6
4347,2570,45,2525,2363,7,8,33,0,16
4348,3152,41,3111,2961,10,13,13,2,7
4349,1160,9,1151,1098,5,4,4,0,0
4350,3586,52,3534,3332,9,7,10,0,9
4351,2462,29,2433,2290,7,9,28,0,9
4352,1721,24,1697,1615,2,2,8,1,14
4353,2338,37,2301,2157,12,14,11,0,12
4354,1570,21,1549,1473,2,11,4,1,4
4355,2597,58,2539,2416,13,4,10,0,3
4357,3522,50,3472,3276,9,16,12,0,7
4358,4373,78,4295,4055,19,21,25,2,2
4359,455,5,450,406,2,1,2,1,1
4360,578,14,564,541,0,0,2,0,1
4363,2632,47,2585,2454,10,7,6,1,4
4364,6115,101,6014,5640,51,18,46,0,10
4401,44608,941,43667,39636,791,355,813,9,147
4406,751,11,740,704,0,8,0,0,7
4408,201,5,196,185,1,3,0,0,0
4410,1184,31,1153,1070,7,4,0,0,3
4411,1532,14,1518,1431,7,19,7,0,1
4412,9672,232,9440,8693,99,59,138,3,16
4413,147,2,145,144,0,0,1,0,0
4414,1104,20,1084,1045,2,2,4,0,2
4415,266,1,265,246,0,3,1,0,0
4416,5451,90,5361,5073,15,19,19,1,17
4417,395,1,394,363,0,4,4,0,1
4418,1720,9,1711,1601,11,29,3,0,5
4419,2863,36,2827,2692,8,12,10,0,0
4421,1320,33,1287,1217,16,3,18,2,5
4422,1551,42,1509,1387,29,11,9,0,7
4424,839,8,831,764,0,9,7,0,1
4426,4841,95,4746,4367,24,22,77,1,23
4427,2900,30,2870,2687,3,19,5,1,12
4428,3034,38,2996,2830,13,23,7,2,8
4429,4925,72,4853,4626,14,29,22,2,14
4430,1567,19,1548,1480,5,4,8,0,2
4431,18,0,18,18,0,0,0,0,0
4434,1230,16,1214,1152,2,2,6,1,3
4435,963,18,945,921,1,4,3,0,0
4438,1231,17,1214,1161,1,6,2,2,1
4441,1632,17,1615,1558,3,7,1,1,3
4442,101,1,100,100,0,0,0,0,0
4443,2173,33,2140,2007,3,9,16,1,10
4444,9304,144,9160,8619,55,40,95,1,34
4448,1265,10,1255,1208,0,15,0,1,0
4449,1373,18,1355,1249,3,9,0,0,2
4450,1346,18,1328,1282,5,3,4,0,0
4451,199,0,199,196,0,0,1,0,0
4453,725,8,717,665,1,3,0,0,4
4454,62,0,62,61,0,0,1,0,0
4455,916,19,897,831,7,8,29,0,2
4456,2940,49,2891,2742,15,19,8,4,0
4457,5689,82,5607,5339,10,35,26,0,8
4459,669,4,665,613,0,4,0,0,1
4460,1236,8,1228,1175,5,1,3,0,0
4461,3069,30,3039,2783,21,51,27,2,8
4462,4411,45,4366,4146,10,28,17,0,5
4463,2766,46,2720,2499,15,33,13,4,5
4464,603,10,593,558,2,5,0,0,7
4468,8801,165,8636,7582,105,381,119,0,21
4469,3113,97,3016,2745,58,23,95,3,9
4471,624,12,612,563,2,10,0,0,4
4472,2203,45,2158,2055,1,2,8,0,10
4473,8070,207,7863,7022,87,57,304,2,45
4474,3812,30,3782,3596,4,12,25,1,13
4475,356,2,354,328,3,4,1,0,0
4476,1128,15,1113,1063,4,3,4,0,12
4478,272,3,269,260,1,0,0,0,0
4479,1306,14,1292,1219,8,3,6,0,6
4481,665,8,657,631,0,5,2,0,0
4485,251,0,251,231,0,3,0,0,3
4487,778,13,765,722,3,5,1,3,2
4488,1186,7,1179,1139,2,4,1,0,2
4489,197,11,186,170,5,2,2,0,0
4490,208,4,204,194,0,4,0,1,0
4491,107,0,107,100,1,2,2,0,0
4492,132,1,131,126,0,2,0,0,0
4493,1803,19,1784,1706,1,9,6,0,6
4495,399,3,396,370,0,1,6,0,0
4496,3817,54,3763,3544,17,11,17,5,11
4497,307,7,300,289,1,3,0,0,1
4530,11153,226,10927,10073,170,29,68,1,47
4535,710,14,696,664,1,2,2,0,1
4537,2000,18,1982,1876,6,6,7,0,3
4538,1729,16,1713,1603,12,9,22,1,2
4539,1227,13,1214,1170,5,0,4,0,3
4541,44,0,44,40,0,0,0,0,0
4543,2297,21,2276,2158,8,3,22,0,14
4544,695,6,689,658,2,5,2,0,0
4547,1142,11,1131,1072,0,5,1,0,2
4548,1058,15,1043,1000,3,3,9,0,5
4551,823,13,810,786,0,0,1,0,6
4553,1848,30,1818,1730,8,0,13,2,7
4554,649,1,648,621,5,0,3,0,0
4555,1791,15,1776,1712,3,5,17,0,0
4556,1188,14,1174,1121,1,2,7,1,4
4558,409,5,404,378,4,2,6,2,2
4562,2155,18,2137,2038,9,2,1,0,7
4563,1502,18,1484,1414,0,3,2,1,5
4564,505,10,495,477,0,3,1,0,2
4568,461,12,449,433,0,0,1,0,1
4570,16,1,15,5,0,1,0,0,0
4571,308,0,308,301,1,0,1,0,0
4572,5154,46,5108,4856,19,20,33,0,9
4573,666,21,645,593,14,3,6,0,2
4574,1592,28,1564,1482,6,5,2,1,3
4575,298,9,289,261,8,0,0,0,1
4576,606,2,604,590,0,0,3,0,2
4578,4461,36,4425,4150,29,14,47,1,13
4579,3068,55,3013,2855,12,7,14,0,11
4605,13651,258,13393,12436,113,76,163,1,46
4606,1148,21,1127,1063,5,7,0,0,3
4607,1224,38,1186,1139,5,0,4,0,2
4609,5089,102,4987,4471,100,32,173,0,33
4611,443,0,443,432,1,1,1,0,0
4612,590,14,576,541,0,1,5,0,0
4613,121,2,119,112,0,0,0,0,0
4614,2792,51,2741,2609,11,1,21,1,6
4616,827,12,815,786,5,2,7,0,2
4617,724,1,723,691,2,1,5,0,3
4619,3079,55,3024,2828,11,53,20,0,2
4622,1310,45,1265,1181,3,15,11,0,6
4623,943,31,912,869,4,7,4,2,0
4624,211,6,205,201,0,0,0,0,0
4625,64,1,63,59,1,0,0,0,0
4626,524,4,520,484,0,8,4,0,1
4627,1937,21,1916,1834,5,5,14,1,0
4628,672,6,666,637,1,6,2,0,5
4630,1364,30,1334,1263,6,10,5,2,9
4631,1288,22,1266,1135,5,55,4,0,11
4634,1998,26,1972,1817,2,17,18,0,13
4635,27,0,27,26,0,0,0,0,0
4640,2421,40,2381,2238,15,6,16,1,11
4642,201,2,199,192,1,1,3,0,0
4643,962,28,934,885,0,3,2,0,6
4645,92,4,88,79,1,1,1,0,0
4646,96,1,95,89,1,0,0,0,0
4648,567,10,557,543,1,1,2,0,0
4649,1245,24,1221,1173,10,11,3,0,1
4650,256,6,250,247,0,0,0,0,0
4652,1536,31,1505,1453,6,0,2,0,3
4653,575,17,558,529,1,1,4,0,2
4654,3312,72,3240,3031,63,24,22,1,6
4655,962,20,942,895,7,10,6,0,4
4657,344,7,337,321,2,3,0,1,0
4658,1375,113,1262,1210,2,12,1,0,3
4660,1414,23,1391,1341,8,0,12,0,3
4662,460,4,456,434,6,3,5,0,0
4664,1219,33,1186,1073,3,17,8,0,9
4666,1125,13,1112,1027,4,29,3,0,7
4667,1494,31,1463,940,0,401,1,0,6
4668,1765,25,1740,998,0,652,2,0,4
4669,169,5,164,156,0,0,2,0,0
4671,539,11,528,494,5,8,2,0,1
4673,144,0,144,135,2,0,1,0,6
4674,379,0,379,351,2,2,2,0,1
4675,272,5,267,245,2,2,3,0,4
4676,1076,16,1060,1009,2,6,5,0,1
4677,279,8,271,257,0,0,1,0,1
4679,1756,45,1711,1613,8,9,12,1,5
4680,1129,20,1109,1043,10,11,8,0,4
4681,1056,10,1046,1015,4,2,0,1,0
4683,1,0,1,1,0,0,0,0,0
4684,1632,11,1621,1513,10,5,5,0,16
4685,355,3,352,327,0,1,4,0,3
4686,135,2,133,124,0,5,0,0,0
4691,460,2,458,430,0,4,4,0,4
4693,461,9,452,430,2,1,2,0,0
4694,2137,30,2107,1982,10,29,4,0,0
4730,9813,140,9673,8811,57,497,42,3,13
4732,1506,7,1499,1446,1,6,0,1,0
4733,163,0,163,161,1,0,0,0,0
4734,739,4,735,713,1,12,0,0,0
4735,541,11,530,503,4,8,0,1,0
4736,9033,101,8932,8382,48,133,52,3,25
4737,0,0,0,0,0,0,0,0,0
4739,993,8,985,961,5,5,1,0,0
4740,1320,15,1305,1251,3,15,4,1,0
4742,3322,55,3267,3097,15,29,11,0,8
4743,4625,69,4556,4205,99,31,90,0,5
4745,1052,8,1044,1023,3,1,0,0,1
4746,366,1,365,360,1,1,0,0,0
4747,1281,21,1260,1182,1,17,8,0,2
4750,1817,32,1785,1668,19,18,6,2,13
4756,3134,43,3091,2985,2,9,13,0,7
4757,2777,21,2756,2631,9,31,8,0,5
4758,1370,18,1352,1289,5,23,2,1,3
4760,748,12,736,679,4,21,2,0,2
4761,590,11,579,558,0,7,0,0,1
4762,577,19,558,517,5,20,2,0,1
4763,661,7,654,619,3,16,0,0,0
4764,42,0,42,39,1,0,0,0,0
4765,1122,16,1106,1072,0,1,5,0,0
4766,371,7,364,340,1,2,2,0,0
4768,366,3,363,343,0,4,0,0,0
4769,8797,163,8634,7920,82,210,127,1,28
4772,730,2,728,705,6,1,0,0,0
4773,780,6,774,733,5,5,6,0,6
4774,675,4,671,655,1,6,0,0,0
4776,907,7,900,853,8,3,0,0,0
4777,387,3,384,370,0,4,1,0,4
4779,446,3,443,420,0,3,1,0,0
4780,733,6,727,700,0,6,2,3,0
4781,534,8,526,513,1,4,0,0,1
4783,473,0,473,444,3,4,3,0,0
4785,2323,38,2285,2188,13,20,4,1,2
4786,1756,34,1722,1644,8,20,5,1,2
4787,445,2,443,431,4,4,0,0,1
4841,6936,142,6794,6342,43,25,70,2,34
4843,5241,73,5168,4886,17,4,34,2,20
4847,1698,22,1676,1581,3,4,6,0,7
4848,583,10,573,546,0,1,6,0,3
4849,3862,56,3806,3625,13,9,22,2,19
4851,53,1,52,47,1,0,1,0,2
4852,64,3,61,56,0,0,0,0,1
4853,408,6,402,383,1,0,0,0,5
4854,1517,17,1500,1439,3,1,4,0,1
4855,163,1,162,152,0,1,2,0,0
4856,3644,100,3544,3300,9,7,44,0,6
4858,1497,10,1487,1395,7,6,7,0,2
4859,645,4,641,614,3,1,1,0,2
4860,1800,22,1778,1676,3,7,4,0,9
4861,2739,70,2669,2491,14,8,33,4,5
4862,3794,34,3760,3581,9,3,9,3,20
4863,1279,11,1268,1224,5,1,7,1,6
4864,4865,98,4767,4375,131,57,22,4,15
4901,26491,804,25687,23468,306,120,394,6,81
4910,2006,27,1979,1868,9,6,13,0,0
4911,1918,20,1898,1775,2,11,5,0,1
4912,982,13,969,927,4,0,5,0,4
4915,9110,112,8998,8467,40,27,65,0,32
4917,3259,40,3219,3067,4,11,17,0,7
4918,11,0,11,6,2,0,0,0,0
4920,1602,22,1580,1491,8,4,3,0,1
4921,1620,21,1599,1499,0,4,7,0,4
4922,1096,19,1077,1017,3,5,2,0,4
4923,443,0,443,412,0,6,1,0,0
4924,2193,26,2167,2062,12,13,2,0,2
4925,87,0,87,84,0,0,0,0,0
4926,35,2,33,29,0,0,0,0,0
4927,3370,57,3313,3148,6,7,9,1,13
4928,2221,39,2182,2096,3,7,2,0,9
4929,885,20,865,818,4,4,3,0,1
4930,4287,70,4217,3922,14,27,28,2,10
4932,1211,17,1194,1118,14,5,3,1,13
4936,257,0,257,245,0,0,0,0,1
4937,6363,75,6288,5893,42,19,34,3,18
4938,9592,171,9421,8531,122,15,325,12,41
4939,1026,22,1004,937,6,8,6,0,5
4940,60,2,58,48,0,0,0,0,0
4941,1731,32,1699,1600,6,5,3,1,5
4942,1121,10,1111,1053,0,6,3,0,1
4943,1705,23,1682,1580,5,5,1,0,21
4944,68,2,66,59,1,0,0,0,0
4945,1125,17,1108,1035,7,8,6,0,12
4947,1717,14,1703,1619,1,2,7,6,7
4949,934,14,920,868,0,3,1,0,0
4950,4726,72,4654,4386,41,28,28,0,16
4951,931,9,922,876,1,5,3,0,2
4952,1947,29,1918,1807,2,2,17,0,14
4953,3139,61,3078,2938,16,11,18,0,6
4955,1448,12,1436,1361,4,6,0,0,15
4956,721,11,710,685,0,5,1,0,2
4957,3987,59,3928,3731,16,16,19,1,14
4958,1868,32,1836,1713,4,16,8,0,8
4961,1008,11,997,945,1,3,13,1,3
4963,7358,113,7245,6812,30,23,33,0,23
4964,265,8,257,242,2,2,1,0,0
4965,1924,14,1910,1835,8,9,3,0,0
4966,1527,15,1512,1443,5,1,3,0,7
4967,3908,77,3831,3594,19,23,18,6,4
4969,1319,13,1306,1226,6,11,2,0,1
4970,1632,31,1601,1564,1,1,4,3,2
4971,2045,18,2027,1924,2,6,5,0,4
4973,1400,22,1378,1303,7,1,11,0,1
4974,2649,43,2606,2444,5,20,11,0,6
4975,53,2,51,51,0,0,0,0,0
4976,9937,124,9813,9136,60,29,92,3,25
4978,925,5,920,893,1,2,2,0,0
4979,978,10,968,918,6,4,5,0,3
4981,2231,18,2213,2100,7,13,11,0,9
4982,581,14,567,539,0,2,0,1,1
4983,1665,20,1645,1553,1,5,4,0,6
4984,527,7,520,491,1,4,0,0,0
4985,122,2,120,117,0,0,2,0,0
4986,1585,31,1554,1501,1,0,1,0,8
4987,1018,10,1008,952,7,1,2,0,4
4988,2328,41,2287,2130,23,17,15,1,7
4989,4520,44,4476,4195,18,13,14,2,27
4992,66,2,64,64,0,0,0,0,0
5001,8674,207,8467,7705,99,26,160,1,19
5009,0,0,0,0,0,0,0,0,0
5030,69,1,68,61,1,0,0,0,1
5031,71,1,70,69,1,0,0,0,0
5032,2631,44,2587,2427,18,4,11,0,15
5033,2973,56,2917,2694,15,9,18,1,20
5034,290,6,284,279,0,1,0,0,2
5035,641,11,630,576,1,3,5,0,9
5036,940,18,922,849,8,8,3,0,3
5037,880,17,863,828,0,2,1,0,8
5038,1328,20,1308,1221,0,7,1,1,11
5039,995,10,985,923,5,5,2,0,2
5040,528,6,522,481,3,2,0,0,2
5041,229,2,227,212,3,0,5,0,0
5042,599,8,591,554,2,1,2,0,0
5043,998,12,986,907,7,5,10,0,9
5045,1686,31,1655,1553,11,5,7,1,9
5046,1164,16,1148,1054,4,3,1,0,3
5048,2465,43,2422,2282,9,9,12,2,8
5050,130,3,127,124,0,0,0,0,0
5051,1166,7,1159,1100,4,12,3,0,2
5052,341,14,327,291,3,4,5,1,2
5053,289,4,285,275,0,1,1,0,2
5055,3503,108,3395,3092,24,7,78,0,27
5056,406,2,404,389,4,1,0,0,0
5058,217,0,217,193,0,0,4,0,1
5059,1357,28,1329,1252,30,1,9,0,7
5060,4590,85,4505,4202,24,14,31,2,15
5061,1746,36,1710,1609,22,4,6,0,5
5062,675,6,669,642,0,1,3,0,7
5065,1096,32,1064,971,9,3,8,0,9
5067,249,4,245,232,2,0,0,0,0
5068,3172,57,3115,2864,25,6,37,2,12
5069,673,5,668,632,4,4,0,0,1
5070,460,7,453,420,2,5,3,0,4
5071,307,11,296,281,5,0,3,0,0
5072,509,0,509,468,2,1,3,0,5
5073,22,3,19,17,1,0,0,1,0
5075,1254,27,1227,1158,5,2,7,0,1
5076,468,6,462,430,2,0,0,0,0
5077,1158,10,1148,1086,1,0,2,0,3
5079,703,12,691,621,6,7,2,0,1
5081,871,16,855,766,2,4,30,0,5
5083,194,1,193,177,0,0,0,0,0
5084,85,2,83,78,0,0,0,0,0
5086,857,14,843,773,12,3,4,0,1
5088,783,25,758,688,8,0,16,0,5
5089,4975,82,4893,4526,40,7,27,0,29
5091,3320,83,3237,3080,17,6,14,0,11
5101,4139,114,4025,3691,46,7,33,0,11
5141,60,0,60,58,0,0,0,0,0
5142,751,19,732,676,3,6,5,0,2
5143,4698,105,4593,4342,17,14,20,0,27
5146,621,17,604,583,0,3,1,0,1
5148,1423,35,1388,1320,8,4,6,0,5
5149,2408,45,2363,2203,12,4,19,4,16
5150,854,15,839,762,6,1,10,2,1
5151,1334,18,1316,1237,0,1,3,0,5
5152,533,15,518,494,2,0,7,0,1
5153,799,16,783,728,6,0,2,0,7
5154,481,21,460,425,4,0,6,1,2
5155,933,21,912,858,5,4,10,0,5
5156,8911,177,8734,8123,107,36,74,1,37
5158,935,20,915,857,4,4,3,0,0
5161,590,9,581,558,2,0,5,1,2
5201,14370,342,14028,12950,212,27,114,4,46
5250,3550,68,3482,3266,15,2,24,0,15
5251,1564,21,1543,1451,6,0,22,0,12
5252,361,8,353,330,2,0,7,0,4
5253,636,17,619,592,2,0,2,0,3
5254,476,17,459,399,7,0,25,0,2
5255,4018,156,3862,3596,66,7,52,1,19
5257,3080,134,2946,2613,53,7,100,0,12
5260,373,8,365,356,0,0,0,0,0
5261,2364,37,2327,2213,13,13,10,0,2
5262,2366,46,2320,2202,14,3,10,0,2
5301,16681,548,16133,14520,251,44,273,2,95
5340,1167,27,1140,1083,1,3,16,0,0
5341,485,5,480,467,0,1,1,1,2
5342,658,12,646,605,5,1,2,1,0
5343,986,22,964,895,3,0,4,0,2
5344,807,38,769,666,48,0,38,0,0
5345,1721,31,1690,1580,9,2,4,0,16
5346,5126,158,4968,4543,51,13,51,1,48
5350,706,2,704,680,2,0,1,0,0
5351,282,16,266,240,0,2,1,0,6
5352,857,10,847,813,7,0,4,0,0
5353,1128,25,1103,1027,5,3,5,0,15
5354,2183,58,2125,2002,15,3,13,0,7
5355,732,7,725,678,8,0,1,0,6
5356,1313,56,1257,1192,9,1,21,0,4
5358,248,3,245,235,4,0,0,0,2
5359,569,15,554,522,6,1,2,0,1
5360,337,5,332,316,3,1,0,1,1
5361,864,15,849,803,0,0,0,0,0
5362,257,7,250,236,2,0,2,0,4
5363,2380,76,2304,2175,8,5,14,1,4
5401,32059,1304,30755,25664,1583,59,1792,0,157
5403,20166,677,19489,16545,611,17,1360,7,105
5404,7981,247,7734,5625,707,34,894,3,35
5405,2351,84,2267,2170,17,1,31,0,0
5408,10425,281,10144,8482,497,21,583,2,52
5439,1455,72,1383,1248,32,5,42,0,8
5440,2106,38,2068,1909,11,26,14,0,3
5441,542,11,531,510,1,1,0,0,0
5442,358,5,353,311,0,2,3,0,2
5443,6387,127,6260,5854,27,9,39,0,22
5444,1948,50,1898,1772,14,5,5,0,15
5445,3912,94,3818,3541,25,4,26,0,36
5446,16081,374,15707,13977,392,23,535,12,38
5447,141,0,141,129,3,3,0,0,0
5448,1150,17,1133,1067,0,5,5,0,4
5450,5280,125,5155,4816,14,41,22,3,16
5452,22153,576,21577,18797,457,39,1193,7,74
5454,5167,104,5063,4754,25,14,47,2,13
5455,1219,25,1194,1124,1,8,3,1,2
5456,1137,31,1106,1081,4,1,3,0,0
5457,1577,24,1553,1478,5,10,1,0,3
5458,2152,33,2119,1984,14,5,4,0,6
5459,1699,29,1670,1523,8,39,4,0,1
5461,4923,105,4818,4464,20,10,28,3,43
5462,1856,32,1824,1711,8,4,8,0,18
5463,488,6,482,458,4,3,0,0,1
5464,2975,59,2916,2762,15,7,5,0,14
5465,5587,126,5461,5079,46,6,40,0,28
5468,13369,219,13150,12187,122,41,114,7,38
5471,816,9,807,773,7,4,0,0,0
5472,1787,52,1735,1641,5,1,15,0,6
5473,1470,36,1434,1348,5,2,9,0,4
5474,939,17,922,855,9,5,0,0,2
5476,3185,51,3134,2934,10,50,16,1,5
5477,4551,91,4460,4176,19,1,27,0,22
5478,15704,325,15379,14016,166,124,168,5,42
5481,16,0,16,10,0,1,0,0,0
5482,7751,173,7578,6977,61,9,149,6,36
5483,1653,24,1629,1515,7,17,3,1,5
5485,20,0,20,20,0,0,0,0,0
5486,1608,33,1575,1491,11,0,12,0,4
5487,1507,35,1472,1395,1,2,6,0,5
5488,7945,105,7840,7067,56,159,21,0,15
5489,3355,55,3300,3101,17,3,22,1,10
5491,5784,171,5613,5275,36,18,28,1,14
5492,771,10,761,709,1,5,0,0,10
5494,1754,24,1730,1626,6,2,8,0,8
5495,10897,241,10656,9648,147,16,366,4,54
5602,12235,340,11895,10842,109,15,238,6,92
5640,110,1,109,104,1,0,0,0,3
5641,16709,536,16173,14903,190,52,132,2,99
5647,1064,15,1049,957,7,2,4,0,8
5648,464,4,460,432,2,0,3,0,1
5649,494,12,482,464,1,4,1,0,0
5650,1124,31,1093,1034,5,2,1,0,0
5651,1503,37,1466,1371,11,0,12,0,1
5652,818,5,813,766,1,1,3,0,3
5653,520,5,515,495,0,9,1,0,0
5654,1239,20,1219,1162,4,2,6,0,1
5655,3020,57,2963,2795,6,11,11,0,14
5656,3566,79,3487,3183,50,22,17,0,15
5658,1502,49,1453,1357,6,6,5,0,6
5660,1841,23,1818,1677,9,5,28,0,13
5661,5881,206,5675,5247,58,18,49,0,28
5663,6559,210,6349,5743,162,10,65,2,15
5664,92,2,90,79,3,3,1,0,0
5666,37,1,36,35,0,0,0,0,0
5667,2235,44,2191,2023,23,4,25,1,6
5669,564,11,553,495,2,5,1,1,3
5670,35,0,35,31,0,0,0,0,0
5672,5238,180,5058,4704,67,9,42,0,27
5673,2680,52,2628,2504,15,2,19,1,6
5674,1977,46,1931,1834,6,4,7,0,12
5675,923,14,909,849,3,3,6,0,7
5676,5190,117,5073,4713,29,19,60,5,34
5677,2233,33,2200,2043,17,3,19,5,4
5678,177,5,172,169,0,0,0,0,0
5679,3263,56,3207,3029,12,12,10,0,11
5680,2121,24,2097,1986,14,2,8,1,7
5681,231,7,224,201,0,2,2,0,0
5682,1227,20,1207,1091,13,0,10,0,18
5701,20349,597,19752,18137,225,71,221,7,50
5730,442,4,438,429,0,1,2,0,0
5731,17,0,17,17,0,0,0,0,0
5732,915,9,906,863,3,2,12,0,4
5733,5935,77,5858,5476,21,19,27,1,22
5734,1282,51,1231,1183,9,1,2,0,5
5735,4019,79,3940,3675,82,6,39,0,7
5736,583,11,572,539,9,11,3,0,0
5737,626,11,615,577,5,1,3,1,2
5738,1139,17,1122,1066,6,1,4,0,1
5739,1322,28,1294,1225,4,0,4,0,0
5742,641,5,636,585,3,3,1,0,1
5743,4210,55,4155,3882,21,9,9,0,16
5744,665,12,653,567,10,1,3,3,4
5746,3,1,2,2,0,0,0,0,0
5747,270,6,264,246,1,0,0,0,5
5748,348,3,345,333,0,1,1,0,1
5751,1415,35,1380,1292,10,1,24,0,8
5753,11113,512,10601,9354,224,24,447,5,24
5757,847,13,834,777,2,3,3,0,5
5758,788,9,779,723,3,2,8,0,2
5759,1831,13,1818,1701,4,0,21,0,3
5760,1084,25,1059,990,10,4,8,0,7
5761,1132,23,1109,1041,14,0,8,0,1
5762,503,13,490,466,2,0,6,0,1
5763,2625,43,2582,2348,9,8,17,0,8
5764,3045,60,2985,2782,10,9,15,0,11
5765,1722,19,1703,1554,8,0,1,3,5
5766,739,28,711,639,8,2,17,0,0
5767,1115,24,1091,1022,4,1,11,1,10
5768,45,1,44,41,1,0,0,0,0
5769,1248,22,1226,1156,1,2,7,2,5
5770,1179,36,1143,1066,4,5,8,0,4
5772,685,22,663,623,0,0,3,0,1
5773,2036,33,2003,1878,13,2,6,0,11
5774,1300,15,1285,1221,10,1,9,0,8
5775,592,15,577,543,0,0,1,0,0
5776,389,18,371,354,1,0,1,0,1
5777,3100,34,3066,2889,19,0,15,0,4
5778,738,14,724,677,4,3,1,1,5
5819,9040,297,8743,7963,103,28,238,4,32
5820,423,15,408,379,3,5,0,0,1
5821,1172,18,1154,1114,4,1,4,2,0
5822,2061,27,2034,1877,11,31,7,0,1
5824,1082,17,1065,1010,9,9,2,1,5
5825,157,0,157,153,0,1,2,0,0
5826,861,18,843,826,2,1,2,0,0
5827,620,35,585,528,7,2,8,0,4
5828,2019,27,1992,1874,6,7,6,0,5
5829,1854,18,1836,1745,7,6,4,0,1
5830,1411,41,1370,1295,5,8,1,0,2
5832,952,23,929,886,1,1,7,0,5
5833,49,2,47,39,0,5,0,0,0
5836,1132,20,1112,1016,8,2,6,0,4
5837,335,2,333,314,0,0,1,0,0
5839,706,5,701,674,3,2,0,0,3
5840,68,0,68,65,0,0,0,0,0
5841,405,5,400,376,2,0,1,0,3
5842,561,8,553,506,1,0,1,0,3
5843,2538,40,2498,2325,14,4,18,2,10
5845,1194,22,1172,1109,4,7,8,0,4
5846,1298,27,1271,1223,0,1,1,2,4
5847,887,18,869,804,5,1,15,0,4
5850,259,14,245,194,8,2,8,2,1
5851,6081,85,5996,5576,45,28,54,5,36
5853,560,4,556,544,0,0,0,0,1
5855,7388,122,7266,6752,50,65,44,0,16
5857,1402,15,1387,1290,6,5,6,0,4
5858,325,5,320,302,2,1,1,0,0
5859,2024,29,1995,1859,6,32,8,0,4
5860,2604,45,2559,2412,4,10,3,0,4
5862,298,3,295,281,1,0,1,0,1
5866,725,4,721,691,1,0,0,0,1
5867,774,8,766,730,1,0,0,0,1
5868,183,2,181,176,1,0,0,0,0
5871,1540,17,1523,1421,1,8,8,0,10
5872,873,9,864,819,4,9,0,0,2
5873,739,6,733,685,9,1,9,2,5
5874,561,16,545,504,2,7,6,0,4
5875,646,12,634,603,4,0,3,1,0
5901,17,0,17,13,1,0,0,0,0
5902,147,2,145,136,2,0,0,0,0
5903,830,6,824,787,1,0,4,0,0
5904,267,0,267,250,0,0,3,0,0
5905,788,9,779,728,0,1,2,1,0
5906,1144,7,1137,1067,2,6,3,1,0
5907,159,1,158,151,0,0,0,0,0
6001,19262,936,18326,14699,407,24,2337,3,86
6002,21579,1709,19870,6934,11463,41,475,3,143
6010,60748,9927,50821,43230,3109,64,1543,11,274
6013,9519,378,9141,8449,59,4,170,0,50
6016,6273,585,5688,4701,421,5,245,0,45
6018,2610,238,2372,2208,26,6,13,0,8
6019,9857,401,9456,8739,136,14,195,0,30
6020,23,1,22,20,0,0,0,0,0
6021,1361,31,1330,1257,5,1,4,0,8
6022,141,11,130,118,6,0,2,0,0
6023,1344,61,1283,1173,14,1,44,0,9
6024,601,28,573,539,10,0,2,0,2
6026,5177,268,4909,4304,142,9,263,0,10
6027,1368,28,1340,1248,13,7,8,0,7
6029,16351,688,15663,13456,364,13,1250,6,51
6031,1364,76,1288,1217,16,5,2,0,10
6032,19060,1123,17937,13657,612,14,2907,4,74
6033,29658,1994,27664,22703,773,26,2960,3,137
6035,7305,286,7019,6497,64,6,132,5,13
6037,18855,1053,17802,16317,237,8,630,1,55
6039,2357,122,2235,1989,58,4,47,1,28
6040,35676,6759,28917,18909,5446,90,2759,8,210
6042,24044,3569,20475,12545,3388,54,3490,7,181
6043,4867,278,4589,4188,89,3,83,0,25
6051,31134,17441,13693,7937,4151,23,416,12,167
6052,8017,2506,5511,4005,1014,14,137,7,62
6053,35024,12678,22346,15620,4129,37,1332,8,251
6057,6429,172,6257,5890,17,6,75,3,31
6058,1677,57,1620,1507,8,4,19,0,3
6059,103,0,103,103,0,0,0,0,0
6060,2452,92,2360,2191,39,8,17,1,10
6061,213,4,209,201,1,0,0,0,0
6062,17628,1909,15719,13989,489,25,490,4,69
6063,3451,78,3373,3203,11,1,25,0,12
6065,485,8,477,458,0,0,3,0,0
6066,30237,3348,26889,21227,2148,36,1978,6,92
6067,20809,1339,19470,14120,728,32,3992,0,74
6068,1519,55,1464,1376,19,2,30,0,6
6069,2463,91,2372,2189,33,1,38,0,29
6070,15658,801,14857,13046,343,12,797,2,63
6071,10395,595,9800,8774,610,9,130,3,30
6072,91,10,81,79,1,0,0,0,0
6073,5501,200,5301,4616,69,2,380,0,36
6074,26911,1575,25336,18145,1135,25,4941,13,100
6076,11988,509,11479,10596,102,15,122,6,59
6078,12221,979,11242,9436,1075,8,345,1,24
6079,89,0,89,86,2,0,1,0,0
6080,43,16,27,5,19,2,0,0,0
6081,1324,108,1216,1023,79,0,48,1,7
6082,42141,4185,37956,32261,2699,73,1025,9,162
6084,14598,637,13961,12701,209,19,435,0,55
6085,7208,376,6832,5420,196,2,921,0,23
6088,4917,425,4492,3444,269,11,503,0,23
6089,3594,212,3382,2882,64,0,290,0,15
6090,1183,58,1125,1047,7,10,12,4,2
6091,202,3,199,181,1,0,3,0,1
6092,3924,212,3712,3377,30,1,149,0,9
6093,3488,118,3370,3142,31,3,33,0,0
6095,29458,3456,26002,12534,10328,21,1528,4,238
6096,12613,1118,11495,9279,808,8,807,2,78
6098,10188,685,9503,8779,115,14,123,12,42
6103,2540,296,2244,1071,380,1,678,1,21
6105,18803,5539,13264,4245,7061,57,993,4,158
6106,38036,22445,15591,4917,7215,83,1526,19,689
6107,19221,1149,18072,15703,508,9,1006,0,123
6108,24201,9073,15128,5114,8032,49,1052,1,199
6109,27298,3403,23895,20989,944,24,1100,8,140
6110,13004,2995,10009,5878,1376,20,1947,2,211
6111,30536,3585,26951,22190,1369,18,2236,5,183
6112,23189,3561,19628,1735,16873,41,146,1,195
6114,26257,16470,9787,3204,4775,47,828,8,291
6117,16695,1063,15632,12142,1027,11,1665,1,162
6118,26844,8041,18803,10277,6072,51,1230,2,199
6119,14843,2024,12819,9842,1110,6,1075,0,141
6120,12636,5017,7619,442,6750,33,46,1,58
6226,19233,9253,9980,7514,823,30,915,6,89
6231,3901,134,3767,3569,26,3,25,0,14
6232,3142,120,3022,2799,38,3,34,0,17
6234,8484,538,7946,7214,196,23,123,4,31
6235,2089,119,1970,1826,25,10,7,0,12
6237,5272,212,5060,4763,47,17,31,0,18
6238,12235,512,11723,10883,91,13,168,0,76
6239,11410,621,10789,9663,163,24,234,1,45
6241,6568,255,6313,5779,83,16,114,0,31
6242,1365,48,1317,1237,8,4,11,0,11
6243,226,6,220,196,2,1,3,0,2
6247,2603,88,2515,2386,6,15,12,0,15
6248,5197,190,5007,4712,28,4,78,0,23
6249,7142,331,6811,6337,45,44,45,1,35
6250,4951,322,4629,3735,75,4,574,7,30
6254,1863,89,1774,1624,23,20,20,0,5
6255,4673,128,4545,4238,48,15,30,0,16
6256,2114,382,1732,1541,29,11,30,0,9
6258,334,22,312,222,32,0,39,0,0
6259,4163,165,3998,3778,18,5,67,0,24
6260,9236,551,8685,7813,144,34,113,4,47
6262,572,34,538,504,0,2,8,0,3
6263,312,16,296,272,3,1,5,0,0
6264,109,12,97,83,0,0,0,0,0
6266,409,54,355,320,13,0,0,0,0
6268,12460,995,11465,8554,558,22,1851,4,70
6269,8161,840,7321,5227,590,13,1185,2,32
6277,3940,136,3804,3521,22,10,41,0,22
6278,4266,190,4076,3771,55,5,58,1,16
6279,5566,260,5306,4640,76,8,324,8,30
6280,3286,571,2715,2489,57,10,24,0,21
6281,7021,183,6838,6439,37,12,67,1,23
6282,1225,39,1186,1108,11,1,22,0,4
6320,27398,9330,18068,11448,4151,156,646,26,162
6330,3167,153,3014,2688,74,28,50,1,9
6331,5085,212,4873,4482,65,20,28,0,38
6332,565,23,542,489,2,2,19,0,7
6333,7289,381,6908,5651,104,11,766,2,41
6334,2336,95,2241,2079,29,5,8,4,14
6335,6781,521,6260,5400,178,39,218,7,20
6336,93,10,83,66,1,0,2,0,0
6338,296,12,284,21,11,222,1,0,1
6339,8346,602,7744,6427,269,204,278,8,42
6340,29788,4184,25604,19538,1965,183,1685,54,168
6350,133,5,128,115,3,2,0,0,0
6351,15609,769,14840,13090,287,121,316,5,49
6353,175,13,162,124,12,4,2,2,3
6354,5647,281,5366,4864,88,22,45,0,17
6355,12835,618,12217,10864,221,38,463,10,40
6357,11404,607,10797,9622,341,26,411,3,38
6359,5149,180,4969,4555,38,42,55,8,33
6360,37104,7123,29981,19953,4191,255,2812,45,317
6365,4770,203,4567,4092,53,26,116,0,17
6370,7138,522,6616,5759,207,71,144,3,27
6371,9840,363,9477,8921,56,6,191,3,46
6373,267,2,265,248,1,1,0,0,0
6374,8108,453,7655,6956,122,39,95,2,27
6375,3758,382,3376,2908,110,21,126,0,28
6376,40,7,33,28,0,0,1,0,0
6377,2739,99,2640,2372,22,14,15,0,5
6378,5318,151,5167,4864,49,5,63,0,13
6379,8813,331,8482,7745,93,42,179,5,27
6380,2892,587,2305,1687,359,13,35,3,19
6382,11060,1118,9942,7243,837,267,998,15,63
6384,2611,73,2538,2368,11,16,14,0,5
6385,15796,1171,14625,12795,403,47,613,2,85
6387,359,19,340,280,4,1,8,0,1
6389,129,17,112,71,10,0,4,0,6
6390,422,32,390,352,3,0,11,2,2
6401,18946,4492,14454,10709,2477,27,382,1,113
6403,5985,409,5576,5118,124,9,84,0,43
6405,28171,1856,26315,23337,654,25,1313,10,133
6409,686,46,640,599,15,0,7,0,0
6410,28559,1812,26747,22734,1225,16,1776,2,100
6412,3749,135,3614,3424,27,0,30,1,16
6413,13161,1230,11931,11048,148,14,246,1,86
6414,330,19,311,266,6,2,3,2,4
6415,16300,786,15514,14175,238,44,266,5,83
6416,14225,1003,13222,11279,623,12,791,0,44
6417,4415,196,4219,3909,44,9,47,0,2
6418,12297,2545,9752,7574,1370,20,336,3,64
6419,6174,202,5972,5630,22,4,69,2,17
6420,4250,230,4020,3596,64,17,110,4,26
6422,7152,262,6890,6414,63,7,112,3,29
6423,4821,176,4645,4388,22,12,39,2,11
6424,12403,501,11902,11063,147,16,191,8,57
6426,3453,125,3328,3133,29,7,64,4,4
6437,22064,1134,20930,19076,202,10,777,2,66
6438,2616,103,2513,2375,24,2,18,1,8
6439,100,0,100,100,0,0,0,0,0
6441,5484,160,5324,4946,38,2,94,0,22
6442,2594,102,2492,2396,8,1,15,0,3
6443,17713,643,17070,15724,127,20,563,0,63
6444,636,35,601,554,6,0,25,0,0
6447,6133,299,5834,5451,60,6,85,0,30
6450,36007,12825,23182,17383,3396,33,896,13,168
6451,24894,9478,15416,11761,2170,34,416,12,145
6455,2958,131,2827,2659,33,1,41,0,6
6456,355,5,350,312,3,3,7,0,2
6457,46505,5501,41004,29659,6196,82,2438,13,223
6459,1212,136,1076,683,110,3,173,0,7
6460,37310,2923,34387,29972,1099,46,1781,14,193
6461,14734,1188,13546,11445,432,5,1059,3,73
6467,379,29,350,307,8,0,19,0,1
6468,18825,1470,17355,15548,400,20,660,0,89
6469,3272,120,3152,2974,29,5,38,0,4
6470,16284,1159,15125,13590,440,11,418,5,74
6471,7195,389,6806,6401,70,5,138,0,18
6472,6438,286,6152,5816,75,2,97,0,15
6473,24574,1531,23043,19855,907,23,1483,8,106
6475,10481,539,9942,9261,83,11,256,4,51
6477,14280,715,13565,11326,259,11,1458,1,57
6478,12689,681,12008,11238,128,7,217,4,46
6479,10156,512,9644,8842,168,8,264,1,19
6480,9365,577,8788,8020,191,8,133,1,48
6481,1259,70,1189,1124,15,0,8,0,9
6482,10884,597,10287,9359,151,1,314,5,62
6483,16748,1752,14996,13298,668,13,421,5,74
6484,40869,4080,36789,31701,1812,30,1800,11,287
6488,19896,830,19066,17641,200,6,557,2,88
6489,32267,1831,30436,27801,426,18,1075,5,100
6492,44606,4775,39831,35571,845,57,1820,18,161
6498,6793,553,6240,5689,121,13,95,0,88
6510,4409,504,3905,2082,428,15,1144,6,24
6511,55879,9211,46668,17703,20117,179,5953,24,411
6512,29457,6483,22974,19094,1886,24,985,1,121
6513,38618,18834,19784,9640,7915,66,931,10,230
6514,26613,4252,22361,10343,9401,52,1421,12,158
6515,17877,3113,14764,6226,7013,47,548,6,130
6516,55584,13177,42407,25960,11485,118,2609,10,349
6517,14954,1842,13112,8342,3234,26,808,6,59
6518,19528,1728,17800,13680,2174,98,1210,7,85
6519,15450,7954,7496,1705,4697,36,543,17,68
6524,5297,182,5115,4561,101,3,248,0,25
6525,9087,547,8540,6625,264,5,1203,3,73
6604,30003,12614,17389,5109,9079,47,1307,11,651
6605,23867,10584,13283,4972,6745,26,662,7,203
6606,48427,17145,31282,10481,15359,89,1234,7,1630
6607,8690,4028,4662,300,3955,16,99,1,69
6608,14312,8573,5739,553,4620,24,126,0,125
6610,23347,9904,13443,2989,8929,26,596,5,260
6611,36835,3510,33325,27652,1645,22,2509,1,277
6612,7605,444,7161,6408,106,6,328,1,34
6614,33749,6379,27370,20772,4307,27,841,5,222
6615,18606,4728,13878,7635,4829,26,469,6,190
6702,3882,2240,1642,725,693,17,58,0,25
6704,27300,13231,14069,5433,6800,72,336,7,408
6705,27197,9529,17668,10004,5320,63,863,6,303
6706,14699,6511,8188,4444,2113,44,393,7,489
6708,30345,8939,21406,14312,4684,93,612,12,401
6710,11056,4831,6225,2911,2664,19,87,0,172
6712,9344,415,8929,8308,200,6,94,2,33
6716,15996,1078,14918,13651,389,27,249,3,72
6750,1370,56,1314,1258,5,5,11,0,1
6751,3367,104,3263,3087,31,4,22,0,12
6752,1667,41,1626,1522,16,1,10,0,8
6753,103,1,102,98,0,0,3,0,0
6754,1568,63,1505,1386,10,7,32,0,6
6755,1164,123,1041,925,23,1,15,1,13
6756,2993,105,2888,2762,16,1,24,0,4
6757,2193,106,2087,1927,16,10,38,0,7
6758,39,0,39,36,0,0,0,0,0
6759,5729,205,5524,5179,37,4,106,0,12
6762,7574,332,7242,6560,67,0,377,3,31
6763,2217,67,2150,2057,12,0,14,0,6
6770,31634,4892,26742,21440,2201,34,750,7,561
6776,26848,3107,23741,20506,616,31,940,5,269
6777,1715,133,1582,1468,6,2,19,0,16
6778,1243,31,1212,1132,9,5,9,0,1
6779,8250,712,7538,6790,231,13,178,3,53
6782,2268,131,2137,1989,24,4,25,0,4
6783,2255,70,2185,2051,7,2,29,0,9
6784,3607,167,3440,3212,25,1,54,0,6
6785,753,47,706,606,8,10,44,0,3
6786,9384,607,8777,8058,114,12,119,9,16
6787,7545,344,7201,6726,61,9,92,1,30
6790,35486,5421,30065,26297,1061,65,888,15,145
6791,5546,179,5367,5093,35,8,33,0,13
6793,1189,65,1124,1069,10,2,16,0,4
6794,1119,47,1072,1015,8,1,17,0,5
6795,13873,678,13195,12348,168,8,221,7,61
6796,1023,34,989,960,4,1,5,0,2
6798,9723,454,9269,8609,108,18,141,6,52
6801,20245,2587,17658,14364,559,19,1206,1,397
6804,17748,1502,16246,13916,317,11,966,3,181
6807,7197,734,6463,5320,73,4,608,0,60
6810,55200,22603,32597,19119,3371,41,3363,8,2470
6811,31216,6091,25125,18759,2248,29,1965,17,517
6812,13579,1201,12378,11438,153,11,230,3,98
6820,21499,1234,20265,18016,148,17,1197,4,88
6824,34876,2191,32685,29541,400,10,1362,1,172
6825,22090,2376,19714,16619,666,11,1301,4,235
6830,25043,4563,20480,16545,718,19,1701,4,305
6831,15254,1399,13855,11931,206,3,968,9,137
6840,20612,1116,19496,17167,245,6,1158,4,88
6850,20801,5474,15327,10832,2252,25,1372,3,167
6851,28254,6760,21494,16254,2601,24,1633,2,214
6853,3797,172,3625,3375,62,2,37,1,12
6854,29931,12816,17115,9187,5461,49,1400,4,213
6855,8380,2405,5975,4641,701,2,333,4,46
6870,7720,543,7177,6022,57,1,605,0,70
6877,25077,1520,23557,20976,215,22,1263,3,157
6878,8519,919,7600,6238,91,6,847,2,38
6880,27233,1596,25637,22246,371,15,1717,0,152
6883,10354,631,9723,8443,143,3,575,3,75
6890,4466,237,4229,3818,44,2,223,0,11
6896,8704,450,8254,7549,74,11,238,2,58
6897,18520,917,17603,14887,201,3,1615,4,78
6901,10595,1822,8773,5355,1433,4,1562,2,71
6902,69192,26281,42911,24555,11085,79,4921,11,562
6903,14405,1234,13171,11169,471,0,930,2,70
6905,21809,3581,18228,13112,1557,43,2732,7,143
6906,9902,3040,6862,4774,951,10,759,0,97
6907,9371,1982,7389,5739,716,4,550,0,71
7001,16920,3424,13496,5350,3125,41,4408,8,125
7002,71686,22101,49585,32697,7116,80,7011,17,638
7003,52955,16174,36781,19574,9926,82,4491,4,711
7004,7872,733,7139,6562,38,0,355,1,24
7005,15985,1897,14088,11210,545,14,1657,3,70
7006,26733,2689,24044,21011,642,7,1503,4,125
7008,25342,9345,15997,5591,3825,43,5756,6,219
7009,13014,1467,11547,9785,306,18,1016,2,65
7010,25721,8962,16759,11203,656,23,3786,5,354
7011,41691,24056,17635,12583,1964,46,2069,3,283
7012,13333,2882,10451,7639,609,10,1828,0,62
7013,28843,7428,21415,15770,1001,31,3694,10,165
7014,5589,1614,3975,2828,190,0,750,0,95
7016,23827,2439,21388,18939,646,6,903,4,105
7017,39054,5749,33305,867,29982,93,327,4,321
7018,30429,3266,27163,520,24601,71,174,2,249
7020,14336,1959,12377,5934,772,13,5071,1,87
7021,2244,137,2107,1889,24,2,104,0,2
7022,15025,10018,5007,3513,240,27,694,0,238
7023,7774,729,7045,5604,386,3,713,2,11
7024,40171,5361,34810,15485,1192,21,16948,9,236
7026,32655,12781,19874,16398,1684,48,985,3,225
7027,4454,670,3784,3436,69,1,119,0,32
7028,8094,617,7477,5942,365,2,594,0,50
7029,22044,9378,12666,5201,776,20,5203,0,611
7030,60456,8553,51903,40666,2107,29,6526,50,438
7031,16457,5109,11348,9245,257,7,1173,2,166
7032,41999,20465,21534,14889,1246,37,2034,23,1285
7033,8427,1933,6494,5524,219,8,435,2,38
7034,10163,1276,8887,4327,332,12,3818,0,71
7035,11015,1472,9543,8138,332,7,719,2,60
7036,45161,15194,29967,14931,11736,35,1490,6,543
7039,31325,1582,29743,18812,953,12,9010,4,177
7040,25684,2182,23502,13170,7740,30,951,4,166
7041,7649,546,7103,4132,283,15,2339,1,57
7042,27384,3109,24275,13582,7363,34,1311,9,346
7043,14219,1327,12892,9428,1716,4,795,3,98
7044,14572,1431,13141,11591,323,11,696,2,52
7045,10573,583,9990,7222,84,10,2347,3,48
7046,4508,254,4254,3307,23,4,695,1,13
7047,63361,44900,18461,11235,1403,70,4269,14,612
7050,34315,9965,24350,1066,21525,44,262,7,302
7052,48867,9655,39212,19155,13926,53,3527,18,436
7054,30228,2995,27233,12096,894,47,13296,6,163
7055,70518,51574,18944,10811,4004,111,2599,8,672
7057,11868,2299,9569,8286,320,11,694,6,91
7058,5584,474,5110,3217,172,1,1542,3,23
7059,16096,1164,14932,10646,274,6,3336,4,95
7060,48423,27676,20747,5472,12581,47,1054,8,514
7062,14196,5764,8432,1439,6283,46,207,6,131
7063,14745,7912,6833,1441,4542,30,303,2,210
7064,3905,1021,2884,1973,308,3,449,1,34
7065,29556,8867,20689,8913,8892,40,1622,4,228
7066,15555,1950,13605,12350,231,4,644,3,47
7067,18609,2551,16058,11426,966,29,3049,2,87
7068,6299,437,5862,4904,192,7,551,1,22
7069,6696,563,6133,4433,314,6,1059,0,51
7070,18834,3395,15439,11242,631,27,2688,6,124
7071,22519,6081,16438,13388,688,9,1587,0,223
7072,6372,1582,4790,3855,132,10,608,0,41
7073,10022,2556,7466,5028,456,28,1612,2,99
7074,3133,1292,1841,1391,20,0,351,0,27
7075,10137,1738,8399,6141,337,4,1617,0,76
7076,24871,2567,22304,16225,2360,14,2604,0,145
7077,2885,892,1993,1451,299,0,145,0,17
7078,14061,427,13634,8015,175,0,4784,1,89
7079,18597,1615,16982,10517,3895,11,1228,2,283
7080,24261,4541,19720,11574,2478,51,4555,5,286
7081,17200,2241,14959,11144,1504,7,1546,1,131
7082,5720,477,5243,4145,60,5,841,0,25
7083,56131,11459,44672,18935,16628,59,6344,13,733
7086,17197,5665,11532,7537,685,15,2594,7,132
7087,68611,56519,12092,6859,1355,99,2394,7,602
7088,3580,433,3147,203,2668,9,126,0,33
7090,31056,2244,28812,23842,794,19,2735,1,149
7092,7082,677,6405,5543,135,2,472,0,50
7093,64929,47982,16947,9075,1577,58,4809,11,569
7094,22181,4700,17481,8760,922,23,7167,3,122
7095,19839,4825,15014,7688,2282,23,4388,4,143
7102,15047,4043,11004,2089,7507,27,611,3,170
7103,39439,7723,31716,1914,27072,71,1273,11,254
7104,54051,36720,17331,2692,12126,113,657,8,698
7105,50870,24425,26445,12667,3804,50,336,15,4339
7106,34596,3945,30651,882,27005,77,1193,6,242
7107,41627,24038,17589,1773,13622,100,530,9,662
7108,28715,3940,24775,387,23137,49,48,4,316
7109,38078,19113,18965,10301,3021,50,4200,18,525
7110,30149,5861,24288,18875,926,38,3521,13,172
7111,61176,8985,52191,983,48208,84,413,7,429
7112,29773,2757,27016,264,25582,38,79,6,205
7114,17767,5890,11877,2271,8233,47,154,1,493
7201,29390,18321,11069,3027,5971,32,502,9,636
7202,43389,30016,13373,5638,5318,32,961,3,599
7203,22715,7904,14811,2481,10807,37,580,7,223
7204,13984,5300,8684,5733,1186,7,1273,1,136
7205,22432,5173,17259,3781,11326,25,498,0,536
7206,30982,22673,8309,2044,4950,31,284,2,430
7208,33561,19239,14322,5850,6023,57,1010,4,481
7302,57033,7440,49593,24607,3023,44,19119,12,479
7304,48681,14545,34136,8331,14665,108,8563,43,822
7305,67947,17824,50123,7341,27938,199,10844,14,1510
7306,55342,12901,42441,13461,5655,187,20693,21,687
7307,44247,18861,25386,10759,2120,80,10799,5,583
7310,17536,1097,16439,4425,749,19,10694,6,103
7311,1604,88,1516,687,48,1,705,0,17
7401,6834,454,6380,5254,42,1,832,2,22
7403,7691,1170,6521,5857,114,9,265,0,42
7405,17910,2134,15776,14081,214,11,892,0,55
7407,21422,5898,15524,10928,1494,25,2367,0,238
7410,34927,5369,29558,23305,784,24,4468,10,190
7416,5615,708,4907,4411,128,6,84,0,28
7417,11086,786,10300,8759,176,2,1050,3,46
7418,1997,185,1812,1685,31,5,22,0,4
7419,9378,912,8466,7496,313,12,291,0,41
7420,5053,895,4158,3455,160,19,323,0,38
7421,6917,602,6315,5767,114,35,96,0,28
7422,6240,524,5716,5327,88,15,33,0,24
7423,4258,302,3956,3475,26,1,321,0,19
7424,26776,6074,20702,17133,1358,12,1407,3,121
7430,25487,2204,23283,18840,686,93,2830,2,103
7432,6986,729,6257,5730,70,6,239,0,34
7435,2188,202,1986,1851,18,7,25,1,15
7436,12750,1216,11534,10367,116,12,608,1,30
7438,11273,944,10329,9660,115,10,161,5,66
7439,2258,265,1993,1835,20,3,28,0,9
7440,4414,420,3994,3706,31,4,106,0,14
7442,11101,2163,8938,7776,169,9,591,1,62
7444,11144,800,10344,9746,67,4,289,3,23
7446,14812,1376,13436,11718,127,4,1139,1,64
7450,26007,2074,23933,17805,353,7,4558,0,111
7452,12133,848,11285,9037,163,0,1617,1,25
7456,11735,1084,10651,9700,167,109,196,1,47
7457,4107,411,3696,3269,88,0,219,1,9
7458,11725,760,10965,8670,194,12,1691,3,47
7460,3059,175,2884,2684,23,6,41,0,16
7461,18530,1562,16968,15683,306,18,215,0,86
7462,6670,795,5875,5452,92,6,67,0,20
7463,10058,1315,8743,7701,126,6,640,0,31
7465,6350,780,5570,4973,145,8,228,0,27
7470,55284,6524,48760,40190,1774,26,5191,0,218
7480,15358,1385,13973,12968,192,25,259,4,57
7481,16602,1320,15282,13774,93,4,873,3,25
7501,37918,24964,12954,1995,9062,38,1130,2,262
7502,16592,8507,8085,1465,2320,21,3919,1,135
7503,19893,11668,8225,5619,1516,11,489,2,178
7504,13413,7168,6245,419,5406,16,63,5,103
7505,3215,1950,1265,252,910,5,49,0,12
7506,19637,4778,14859,13129,591,12,532,2,106
7508,23959,9305,14654,10495,2244,25,1253,1,166
7512,11042,2403,8639,7282,247,0,835,1,48
7513,11995,9632,2363,545,1495,2,59,3,139
7514,19200,10956,8244,892,6810,21,98,2,136
7522,23345,13171,10174,939,6533,39,2131,2,198
7524,14130,10819,3311,397,2612,33,53,0,97
7601,46030,19220,26810,11053,9558,62,4734,7,435
7603,8778,4506,4272,2614,585,15,748,2,93
7604,12112,2545,9567,7459,333,7,1421,1,73
7605,9324,1684,7640,3259,202,2,3877,0,32
7606,2701,1256,1445,1068,135,1,172,1,17
7607,10080,2567,7513,5143,605,32,1442,1,63
7608,74,31,43,33,7,0,1,0,0
7620,1762,121,1641,949,54,0,593,0,5
7621,28321,9121,19200,9278,1894,30,7222,0,244
7624,8594,725,7869,4496,83,2,3009,0,30
7626,9155,630,8525,5305,90,3,2865,1,37
7627,4981,270,4711,2941,41,1,1562,1,24
7628,17863,3883,13980,9847,503,12,3081,2,93
7630,7290,948,6342,5328,108,4,709,0,15
7631,29308,9639,19669,8497,7180,46,2863,8,315
7632,5342,341,5001,2201,107,0,2534,0,21
7640,4741,299,4442,3235,35,0,1049,0,14
7641,3343,191,3152,2416,51,0,545,0,12
7642,10143,1138,9005,7861,115,3,742,1,47
7643,10987,3468,7519,4012,469,6,2717,3,91
7644,26206,10838,15368,10413,2020,12,2194,0,203
7645,8436,683,7753,6069,121,0,1324,1,17
7646,16923,3304,13619,8830,796,6,3420,0,139
7647,5168,602,4566,3041,65,0,1305,0,14
7648,5641,418,5223,3196,74,4,1809,0,8
7649,8244,734,7510,5889,73,7,1277,0,39
7650,20292,4862,15430,2903,262,10,11900,6,93
7652,26698,2810,23888,15556,459,3,6966,0,135
7656,8883,936,7947,6972,91,2,631,0,33
7657,11473,3335,8138,4263,200,10,3317,4,107
7660,13224,6189,7035,4477,649,8,1460,1,93
7661,12049,1339,10710,6649,283,8,3434,0,50
7662,5814,1575,4239,3254,208,3,602,0,28
7663,14294,2748,11546,9554,442,6,1219,2,62
7666,41246,8848,32398,16845,9180,46,4378,8,590
7670,15409,1137,14272,8719,240,8,4711,12,87
7675,27079,2762,24317,19290,624,17,3521,7,78
7676,9285,800,8485,7585,87,8,566,0,27
7677,6128,407,5721,4955,46,2,536,1,28
7701,24568,5706,18862,16631,1060,5,446,3,86
7702,4184,165,4019,3700,61,4,97,1,28
7703,29,12,17,7,4,0,0,0,2
7704,6278,241,6037,5671,67,6,92,0,11
7711,1506,63,1443,1375,11,0,15,0,5
7712,39397,6797,32600,21406,7735,40,1830,9,278
7716,8713,586,8127,7434,181,0,178,1,23
7717,1933,141,1792,1702,22,1,20,0,2
7718,6210,542,5668,5232,86,2,135,0,18
7719,21665,2247,19418,18157,258,11,350,4,80
7720,4175,875,3300,3032,67,7,57,0,15
7721,3894,618,3276,1586,1063,14,387,0,32
7722,10041,631,9410,8513,114,0,501,1,43
7723,1263,136,1127,1027,21,0,10,0,28
7724,23494,3063,20431,14672,2491,24,1786,2,260
7726,44945,3667,41278,35041,972,13,4007,5,200
7727,7707,737,6970,5923,529,4,229,1,39
7728,56444,11009,45435,37016,2906,39,3585,7,267
7730,17263,1934,15329,13878,262,14,642,5,63
7731,39677,5142,34535,29660,1503,34,1790,10,191
7732,4710,364,4346,3975,85,3,56,0,31
7733,17266,980,16286,11886,186,5,3549,0,69
7734,12772,2308,10464,8558,986,15,312,8,43
7735,18652,3216,15436,13070,974,21,614,3,80
7737,4177,360,3817,3585,58,7,48,1,5
7738,7084,394,6690,6158,46,8,302,1,17
7739,6122,261,5861,5497,24,1,138,0,13
7740,31905,10334,21571,13361,3180,23,587,6,1550
7746,18337,975,17362,13389,248,20,3286,0,63
7747,31915,3924,27991,22116,1729,25,2861,6,192
7748,28169,2262,25907,23630,345,19,970,2,132
7750,3174,122,3052,2908,9,5,36,0,20
7751,21493,1248,20245,13793,448,17,5493,4,69
7753,37397,5038,32359,18915,10547,49,1223,0,174
7755,6375,562,5813,5138,102,6,234,0,84
7756,3164,208,2956,2694,128,0,31,4,12
7757,6169,618,5551,5156,85,0,72,1,56
7758,4942,499,4443,4114,75,5,99,1,8
7760,9575,432,9143,8615,39,3,147,0,44
7762,8642,433,8209,7814,67,6,105,3,21
7764,8587,774,7813,6818,275,5,143,0,146
7801,25935,17174,8761,6015,1197,32,965,1,134
7803,4015,1283,2732,2178,191,3,210,1,29
7820,49,7,42,35,2,0,5,0,0
7821,8877,795,8082,7466,128,13,144,1,23
7822,981,63,918,830,16,1,29,0,7
7823,7102,442,6660,6293,110,10,54,0,28
7825,9314,575,8739,8217,96,11,97,1,37
7826,5739,324,5415,5073,30,11,79,0,19
7827,4214,391,3823,3486,73,6,76,0,21
7828,14473,2577,11896,8745,975,8,1549,3,76
7830,6529,350,6179,5711,42,1,163,0,48
7831,58,4,54,48,0,0,0,0,0
7832,3800,256,3544,3207,29,5,45,3,28
7833,112,10,102,92,2,0,4,0,0
7834,17966,1347,16619,14124,316,22,1493,0,45
7836,12740,1699,11041,9098,557,5,863,0,64
7838,3399,254,3145,2818,74,7,63,0,28
7840,31255,4742,26513,22204,1421,22,1824,2,117
7842,87,16,71,59,1,0,3,0,0
7843,11413,2041,9372,8308,313,28,280,3,76
7844,98,10,88,80,0,0,2,0,0
7846,46,4,42,38,0,0,0,0,0
7847,1871,500,1371,1075,60,0,121,1,24
7848,4818,386,4432,3981,146,3,129,0,27
7849,8569,909,7660,6491,202,13,669,0,54
7850,6244,1141,5103,4359,226,2,266,0,30
7851,245,22,223,203,2,0,5,0,0
7852,3723,520,3203,2562,191,1,354,0,11
7853,12736,892,11844,10854,143,1,427,1,53
7856,4791,555,4236,3660,156,2,285,0,21
7857,3397,824,2573,2174,151,12,120,0,11
7860,25704,2377,23327,21138,593,42,564,1,125
7863,4017,289,3728,3400,71,1,63,0,12
7865,2536,196,2340,2046,85,0,52,0,12
7866,22965,3220,19745,16519,559,20,1864,7,82
7869,25993,3777,22216,17335,722,15,3100,1,115
7870,114,10,104,87,2,0,5,0,3
7871,20992,1711,19281,17440,345,12,642,4,92
7874,8639,1129,7510,6776,220,5,202,2,48
7876,10218,1117,9101,8112,155,5,520,1,38
7878,736,58,678,580,22,1,30,0,12
7880,216,17,199,187,9,0,0,0,2
7881,7,2,5,5,0,0,0,0,0
7882,14971,1618,13353,11479,812,20,417,10,78
7885,11521,4200,7321,6018,374,10,536,3,70
7901,24199,3431,20768,15980,966,8,2640,5,134
7920,27912,1607,26305,18177,349,9,6719,6,94
7921,7733,732,7001,5741,150,7,854,0,29
7922,12311,1087,11224,8595,219,5,1899,1,73
7924,7650,1241,6409,5752,46,3,334,0,27
7926,149,5,144,140,0,0,0,0,1
7927,4120,373,3747,2816,194,3,597,2,11
7928,19778,1147,18631,15403,167,4,2200,0,102
7930,8514,751,7763,6925,73,4,417,2,25
7931,3422,338,3084,2710,30,0,206,0,16
7932,11036,671,10365,8421,537,1,1013,7,33
7933,3091,311,2780,2393,26,2,258,1,11
7934,1430,108,1322,1247,9,0,26,0,2
7935,589,33,556,479,7,0,24,0,10
7936,11105,876,10229,8450,141,4,1425,0,30
7939,459,42,417,288,114,0,7,0,0
7940,18403,2250,16153,13409,650,14,1324,8,89
7945,9875,577,9298,8260,119,3,504,0,55
7946,3110,241,2869,2449,16,2,258,1,28
7950,21459,2010,19449,13103,869,15,4709,2,82
7960,45609,9691,35918,28670,3003,37,2491,19,259
7961,31,2,29,19,1,0,1,0,3
7970,156,10,146,126,2,0,7,0,0
7974,13122,1180,11942,9144,193,7,2063,2,63
7976,479,15,464,420,0,0,27,0,1
7977,939,196,743,647,50,0,23,0,5
7979,362,20,342,313,3,0,11,0,1
7980,2420,357,2063,1729,31,2,177,2,27
7981,9051,574,8477,6861,114,6,1229,2,18
8001,858,17,841,757,25,3,5,5,11
8002,23920,2896,21024,14495,2184,21,3262,5,154
8003,31402,1872,29530,21094,1812,9,5412,8,147
8004,12005,831,11174,9178,1251,11,196,0,63
8005,25814,2610,23204,20743,1007,21,483,4,71
8006,640,21,619,601,0,0,1,1,2
8007,5486,351,5135,4405,365,15,126,0,18
8008,6914,327,6587,6397,6,1,50,0,21
8009,13885,987,12898,10450,1319,12,409,3,105
8010,11555,1699,9856,5353,3194,43,315,2,245
8011,49,2,47,40,4,0,0,0,0
8012,38581,3008,35573,27787,4518,36,1590,3,209
8014,465,20,445,402,22,2,6,0,1
8015,19691,2517,17174,12016,2772,40,538,26,125
8016,34617,3274,31343,15955,10670,49,2833,19,237
8019,889,65,824,752,8,4,7,0,3
8020,2873,163,2710,2372,134,0,82,0,13
8021,51458,10775,40683,21875,14490,84,1790,2,336
8022,9025,553,8472,6571,746,10,813,0,36
8023,411,45,366,290,20,4,10,0,3
8026,2189,154,2035,1792,74,0,79,2,7
8027,4893,228,4665,4186,188,5,45,0,11
8028,24818,2747,22071,15268,4544,32,1031,4,105
8029,4900,431,4469,4005,181,3,101,0,16
8030,13261,1931,11330,9453,723,21,492,6,35
8031,11707,1223,10484,8584,499,4,895,0,63
8032,424,21,403,345,23,0,11,0,1
8033,17451,726,16725,15208,292,16,484,5,56
8034,19256,1674,17582,13529,1294,18,1994,6,105
8035,7556,258,7298,6847,91,5,87,1,45
8036,6021,396,5625,4651,432,7,263,1,24
8037,23814,4960,18854,16988,875,20,240,10,78
8038,193,18,175,167,2,1,1,0,0
8039,76,2,74,67,4,0,2,0,0
8041,921,61,860,738,41,4,22,3,0
8042,207,9,198,191,1,0,1,0,0
8043,31069,1820,29249,19181,2882,22,6008,11,144
8045,2930,336,2594,189,2198,0,59,1,18
8046,31846,3763,28083,3649,21931,81,600,24,295
8048,12782,1107,11675,7625,2615,17,674,5,34
8049,5284,615,4669,3429,822,6,139,1,33
8050,26507,2300,24207,22715,294,12,388,5,46
8051,10644,495,10149,9034,487,11,208,2,35
8052,20003,2565,17438,12670,2359,22,1303,15,96
8053,46826,2527,44299,36571,2224,17,3591,16,157
8054,44633,2962,41671,29901,4791,53,4754,14,243
8055,28806,1232,27574,25473,456,17,625,2,84
8056,5337,196,5141,4494,181,4,222,0,24
8057,21691,1019,20672,16372,1193,21,2064,0,101
8059,5639,398,5241,4757,194,1,97,0,16
8060,25426,3451,21975,13338,5633,33,1199,16,175
8061,3510,225,3285,2639,304,0,219,0,10
8062,17446,834,16612,14450,851,11,716,2,52
8063,3109,163,2946,2638,121,9,20,0,7
8064,121,19,102,58,9,0,12,0,2
8065,7438,710,6728,5079,994,9,166,8,45
8066,8414,1084,7330,4094,2534,21,149,7,75
8067,1768,114,1654,1401,128,4,9,0,8
8068,6628,1008,5620,3295,1583,20,194,5,41
8069,13325,3190,10135,5841,3576,26,126,0,57
8070,12386,643,11743,10545,389,22,190,0,30
8071,9259,379,8880,8312,116,3,87,1,15
8072,231,19,212,160,15,0,1,0,0
8073,153,14,139,111,16,0,2,0,1
8074,76,0,76,75,1,0,0,0,0
8075,30327,2917,27410,20427,2995,30,833,14,863
8077,19851,1056,18795,15927,1295,18,543,4,140
8078,8074,739,7335,6337,414,13,305,0,17
8079,10793,913,9880,5878,3362,31,60,3,66
8080,37942,1986,35956,30710,2180,35,1708,8,111
8081,50601,5111,45490,22412,18333,113,2248,9,237
8083,9888,1008,8880,6480,1517,17,484,1,28
8084,6981,712,6269,4935,684,7,327,1,41
8085,21274,1536,19738,15548,2348,21,894,1,75
8086,8358,468,7890,6635,644,9,268,2,25
8087,25191,1890,23301,21655,407,29,264,14,67
8088,24095,1042,23053,21476,465,18,223,16,50
8089,3774,343,3431,2597,662,5,30,0,12
8090,8537,441,8096,6838,699,10,161,2,26
8091,5867,620,5247,4120,483,5,411,0,17
8092,3596,245,3351,3191,17,12,34,0,3
8093,9933,1272,8661,6474,1393,20,243,1,52
8094,40774,3243,37531,28895,5514,44,999,19,146
8095,56,40,16,13,0,0,2,0,0
8096,36355,3457,32898,24782,4973,45,1330,13,153
8097,3283,204,3079,2719,216,0,35,10,7
8098,9196,567,8629,7272,780,18,118,0,29
8102,8413,4736,3677,924,2382,20,139,2,33
8103,12862,4770,8092,584,7067,23,82,4,51
8104,21951,8180,13771,753,12168,50,133,4,80
8105,26572,18986,7586,515,5786,32,694,0,141
8106,9698,489,9209,8565,182,9,104,5,33
8107,13688,2750,10938,7707,2078,21,555,4,78
8108,18618,1168,17450,15665,532,20,494,0,71
8109,23306,6447,16859,10052,3894,43,1996,4,123
8110,19599,9391,10208,2938,4993,35,1739,11,68
8201,10647,1437,9210,6372,1627,14,762,3,60
8202,1350,12,1338,1294,10,0,12,0,1
8203,7725,496,7229,6448,155,3,385,2,39
8204,17090,922,16168,15029,367,15,137,4,41
8205,28666,3956,24710,16320,3622,23,3437,5,156
8210,17635,1227,16408,14070,1301,23,276,3,73
8212,305,8,297,291,0,0,1,0,0
8215,14092,2255,11837,9347,1386,12,422,6,73
8217,33,9,24,22,2,0,0,0,0
8221,6971,362,6609,5890,87,6,341,1,9
8223,4116,149,3967,3755,34,7,31,2,24
8224,294,22,272,266,0,0,0,0,0
8225,8442,974,7468,6470,197,3,466,6,25
8226,11229,548,10681,10072,213,9,105,0,21
8230,5908,175,5733,5437,40,4,47,1,29
8232,19897,10143,9754,1906,6673,28,587,4,95
8234,46906,8156,38750,26551,4206,81,5776,13,257
8240,2441,351,2090,1628,264,8,104,0,0
8241,1101,37,1064,1012,7,1,12,0,1
8242,4067,703,3364,2832,221,10,101,7,14
8243,2104,57,2047,1998,5,2,11,0,7
8244,10535,1375,9160,7646,795,13,292,2,40
8245,35,2,33,32,0,0,0,0,0
8246,99,6,93,89,2,0,1,0,1
8247,862,17,845,829,0,0,1,0,1
8248,137,3,134,131,1,0,2,0,0
8251,10075,949,9126,8453,216,12,51,2,21
8260,12964,1992,10972,10053,426,13,88,0,55
8270,7913,715,7198,6251,479,5,29,3,34
8302,47826,19303,28523,15997,10051,500,381,4,146
8310,1776,270,1506,1339,91,0,10,0,9
8311,1914,307,1607,1380,112,15,8,0,9
8312,8465,794,7671,5321,1558,11,178,1,48
8314,280,22,258,236,8,0,1,0,3
8316,327,41,286,247,12,0,0,0,0
8317,1102,77,1025,959,10,0,13,0,6
8318,11896,848,11048,9729,572,58,118,4,46
8319,1272,51,1221,1165,23,2,0,0,4
8320,1054,287,767,346,373,28,15,0,0
8321,189,7,182,167,0,0,0,0,0
8322,10325,604,9721,8442,703,13,115,0,39
8323,771,45,726,644,32,2,10,0,1
8324,408,14,394,369,4,0,0,0,1
8326,1600,662,938,751,102,2,14,2,0
8327,3876,491,3385,1690,1606,14,7,0,26
8328,1302,87,1215,1096,64,2,17,0,4
8329,220,4,216,201,11,0,1,0,0
8330,29548,4175,25373,17010,5094,51,1668,7,164
8332,35396,6165,29231,20003,6613,198,366,0,171
8340,862,53,809,751,12,1,13,0,6
8341,1661,497,1164,923,154,5,49,1,0
8343,4810,283,4527,4072,146,7,38,1,25
8344,5894,774,5120,4417,401,12,29,0,19
8345,745,44,701,623,26,3,0,0,0
8346,552,123,429,187,220,1,0,0,0
8348,157,15,142,134,5,0,0,0,0
8349,1895,152,1743,1318,316,6,1,0,8
8350,611,94,517,403,78,0,11,0,8
8352,409,102,307,177,88,4,2,0,2
8353,444,46,398,355,13,7,3,0,0
8360,43043,21887,21156,13527,5593,93,598,6,191
8361,18669,4279,14390,11383,1630,50,684,4,54
8401,38536,11539,26997,6215,13078,72,6225,17,261
8402,5291,182,5109,4923,11,4,51,0,16
8403,967,14,953,935,5,0,3,0,0
8406,9188,1401,7787,6505,243,6,697,2,43
8501,6574,355,6219,5506,157,6,319,2,36
8502,11636,622,11014,5107,432,8,5027,3,39
8505,18178,1485,16693,12672,1852,18,1384,2,60
8510,5101,452,4649,3936,210,8,295,0,25
8511,905,98,807,700,32,3,22,1,3
8512,12897,2179,10718,5528,950,12,3880,2,46
8514,4715,335,4380,3883,114,4,183,1,15
8515,6344,350,5994,3976,274,16,1505,0,34
8518,5943,451,5492,3614,913,12,658,4,24
8520,29291,8045,21246,12390,2282,37,5503,13,190
8525,4649,243,4406,4031,78,18,93,2,27
8527,57925,7456,50469,43949,2737,42,1542,13,383
8528,401,72,329,229,15,0,54,0,9
8530,7832,785,7047,6344,286,4,137,2,30
8533,6764,609,6155,5679,91,8,58,2,23
8534,12955,703,12252,9637,361,4,1764,4,45
8535,5273,390,4883,4175,205,6,332,0,17
8536,20682,1304,19378,5136,1398,49,12191,4,103
8540,48216,3433,44783,24142,2338,44,16061,14,277
8542,3325,790,2535,1671,396,0,305,0,26
8544,4349,433,3916,2046,376,0,1183,3,15
8550,21034,930,20104,7626,673,17,11071,9,90
8551,5540,288,5252,4598,133,6,331,0,16
8553,743,70,673,604,3,1,36,0,4
8554,3689,228,3461,2607,315,3,357,0,15
8555,808,103,705,630,23,1,12,0,7
8558,7754,385,7369,4541,176,4,2373,0,28
8559,5009,281,4728,4414,38,4,71,0,17
8560,3553,190,3363,2945,83,0,161,1,17
8561,330,16,314,161,8,0,128,0,7
8562,5025,646,4379,3607,383,5,118,2,16
8608,1269,426,843,99,668,2,12,0,13
8609,14867,6423,8444,822,7142,13,124,3,83
8610,32649,12282,20367,13515,5000,25,810,2,161
8611,31531,21143,10388,3078,6367,42,205,7,170
8618,37544,5173,32371,7681,22411,81,866,9,170
8619,23301,3334,19967,15281,2049,23,1784,5,68
8620,14633,1648,12985,9712,2530,9,391,2,28
8628,10310,948,9362,6020,2290,12,630,2,72
8629,13359,6710,6649,1578,4459,20,230,8,71
8638,23548,5063,18485,7272,9750,31,683,10,119
8640,6508,1289,5219,2717,2049,19,131,33,29
8641,4499,906,3593,2429,566,13,152,33,47
8648,31955,3686,28269,17508,3730,25,5699,8,154
8690,19470,1539,17931,15750,644,9,974,6,58
8691,16866,853,16013,10877,543,22,4011,0,63
8701,135256,15804,119452,111436,3298,91,701,7,2056
8720,899,29,870,829,9,0,7,0,1
8721,22050,2570,19480,17632,491,18,460,6,77
8722,10859,1290,9569,8765,239,7,147,2,32
8723,31272,4215,27057,24717,645,30,572,6,109
8724,41458,3971,37487,33803,1422,33,775,4,155
8730,4982,226,4756,4500,69,3,34,2,20
8731,20953,1485,19468,18319,170,21,246,3,61
8732,1471,43,1428,1331,5,3,13,1,9
8733,2738,520,2218,1741,246,6,79,0,11
8734,7702,515,7187,6772,53,1,88,2,34
8735,3064,85,2979,2879,10,2,14,0,7
8736,12566,658,11908,11391,33,3,165,7,13
8738,979,35,944,911,1,1,5,2,1
8740,1932,156,1776,1623,46,0,5,0,8
8741,2739,187,2552,2378,27,0,33,0,9
8742,25056,1851,23205,22214,95,23,225,12,51
8750,3505,102,3403,3327,13,2,8,1,7
8751,3867,648,3219,2882,140,11,39,0,6
8752,1961,70,1891,1818,10,1,12,3,6
8753,64369,8208,56161,49961,1740,47,2182,7,242
8755,28643,3297,25346,21421,1412,18,1590,4,199
8757,34679,3529,31150,27727,1690,38,670,5,106
8758,7582,295,7287,6908,65,13,67,2,20
8759,34547,2045,32502,29831,1255,33,591,6,81
8801,8345,757,7588,6162,686,5,419,0,39
8802,3911,225,3686,3407,55,0,104,2,13
8804,2987,186,2801,2577,55,2,46,0,9
8805,13948,6574,7374,5069,1052,15,658,5,216
8807,39299,3987,35312,22496,1121,39,10396,7,194
8809,7255,631,6624,5323,516,9,587,0,30
8810,8170,499,7671,2339,712,13,4396,0,35
8812,14593,3624,10969,7356,1021,7,2028,4,127
8816,48729,4653,44076,26455,2098,41,13809,7,304
8817,48243,6639,41604,14715,4204,92,21166,15,305
8820,41169,1389,39780,7671,1766,88,29481,7,181
8821,391,38,353,317,3,0,20,0,0
8822,31844,4069,27775,23759,657,24,2258,3,148
8823,9282,791,8491,2545,2057,6,3491,4,60
8824,13300,866,12434,5760,640,22,5603,2,47
8825,4494,222,4272,3982,42,5,55,0,22
8826,5426,350,5076,4713,102,4,85,1,25
8827,4531,334,4197,3829,72,1,112,0,20
8828,2455,282,2173,1846,99,1,119,4,12
8829,3566,347,3219,2939,52,1,113,0,7
8830,20088,1864,18224,4749,1275,51,11534,4,180
8831,55123,4684,50439,33659,2100,51,13305,5,256
8832,3027,2166,861,400,251,1,151,4,11
8833,9117,606,8511,7676,155,5,345,1,42
8835,10953,3464,7489,6255,514,14,337,7,46
8836,3908,253,3655,3018,58,2,440,1,16
8837,18463,2755,15708,5922,1819,39,7281,5,146
8840,17841,2025,15816,10176,880,17,3867,2,107
8844,43333,4063,39270,25688,2044,31,9878,9,213
8846,14636,3751,10885,8331,902,14,1159,0,65
8848,8103,426,7677,7224,66,7,73,1,23
8850,8325,932,7393,6421,192,5,488,0,33
8852,18956,1657,17299,5531,1725,43,9482,5,81
8853,5445,386,5059,4007,183,2,674,0,6
8854,60545,8258,52287,14250,11741,128,23765,21,834
8857,40675,5726,34949,25208,2354,41,5888,10,261
8858,117,9,108,101,0,0,1,0,0
8859,24666,3974,20692,11481,3080,43,5247,4,184
8861,58039,47533,10506,5043,3592,39,730,12,488
8863,12939,3627,9312,5423,1288,15,2130,1,99
8865,30537,3695,26842,21902,2723,18,721,8,151
8867,5221,351,4870,4372,79,4,210,1,24
8869,7835,1672,6163,4120,247,6,1558,1,25
8872,20351,3696,16655,9288,3175,22,3356,3,222
8873,55500,10802,44698,17324,14179,87,11070,9,398
8876,22849,3957,18892,14058,1464,27,2436,2,130
8879,22965,4388,18577,14215,1667,29,1827,1,135
8880,4872,1537,3335,2214,532,7,395,1,35
8882,16118,4198,11920,8804,1000,4,826,2,439
8884,8185,918,7267,6153,273,3,522,0,26
8886,6697,668,6029,4753,545,1,454,2,25
8887,1047,75,972,840,27,0,71,0,2
8889,9928,722,9206,8256,141,5,502,0,28
8890,43,15,28,10,3,0,7,0,7
8901,56278,31534,24744,10697,6387,35,6013,30,808
8902,43296,10587,32709,12438,7665,77,10998,1,390
8904,15072,2251,12821,8212,1258,12,2643,5,172
10001,32612,7279,25333,14845,2950,66,6005,25,217
10002,82155,20147,62008,19440,6541,74,33312,28,543
10003,57076,5391,51685,38025,2194,36,8141,32,495
10004,4287,443,3844,2409,189,1,932,4,24
10005,10639,935,9704,6754,386,6,1950,12,102
10006,4282,430,3852,2656,126,0,829,0,39
10007,8421,790,7631,5322,447,1,1306,10,64
10009,61716,15098,46618,29686,4650,92,9317,37,465
10010,33991,3746,30245,21175,1728,35,5313,117,350
10011,53318,6072,47246,37014,2151,42,5405,36,415
10012,23125,2042,21083,15892,544,10,3293,10,173
10013,31042,2337,28705,16709,1024,31,9138,12,275
10014,32590,2499,30091,25636,609,16,2149,13,265
10016,62336,5786,56550,38424,2949,47,12397,45,431
10017,17401,1432,15969,10557,544,8,4016,8,147
10018,11145,1983,9162,4320,1250,19,3101,14,71
10019,49029,8138,40891,25918,2862,24,9837,14,381
10020,0,0,0,0,0,0,0,0,0
10021,45691,2881,42810,35983,605,21,4515,5,275
10022,36708,2614,34094,26859,812,15,4977,26,245
10023,71164,7060,64104,48870,2757,68,8836,21,586
10024,62250,7255,54995,44650,2892,36,4249,14,505
10025,95424,19652,75772,49474,10163,110,10999,22,930
10026,35644,7940,27704,8196,15144,56,2140,11,366
10027,64037,16699,47338,15532,21536,126,6719,24,648
10028,48116,3346,44770,37595,704,22,4426,1,282
10029,78141,37263,40878,12203,18388,132,7376,19,621
10030,29686,7511,22175,3445,16423,77,763,27,265
10031,56363,28639,27724,10385,12604,87,2181,17,503
10032,55170,34148,21022,9385,7189,61,2569,17,415
10033,50085,31849,18236,12892,2393,28,1365,14,442
10034,36778,24972,11806,7384,2399,33,798,7,296
10035,35980,16207,19773,4729,11596,95,1793,13,301
10036,33868,6040,27828,15362,3522,57,7308,18,264
10037,19670,4761,14909,1623,11734,36,614,4,130
10038,25332,3603,21729,11616,1717,19,7167,20,176
10039,29239,8166,21073,2079,17027,75,739,15,179
10040,40405,27267,13138,8965,1838,36,1080,11,341
10044,11722,1440,10282,4251,1237,109,3897,97,127
10065,32891,2141,30750,25043,527,18,3717,18,214
10069,6671,551,6120,3991,177,9,1576,3,43
10075,27796,1954,25842,21546,454,4,2676,11,135
10103,10,1,9,7,0,0,1,0,0
10110,14,4,10,6,2,0,2,0,0
10111,6,4,2,1,0,0,1,0,0
10112,5,2,3,1,0,0,0,0,0
10115,0,0,0,0,0,0,0,0,0
10119,154,52,102,38,44,6,0,6,1
10128,64249,6662,57587,44797,2544,24,7305,12,411
10152,48,2,46,26,1,2,7,0,1
10153,0,0,0,0,0,0,0,0,0
10154,0,0,0,0,0,0,0,0,0
10162,1814,135,1679,1380,20,3,194,3,5
10165,20,6,14,5,9,0,0,0,0
10167,0,0,0,0,0,0,0,0,0
10168,0,0,0,0,0,0,0,0,0
10169,0,0,0,0,0,0,0,0,0
10170,40,17,23,4,12,0,0,0,0
10171,17,4,13,0,8,0,1,0,0
10172,0,0,0,0,0,0,0,0,0
10173,2,1,1,1,0,0,0,0,0
10174,17,5,12,7,3,0,0,0,0
10177,0,0,0,0,0,0,0,0,0
10199,71,27,44,7,29,0,0,0,2
10271,0,0,0,0,0,0,0,0,0
10278,6,1,5,2,0,0,2,0,0
10279,236,10,226,131,6,0,57,0,0
10280,8993,694,8299,5646,150,4,1971,5,73
10282,5847,449,5398,3840,107,0,1029,2,31
10301,41474,11743,29731,15484,8757,69,3639,9,375
10302,20931,9476,11455,5428,3910,26,1415,1,133
10303,28155,10356,17799,4500,9229,93,2795,20,278
10304,46944,11964,34980,14703,11761,89,6925,17,307
10305,44008,8571,35437,23771,1860,50,8477,22,318
10306,57919,7783,50136,40296,1437,55,6843,6,332
10307,14129,1620,12509,11682,111,18,350,3,71
10308,28198,3033,25165,22337,177,16,2070,2,93
10309,33523,3435,30088,27104,330,13,1883,2,155
10310,26667,8642,18025,9898,4911,62,2118,14,233
10311,0,0,0,0,0,0,0,0,0
10312,61642,6522,55120,47884,576,54,5222,10,243
10314,92157,13815,78342,54894,3776,79,17016,29,603
10451,51536,29663,21873,1605,18074,64,798,13,427
10452,77564,53489,24075,1332,19852,143,1144,23,603
10453,81951,55376,26575,1176,22131,177,1153,21,677
10454,40232,27493,12739,1140,10296,83,310,10,254
10455,43804,30749,13055,963,10650,61,415,13,355
10456,93412,54067,39345,1692,34429,143,901,20,692
10457,77488,50615,26873,1415,22598,166,896,30,654
10458,81299,53671,27628,7206,15154,156,2740,23,925
10459,50984,33826,17158,886,14616,75,385,11,431
10460,62625,40654,21971,1664,17205,166,1209,26,691
10461,54901,24133,30768,16929,4279,95,7679,28,706
10462,84655,36865,47790,10342,18124,249,15571,21,1159
10463,71301,37435,33866,20694,7702,90,3010,27,665
10464,4592,1194,3398,2778,227,0,205,0,43
10465,45799,20807,24992,17591,4081,52,1944,12,554
10466,70420,19023,51397,1521,44861,235,1494,19,1267
10467,103660,52124,51536,8122,31821,225,8065,34,1180
10468,78238,57121,21117,3170,13310,112,2833,15,726
10469,71571,20398,51173,6707,37221,137,4289,31,881
10470,16686,3911,12775,5827,5406,62,524,11,370
10471,25121,6731,18390,13006,2441,27,1701,9,331
10472,72245,44691,27554,1675,14397,296,8103,31,1578
10473,62692,36721,25971,1231,20581,168,1836,17,838
10474,12013,8344,3669,176,3167,6,80,4,70
10475,42609,12081,30528,2222,26226,111,551,9,292
10501,1486,110,1376,1244,10,0,74,0,5
10502,6261,658,5603,3983,258,4,1070,2,36
10503,121,0,121,107,3,0,9,0,0
10504,8258,456,7802,6863,58,0,564,2,42
10505,1431,170,1261,1105,48,0,78,0,3
10506,5762,445,5317,4868,57,3,211,0,21
10507,6521,1959,4562,3532,569,13,244,0,44
10509,19501,4731,14770,13159,494,17,512,5,127
10510,10010,762,9248,7543,230,9,1043,0,34
10511,2369,547,1822,1514,78,9,70,0,21
10512,24664,4756,19908,17884,648,30,532,1,137
10514,12568,731,11837,9444,125,0,1707,2,86
10516,5462,436,5026,4622,48,5,108,0,23
10517,549,162,387,339,16,1,21,0,2
10518,1327,91,1236,1061,21,1,97,0,8
10519,278,94,184,136,9,1,12,0,8
10520,13226,1889,11337,9567,580,15,562,2,76
10522,11587,1733,9854,7756,472,7,1054,2,76
10523,9489,3309,6180,2640,2051,22,1167,0,68
10524,4447,500,3947,3507,104,2,102,1,30
10526,1865,184,1681,1470,54,3,73,0,5
10527,785,111,674,620,10,1,19,0,2
10528,13108,1730,11378,9087,271,1,1481,2,115
10530,13037,1897,11140,7713,1078,10,1760,1,120
10532,5115,600,4515,4120,61,0,225,0,33
10533,7705,557,7148,5908,125,2,696,0,59
10535,531,160,371,295,20,0,39,0,2
10536,10792,831,9961,9080,145,3,310,4,59
10537,2527,660,1867,1542,112,5,72,0,29
10538,18318,1685,16633,14398,381,7,903,5,140
10540,19,10,9,1,6,0,0,0,0
10541,25651,3902,21749,19973,503,9,498,0,142
10542,85,29,56,36,7,0,9,0,0
10543,21296,5630,15666,12803,831,5,1105,0,175
10545,160,13,147,136,1,1,8,0,0
10546,1426,128,1298,954,49,0,229,0,5
10547,7293,1649,5644,4541,482,9,363,1,53
10548,3743,902,2841,2406,209,2,91,0,17
10549,16837,5008,11829,9840,514,21,862,1,109
10550,41137,8336,32801,1933,27624,89,621,11,893
10552,21296,4111,17185,6613,8305,30,656,8,445
10553,11281,1563,9718,356,8734,21,112,2,120
10560,4854,476,4378,4059,70,3,106,0,19
10562,34252,14112,20140,13551,3952,48,1521,5,216
10566,25384,11139,14245,7707,4687,32,725,5,235
10567,20400,4327,16073,12934,1373,17,921,1,135
10570,13986,1637,12349,10422,480,10,925,0,57
10573,41758,22284,19474,15097,1500,25,1458,0,421
10576,5099,347,4752,4257,66,3,167,0,21
10577,6008,801,5207,3331,358,3,1276,2,17
10578,721,107,614,538,12,0,22,0,3
10579,8633,1150,7483,6739,205,5,177,4,46
10580,18268,1501,16767,14433,199,14,1290,4,66
10583,41589,2822,38767,27615,956,15,8163,2,291
10588,2430,391,2039,1731,85,3,116,1,15
10589,8510,532,7978,7391,88,0,284,0,24
10590,6556,567,5989,5371,92,4,208,0,36
10591,23301,8363,14938,11734,1108,18,1232,2,157
10594,5028,595,4433,4031,39,4,237,0,18
10595,7264,991,6273,5198,400,6,393,0,44
10596,1519,389,1130,1027,40,0,16,0,3
10597,1000,31,969,900,5,0,28,0,5
10598,29040,3659,25381,22086,870,20,1517,2,121
10601,11882,3702,8180,4408,1915,9,1385,1,92
10603,18033,5129,12904,6499,4089,13,1526,1,173
10604,11526,3351,8175,6409,690,10,693,2,82
10605,19438,3926,15512,12397,1257,6,1072,10,167
10606,16929,7804,9125,5117,2101,10,1232,0,186
10607,7441,2077,5364,2190,1866,12,975,1,74
10701,68704,34099,34605,13380,16138,124,2768,10,572
10703,22571,10262,12309,6708,3532,44,1262,6,183
10704,32426,9491,22935,16784,2795,50,2224,2,303
10705,41785,24792,16993,7333,6221,83,2066,6,428
10706,9339,1030,8309,6907,216,4,627,1,65
10707,10553,1299,9254,7396,655,3,823,2,64
10708,22299,3016,19283,15756,1170,9,1374,4,172
10709,10131,907,9224,7833,170,0,871,1,66
10710,26725,7187,19538,11841,3466,20,3396,5,203
10801,42949,17919,25030,11263,10005,60,1970,8,530
10803,13255,1705,11550,9105,733,11,856,10,178
10804,14455,1252,13203,10767,1164,8,666,6,116
10805,18479,6843,11636,7053,2937,26,923,5,197
10901,25145,4302,20843,16988,1526,44,1437,4,203
10910,34,1,33,29,1,0,1,0,0
10911,27,10,17,3,1,2,5,0,0
10913,5647,790,4857,4124,202,5,368,0,8
10914,605,111,494,423,27,2,18,0,2
10915,81,19,62,61,1,0,0,0,0
10916,4604,639,3965,3504,146,5,120,0,27
10917,1973,426,1547,1177,132,1,160,0,18
10918,12547,2283,10264,8155,1018,15,497,2,120
10919,1123,210,913,752,93,8,18,0,9
10920,8727,1509,7218,5383,362,8,1231,0,46
10921,4205,758,3447,2903,271,9,103,1,22
10922,1026,139,887,740,48,1,45,0,10
10923,9489,3707,5782,3535,1511,5,452,2,56
10924,14006,2985,11021,9413,708,27,466,1,65
10925,4341,568,3773,3415,74,11,86,0,40
10926,3645,932,2713,1714,512,1,323,2,23
10927,12323,8758,3565,2011,1047,24,271,3,61
10928,4637,1163,3474,2499,560,16,119,0,40
10930,9331,2021,7310,5589,710,10,514,0,218
10931,967,295,672,367,123,31,47,0,10
10932,47,5,42,41,1,0,0,0,0
10933,445,58,387,356,20,0,3,0,2
10940,52803,18977,33826,19634,9648,122,2011,10,513
10941,14549,3861,10688,6540,2722,51,647,1,148
10950,62741,7206,55535,41304,1915,71,1231,16,9364
10952,47426,1714,45712,41362,1838,31,741,3,920
10953,57,13,44,23,5,0,9,0,0
10954,24248,5137,19111,12168,2955,22,3215,2,170
10956,32499,4937,27562,20352,2327,24,3826,3,256
10958,3562,626,2936,2374,312,2,108,0,20
10960,14680,2472,12208,8296,2577,9,633,3,98
10962,5049,714,4335,3220,175,0,771,1,38
10963,3663,690,2973,2144,562,14,151,0,16
10964,1457,114,1343,1095,18,2,173,1,5
10965,15342,1654,13688,12491,249,4,550,1,97
10968,2435,288,2147,1767,71,0,187,1,31
10969,1282,207,1075,945,33,3,29,0,13
10970,11211,2854,8357,5422,1849,3,670,2,131
10973,2053,306,1747,1537,85,5,54,0,9
10974,3395,597,2798,2362,179,7,103,0,37
10975,267,61,206,171,21,0,2,0,5
10976,2269,374,1895,1411,202,0,227,0,10
10977,71049,16270,54779,36909,13382,131,2033,10,1034
10979,115,24,91,83,0,0,5,0,0
10980,13289,2977,10312,8503,862,10,497,3,83
10983,5777,823,4954,3913,110,9,700,0,39
10984,2680,741,1939,1449,279,0,143,0,10
10985,147,26,121,103,8,0,0,0,3
10986,1858,321,1537,1329,101,3,50,0,4
10987,4454,572,3882,3218,263,0,261,0,24
10988,603,56,547,493,22,0,3,0,8
10989,8993,1423,7570,5649,666,6,928,3,33
10990,19877,2467,17410,15527,757,26,323,2,118
10992,9301,2193,7108,5765,799,18,185,3,52
10993,5113,2723,2390,1103,911,5,262,0,14
10994,7242,947,6295,4909,252,5,893,0,51
10996,7276,764,6512,4996,725,42,434,28,16
10998,3588,483,3105,2833,95,7,37,0,24
11001,27662,4051,23611,15047,1496,48,6000,5,290
11003,43979,9743,34236,5900,19206,125,6442,16,929
11004,13608,1606,12002,4101,854,29,6325,8,275
11005,1945,46,1899,1808,16,0,43,0,5
11010,25013,4298,20715,16633,587,24,2757,6,208
11020,6363,532,5831,2094,406,3,3120,0,39
11021,19376,1279,18097,11230,397,14,5795,4,128
11023,10213,585,9628,7483,75,3,1622,0,87
11024,8623,788,7835,6670,154,0,530,4,48
11030,17898,1030,16868,12215,156,16,3941,4,70
11040,43075,4238,38837,16671,627,110,19955,18,426
11042,19,3,16,4,1,0,7,0,0
11050,31512,5634,25878,21027,490,16,3295,7,141
11096,9645,5187,4458,2033,1784,7,370,3,108
11101,48867,10942,37925,15169,6070,85,13928,36,567
11102,37468,10436,27032,16654,3019,77,5253,16,490
11103,37362,8964,28398,20304,603,26,5096,10,630
11104,27407,7899,19508,11062,514,18,6682,16,259
11105,38001,7372,30629,23902,790,26,4026,8,429
11106,41722,10781,30941,17448,2844,47,8180,19,668
11109,8400,829,7571,4687,262,1,2032,1,194
11201,69703,7866,61837,39730,7261,66,10407,9,508
11203,81824,5892,75932,4327,63118,154,1689,32,1096
11204,85885,10937,74948,42895,839,48,27443,17,1496
11205,50474,8103,42371,24411,10538,101,4150,21,1140
11206,91549,31978,59571,31919,17166,113,6411,38,1191
11207,100330,34236,66094,5031,53052,277,2078,39,1087
11208,101958,43870,58088,2054,35701,467,12662,27,2676
11209,73239,13371,59868,45261,1583,60,10002,7,626
11210,62805,5386,57419,18419,31565,98,2946,11,932
11211,68540,16186,52354,42328,2463,69,4066,22,939
11212,91574,16956,74618,1616,66476,229,841,29,842
11213,67217,7947,59270,16092,36680,84,1616,13,1468
11214,96560,14849,81711,37469,1285,56,39557,16,448
11215,67493,10231,57262,44402,2699,56,5556,19,532
11216,61251,7380,53871,18005,27812,119,3631,25,633
11217,42417,6902,35515,21259,7336,59,4017,21,347
11218,78642,14090,64552,37060,5686,96,16909,10,1273
11219,103447,12312,91135,57546,1025,52,26908,10,3553
11220,105797,38808,66989,13611,1744,100,49515,19,596
11221,89222,29570,59652,19077,31380,185,4222,66,795
11222,41957,6664,35293,29174,1298,49,2688,13,296
11223,83519,12303,71216,40556,3134,40,24483,7,630
11224,46019,8372,37647,21962,10005,56,4053,23,342
11225,58786,6419,52367,15192,30983,85,1895,12,901
11226,101727,17326,84401,13687,59232,198,4605,28,1086
11228,45906,6015,39891,20943,328,33,17679,10,179
11229,83669,7514,76155,48143,4355,67,20060,15,509
11230,91391,9344,82047,54236,6537,55,16123,14,1271
11231,37240,7029,30211,21822,3885,34,2209,18,279
11232,30181,14684,15497,7029,1991,35,5388,8,250
11233,75399,12805,62594,7631,48599,243,1656,16,614
11234,92133,8528,83605,33397,38230,126,7328,10,935
11235,88482,8564,79918,59068,2537,48,14468,16,568
11236,100687,7927,92760,3573,80746,150,1943,18,1030
11237,49418,28219,21199,12219,3160,103,3636,30,569
11238,60090,7222,52868,26363,17436,72,4729,17,561
11239,17038,3344,13694,2595,9873,33,424,0,130
11249,42024,7194,34830,28302,1934,41,2465,12,564
11354,61276,9785,51491,7441,1894,27,41026,9,291
11355,89465,12228,77237,4751,1984,63,69106,7,445
11356,28310,12086,16224,5329,415,31,9864,3,170
11357,42319,6232,36087,22801,380,12,12061,7,222
11358,40435,7462,32973,11437,471,12,20298,6,177
11359,0,0,0,0,0,0,0,0,0
11360,20039,2253,17786,10320,365,11,6596,2,126
11361,29116,4334,24782,10172,799,15,13073,6,158
11362,18139,1724,16415,7109,336,11,8548,2,90
11363,7208,780,6428,3294,72,5,2810,0,35
11364,37032,3783,33249,10550,1007,21,20694,0,235
11365,46908,8546,38362,10197,3867,66,22692,5,391
11366,14430,1928,12502,4758,777,10,6305,4,214
11367,43112,6809,36303,17792,3274,57,13334,7,562
11368,117110,89135,27975,4417,8172,195,12848,21,1029
11369,40805,26273,14532,2413,5171,86,5709,9,495
11370,34683,14711,19972,8098,2772,36,8230,13,354
11371,0,0,0,0,0,0,0,0,0
11372,68000,36755,31245,11028,1104,99,16857,16,763
11373,105712,42005,63707,5420,1589,133,54436,18,716
11374,47129,9037,38092,18561,1395,62,15284,4,639
11375,72851,10801,62050,34261,2132,37,21575,11,850
11377,91512,32539,58973,16647,2567,96,37026,20,815
11378,38288,12486,25802,18233,541,27,6107,13,331
11379,37906,8180,29726,23271,434,31,5017,7,221
11385,100883,43183,57700,44151,2842,97,7478,35,896
11411,19579,1419,18160,270,16421,64,313,7,250
11412,37958,3601,34357,388,29646,145,1334,25,759
11413,42978,3645,39333,621,35272,163,579,14,601
11414,27320,6865,20455,17123,842,28,1584,10,259
11415,20241,5299,14942,8279,1569,40,3840,0,390
11416,28381,11414,16967,2595,1700,304,9341,13,1549
11417,31229,11246,19983,5193,2580,378,8144,6,1989
11418,37596,16711,20885,5418,2914,372,8223,45,2039
11419,47430,8495,38935,1867,6056,1405,16693,73,7579
11420,47383,9120,38263,2492,10483,1457,11330,97,6671
11421,42586,25004,17582,5735,1739,148,7797,22,1107
11422,32839,3324,29515,982,25587,114,720,10,519
11423,31985,5138,26847,2442,11061,330,8378,38,2490
11424,0,0,0,0,0,0,0,0,0
11426,19343,3111,16232,4848,1027,69,9294,13,436
11427,24555,3997,20558,3605,5063,154,9324,32,1297
11428,19516,4418,15098,1449,3973,265,5982,21,1902
11429,25895,3568,22327,557,17565,110,1991,16,724
11430,571,139,432,74,337,1,6,0,3
11432,65743,14933,50810,6949,9791,279,29313,69,2020
11433,39071,7483,31588,497,20833,292,6421,45,1367
11434,66964,7223,59741,926,50652,393,2552,57,1486
11435,58980,18245,40735,6261,12781,676,15391,38,2647
11436,20620,3042,17578,333,10773,428,2419,50,1648
11439,2376,436,1940,1160,469,2,167,0,10
11451,1,0,1,1,0,0,0,0,0
11501,21189,4094,17095,12814,519,13,2902,3,209
11507,7449,544,6905,3503,62,5,3118,1,52
11509,2433,123,2310,2183,4,0,43,0,22
11510,34617,7581,27036,10877,12645,52,1592,8,536
11514,4635,683,3952,3177,152,6,437,0,44
11516,8394,1085,7309,6718,159,0,202,0,84
11518,10869,1502,9367,8495,272,6,312,0,50
11520,45121,21646,23475,7694,13049,89,797,20,554
11530,28851,2079,26772,23539,392,17,2038,7,129
11542,29171,9831,19340,15408,1598,58,1527,2,179
11545,12008,979,11029,9262,119,9,1294,1,73
11547,995,69,926,810,8,0,82,0,4
11548,2313,203,2110,1665,25,0,329,0,19
11549,2337,246,2091,1458,266,4,196,8,24
11550,61901,30606,31295,4262,23460,151,1315,19,647
11552,24903,4757,20146,12031,5280,44,1635,0,385
11553,26929,12275,14654,2143,10941,63,617,4,253
11554,37796,6048,31748,22039,1668,39,6758,11,317
11556,18,7,11,3,2,0,0,0,0
11557,8659,1003,7656,6380,327,7,651,1,58
11558,8954,2294,6660,5692,244,15,381,8,99
11559,8709,1142,7567,6860,246,2,172,1,133
11560,6860,1136,5724,5162,101,1,266,1,32
11561,39132,5610,33522,29237,1837,42,1162,21,280
11563,23349,4222,19127,15270,1509,23,1456,1,167
11565,8845,1143,7702,6349,492,11,518,0,118
11566,35147,3459,31688,28403,670,11,1610,2,216
11568,4168,311,3857,2162,568,3,956,0,23
11569,1527,62,1465,1407,8,0,18,0,4
11570,29023,3623,25400,21148,2640,36,694,0,150
11572,31157,4385,26772,24066,611,18,1134,1,204
11575,18048,8178,9870,355,8695,32,180,6,172
11576,12962,674,12288,8866,119,6,2934,2,53
11577,12695,1254,11441,7427,451,17,3156,2,83
11579,5039,461,4578,4153,82,2,146,1,14
11580,43026,9896,33130,9345,12522,164,8277,19,1073
11581,23183,4295,18888,10515,3897,43,3206,11,505
11590,47838,16031,31807,16165,8696,62,5424,7,340
11596,10849,919,9930,7135,90,6,2327,2,67
11598,14515,836,13679,12406,437,7,459,4,169
11691,64673,17400,47273,13960,27770,250,1526,45,1138
11692,22776,5438,17338,2473,12188,119,1102,14,361
11693,12467,2708,9759,5527,3164,27,457,0,174
11694,19780,2895,16885,14009,1738,16,455,10,175
11697,4468,149,4319,4219,6,2,13,0,24
11701,27831,7971,19860,9408,8826,108,461,10,271
11702,14580,1386,13194,12069,297,9,350,1,76
11703,16635,3100,13535,10239,1687,21,993,1,132
11704,40367,7987,32380,24138,5398,76,1376,4,236
11705,7951,704,7247,6722,142,4,136,2,33
11706,66263,29735,36528,22123,9077,143,2815,16,670
11709,6748,704,6044,5691,32,3,140,1,21
11710,35155,3772,31383,27290,804,9,2156,3,173
11713,10970,3034,7936,4976,2033,95,286,1,76
11714,22989,2681,20308,16667,239,7,2789,7,101
11715,4423,258,4165,3953,38,3,45,0,19
11716,10315,1098,9217,8453,178,2,354,0,15
11717,62193,46897,15296,5806,6759,91,1134,6,705
11718,3181,250,2931,2718,82,0,46,0,3
11719,3447,330,3117,2747,194,10,36,0,13
11720,28623,4746,23877,19562,884,31,2492,6,121
11721,6318,345,5973,5578,35,4,129,1,42
11722,37491,22300,15191,5528,7157,98,1122,11,474
11724,3268,217,3051,2776,14,1,128,0,13
11725,28838,2330,26508,23145,512,21,2084,4,145
11726,20763,9920,10843,6980,2764,50,401,1,184
11727,29716,5967,23749,16604,4167,43,1652,7,195
11729,28569,5206,23363,14979,3977,75,3296,1,266
11730,14523,1509,13014,12069,223,9,319,0,62
11731,30353,2930,27423,24605,441,18,1488,4,133
11732,3638,278,3360,2982,46,0,229,2,14
11733,17967,1571,16396,13691,220,13,1832,4,84
11735,32989,5446,27543,22948,1441,24,2211,14,190
11738,16732,2914,13818,11754,613,9,847,4,107
11739,1385,92,1293,1230,15,1,19,0,0
11740,9593,983,8610,7373,433,5,481,0,41
11741,27046,3272,23774,21199,678,20,1167,3,132
11742,12699,1669,11030,9595,300,12,752,1,64
11743,41522,4870,36652,31149,2199,26,1917,5,213
11746,69040,19076,49964,36291,4602,65,6748,13,502
11747,20133,1402,18731,15289,853,14,2003,3,79
11749,3567,1135,2432,1651,437,5,219,0,28
11751,14790,2226,12564,11109,538,17,431,2,83
11752,9758,1619,8139,7315,299,20,244,1,50
11753,13084,434,12650,5698,207,5,6431,2,63
11754,18472,1513,16959,15634,201,7,629,0,80
11755,12118,1387,10731,9094,305,9,959,0,44
11756,42501,7567,34934,27637,599,64,5213,6,257
11757,45157,8646,36511,32438,1354,39,1365,0,236
11758,54226,5547,48679,43346,2554,30,1265,5,215
11762,22439,1648,20791,19667,161,12,444,0,83
11763,29055,7627,21428,16767,2690,64,843,6,177
11764,12566,962,11604,10705,183,10,357,7,35
11765,701,99,602,520,17,0,41,0,0
11766,11888,980,10908,9832,155,15,597,0,42
11767,14379,1355,13024,11548,268,12,771,0,92
11768,21433,1328,20105,18896,139,11,459,1,77
11769,9250,655,8595,8145,101,6,129,2,20
11770,331,36,295,242,21,1,7,0,5
11771,10322,1613,8709,7598,267,10,530,2,32
11772,44459,11588,32871,28045,2314,89,979,10,193
11776,24205,4676,19529,16742,910,23,1028,3,141
11777,9346,863,8483,7365,129,3,602,2,54
11778,12449,1538,10911,10068,154,13,229,3,30
11779,38250,5674,32576,27382,1281,33,2447,15,325
11780,15508,1191,14317,13201,117,12,600,2,40
11782,15682,1044,14638,13727,175,10,284,4,59
11783,21299,1875,19424,18118,175,5,573,0,84
11784,24794,4714,20080,16277,1079,40,1772,3,162
11786,6287,515,5772,5306,81,3,159,0,22
11787,35361,3264,32097,29062,466,7,1444,0,172
11788,16273,1863,14410,12174,465,10,1314,1,82
11789,7640,783,6857,6309,127,13,138,5,22
11790,21519,1917,19602,12348,3150,3,3119,2,157
11791,25879,1279,24600,14919,182,20,8743,4,97
11792,8528,741,7787,7219,149,0,140,0,34
11793,32121,2994,29127,27057,252,7,987,0,143
11794,1779,283,1496,481,572,2,335,0,20
11795,25344,2445,22899,21694,141,6,497,2,45
11796,3676,274,3402,3226,40,2,46,0,4
11797,9452,532,8920,6988,126,2,1623,0,43
11798,17215,6199,11016,1043,8703,45,447,0,210
11801,41779,7777,34002,18317,736,76,13529,7,312
11803,30049,1780,28269,21567,133,24,5837,1,111
11804,4972,254,4718,4038,16,0,529,0,16
11901,30936,11123,19813,15465,3018,70,358,7,168
11930,2062,207,1855,1713,42,2,25,2,25
11931,40,2,38,36,0,0,2,0,0
11932,2129,316,1813,1509,184,2,43,0,9
11933,6899,1062,5837,5172,385,13,50,1,32
11934,8364,1156,7208,6606,227,7,108,0,22
11935,3432,420,3012,2879,36,1,28,1,10
11937,19968,6190,13778,12344,440,39,345,8,114
11939,1048,109,939,881,11,2,11,1,6
11940,5396,524,4872,4533,99,6,73,0,32
11941,2605,344,2261,2117,37,1,20,2,11
11942,5571,1030,4541,4275,38,5,78,0,24
11944,4801,1337,3464,2975,282,4,53,0,27
11946,15535,5933,9602,8838,168,27,182,1,111
11947,55,0,55,52,0,0,2,0,0
11948,1212,211,1001,964,3,4,9,0,7
11949,14663,1501,13162,12065,334,12,258,0,59
11950,16233,4855,11378,8383,1533,258,410,10,130
11951,13827,3037,10790,8005,1745,63,205,4,86
11952,4701,560,4141,3891,68,3,47,1,15
11953,13249,1886,11363,8567,1846,59,389,7,73
11954,4318,804,3514,3195,86,5,62,2,34
11955,3258,410,2848,2271,350,8,66,0,22
11956,405,38,367,355,1,0,3,2,1
11957,1004,42,962,920,2,4,10,0,3
11958,691,105,586,543,13,0,6,0,6
11959,1657,132,1525,1364,43,14,59,0,7
11960,1688,148,1540,1459,13,0,16,0,6
11961,13042,1203,11839,10297,772,14,328,2,55
11962,1099,82,1017,903,17,9,40,0,12
11963,8384,968,7416,6719,276,19,131,0,36
11964,2470,234,2236,2111,12,0,35,0,3
11965,766,51,715,655,9,0,10,0,2
11967,26213,6127,20086,16214,1894,71,706,2,193
11968,14467,2761,11706,9616,465,741,345,3,106
11970,454,54,400,389,2,0,1,0,0
11971,6105,765,5340,5020,66,3,79,0,21
11972,1013,152,861,800,18,0,16,0,3
11973,17,1,16,4,4,0,0,0,3
11975,656,107,549,490,15,1,18,0,6
11976,2764,231,2533,2282,21,5,102,1,15
11977,2837,380,2457,2329,33,1,28,0,12
11978,4087,885,3202,2856,116,11,88,0,28
11980,4931,621,4310,3731,217,6,134,0,49
12007,260,11,249,241,3,0,1,0,0
12008,475,20,455,395,10,1,12,0,7
12009,7874,271,7603,6667,123,13,338,1,50
12010,28845,6642,22203,19515,826,54,367,4,149
12015,3509,185,3324,3003,71,4,49,0,15
12017,358,6,352,327,1,0,8,0,3
12018,7626,174,7452,7061,36,6,42,1,25
12019,15826,514,15312,13936,194,14,550,0,31
12020,34667,1329,33338,30238,541,56,745,18,89
12022,896,22,874,821,20,2,0,0,0
12023,2036,58,1978,1827,9,3,10,0,7
12024,172,9,163,151,4,0,2,0,0
12025,5356,137,5219,4928,31,8,26,0,10
12027,3958,107,3851,3625,18,4,52,0,13
12028,1078,40,1038,988,7,2,5,0,2
12029,1029,45,984,907,10,2,14,0,1
12031,118,3,115,113,0,0,0,0,2
12032,834,12,822,784,0,1,3,0,1
12033,8076,296,7780,7175,126,9,73,0,32
12035,692,27,665,642,0,2,0,0,0
12036,232,10,222,208,1,1,1,0,1
12037,3895,165,3730,3424,83,7,39,0,15
12040,38,2,36,30,0,0,0,0,1
12041,425,9,416,388,5,0,5,0,1
12042,403,9,394,361,5,0,5,0,0
12043,7883,392,7491,6914,138,16,105,2,26
12045,662,44,618,539,24,5,4,0,3
12046,646,12,634,582,4,0,9,0,7
12047,23347,1283,22064,17861,1507,44,1249,2,121
12051,5771,755,5016,3549,1202,22,38,1,19
12052,1535,40,1495,1370,9,5,14,0,9
12053,4142,110,4032,3802,18,9,9,1,13
12054,17282,654,16628,14866,346,15,674,1,49
12056,2192,76,2116,2023,4,3,6,0,2
12057,1842,47,1795,1700,2,9,14,0,4
12058,1523,59,1464,1339,18,6,2,0,4
12059,1482,29,1453,1360,11,1,5,2,5
12060,1411,38,1373,1285,19,1,11,0,16
12061,9404,333,9071,7742,290,7,601,0,31
12062,1878,63,1815,1685,10,6,13,0,5
12063,443,8,435,408,5,2,3,0,2
12064,427,13,414,395,0,0,0,0,1
12065,43893,2148,41745,34881,1189,40,3262,11,210
12066,2007,37,1970,1831,14,1,7,0,7
12067,1513,68,1445,1322,9,3,28,0,12
12068,2899,107,2792,2605,22,5,18,0,3
12069,225,10,215,205,4,0,2,0,1
12070,1475,74,1401,1290,12,1,11,0,9
12071,277,1,276,262,0,2,0,0,0
12072,3016,113,2903,2712,32,1,18,0,8
12074,2901,37,2864,2702,13,1,16,0,8
12075,3135,106,3029,2826,42,6,14,0,10
12076,1247,46,1201,1139,6,2,4,0,2
12077,6739,289,6450,5469,310,6,394,0,24
12078,23009,1025,21984,19835,581,40,150,0,76
12082,28,4,24,21,1,0,0,0,0
12083,3592,103,3489,3284,28,4,19,0,8
12084,4658,179,4479,2647,291,9,1351,11,24
12085,554,20,534,456,39,0,27,0,4
12086,1698,83,1615,1538,12,0,8,0,2
12087,1131,33,1098,1037,11,0,3,0,6
12090,6223,168,6055,5571,57,13,82,3,21
12092,1241,33,1208,1103,9,2,10,0,5
12093,1576,68,1508,1395,6,3,9,0,5
12094,2337,33,2304,2158,2,12,6,0,1
12095,12242,613,11629,10606,306,21,134,1,40
12106,2137,98,2039,1941,14,2,18,6,10
12108,415,5,410,390,3,1,2,0,0
12110,19682,839,18843,14351,1223,23,2364,6,61
12115,190,6,184,171,2,0,2,0,0
12116,1713,31,1682,1596,15,3,8,0,1
12117,2831,65,2766,2638,12,3,6,0,13
12118,16618,538,16080,14476,223,23,599,3,35
12120,593,20,573,544,0,0,3,0,10
12121,1767,24,1743,1631,7,3,6,0,3
12122,3763,112,3651,3439,11,5,23,0,25
12123,5096,179,4917,4544,55,11,34,0,17
12124,443,12,431,385,9,1,2,0,6
12125,1478,83,1395,1198,64,0,23,0,16
12130,845,37,808,736,8,3,8,0,0
12131,135,4,131,121,1,1,1,0,3
12132,130,4,126,121,0,0,0,0,0
12134,3560,92,3468,3295,6,3,8,0,8
12136,927,36,891,833,10,0,8,0,3
12137,1704,55,1649,1521,11,6,8,0,9
12138,3012,70,2942,2776,4,0,14,0,16
12139,266,0,266,259,0,0,0,0,0
12140,1639,38,1601,1534,11,0,5,0,1
12143,4903,265,4638,4078,209,0,33,0,38
12144,21277,1194,20083,15823,1342,46,1641,6,100
12147,521,7,514,493,9,0,1,0,0
12148,4935,158,4777,4060,89,4,403,0,31
12149,2294,97,2197,2027,29,11,7,0,12
12150,799,40,759,721,5,0,9,0,0
12151,957,51,906,789,10,3,40,0,5
12153,818,24,794,725,6,1,8,0,8
12154,2669,55,2614,2423,16,10,11,0,6
12155,1753,46,1707,1615,10,3,3,0,6
12156,853,34,819,758,6,0,6,0,6
12157,4109,84,4025,3795,28,5,15,0,13
12158,6373,316,6057,5343,214,3,159,4,18
12159,8524,295,8229,6853,220,5,758,3,46
12160,938,47,891,816,5,5,8,0,1
12161,75,8,67,60,0,0,0,0,0
12164,487,11,476,441,9,0,10,0,2
12165,146,10,136,130,1,0,0,0,0
12166,1500,32,1468,1393,4,2,10,0,6
12167,2342,110,2232,2060,45,6,24,0,5
12168,1681,60,1621,1527,9,0,8,1,2
12169,445,16,429,390,2,4,1,0,2
12170,4964,172,4792,4460,48,8,39,0,20
12172,381,33,348,293,25,0,3,1,1
12173,1732,114,1618,1482,33,3,12,1,7
12174,260,8,252,236,4,1,6,0,0
12175,725,19,706,664,5,0,2,0,3
12176,292,12,280,268,1,2,1,0,1
12177,400,14,386,360,1,0,4,0,0
12180,55907,5247,50660,36261,7965,108,2857,6,307
12182,14657,1132,13525,10506,1686,50,130,0,80
12183,2934,137,2797,2102,211,14,195,0,13
12184,7178,415,6763,6258,106,6,106,0,20
12185,2059,40,2019,1894,11,3,7,0,6
12186,6485,183,6302,5815,56,7,144,0,30
12187,571,19,552,504,8,2,2,0,5
12188,11035,305,10730,9654,171,14,313,0,54
12189,18970,1220,17750,12369,2116,25,1887,3,129
12190,683,9,674,647,3,2,0,0,0
12192,1617,64,1553,1444,15,0,3,0,14
12193,1934,35,1899,1803,5,1,0,0,7
12194,176,4,172,160,0,1,0,0,0
12195,97,0,97,97,0,0,0,0,0
12196,2930,88,2842,2617,13,1,34,0,8
12197,2176,101,2075,1934,10,2,12,0,9
12198,7548,155,7393,6857,112,2,117,0,19
12202,10257,1637,8620,2306,5148,44,536,4,62
12203,28210,2003,26207,19077,3178,42,2329,58,345
12204,7818,579,7239,3500,2474,14,843,0,40
12205,27168,1525,25643,19632,2050,36,2467,12,105
12206,17219,2360,14859,4027,7893,54,1666,40,182
12207,2399,288,2111,755,1107,5,94,2,19
12208,22118,1775,20343,13638,3334,35,2198,1,139
12209,10231,1489,8742,4394,2767,22,855,5,51
12210,10559,1137,9422,3913,4435,40,386,3,86
12211,13532,664,12868,10875,442,12,1069,1,35
12222,6149,1161,4988,3685,288,1,851,2,18
12226,20,3,17,9,4,0,4,0,0
12302,27618,1037,26581,24099,533,20,528,5,96
12303,30893,2498,28395,20065,2783,233,1811,21,1235
12304,21513,2290,19223,10719,3613,246,1774,30,1038
12305,6085,646,5439,3616,1138,43,189,5,80
12306,26935,1623,25312,21186,1408,61,569,27,331
12307,7567,1272,6295,1217,2674,165,603,28,741
12308,15285,1991,13294,7477,2888,92,907,14,614
12309,31273,1537,29736,22962,1459,65,3247,5,384
12401,35493,5028,30465,23699,3431,54,894,9,233
12404,3625,246,3379,3113,37,6,44,0,19
12405,571,53,518,485,7,0,5,0,4
12406,740,59,681,637,2,2,12,0,1
12407,95,3,92,91,0,0,0,0,0
12409,994,37,957,874,11,1,22,0,10
12410,416,40,376,334,7,2,5,0,8
12411,419,25,394,354,7,0,4,0,4
12412,627,54,573,497,6,0,12,1,8
12413,2914,194,2720,2496,45,14,25,0,27
12414,10163,777,9386,7895,585,16,142,2,54
12416,208,20,188,164,1,1,3,0,1
12417,748,67,681,573,52,0,6,0,4
12418,558,27,531,503,1,3,7,0,0
12419,660,18,642,584,22,0,10,0,4
12420,175,14,161,144,2,0,2,0,3
12421,334,8,326,291,4,0,9,0,0
12422,354,14,340,323,3,1,1,0,2
12423,940,56,884,844,7,4,5,0,4
12424,249,15,234,208,3,1,6,0,2
12427,905,31,874,840,2,0,2,0,3
12428,6969,1871,5098,3827,691,19,120,1,52
12429,329,13,316,288,9,0,0,0,4
12430,999,115,884,814,13,4,6,0,15
12431,1639,91,1548,1434,11,2,15,0,3
12432,507,35,472,445,11,0,7,0,0
12433,403,10,393,363,5,0,11,0,1
12434,622,19,603,573,13,2,5,0,0
12435,276,72,204,171,13,2,4,0,0
12436,451,25,426,399,4,0,4,0,2
12438,56,7,49,43,0,1,0,0,0
12439,401,18,383,356,6,0,6,0,4
12440,1863,132,1731,1570,35,2,19,0,15
12441,130,18,112,97,6,1,0,0,0
12442,752,57,695,626,2,5,28,0,1
12443,3868,276,3592,3231,99,38,74,1,11
12444,430,14,416,380,3,0,8,0,1
12446,4930,389,4541,4039,95,8,78,2,43
12448,255,11,244,233,3,0,1,0,3
12449,3386,356,3030,2613,142,6,87,0,18
12450,171,15,156,136,0,3,3,0,1
12451,1560,69,1491,1377,19,3,23,0,8
12452,48,0,48,43,0,0,0,0,0
12453,271,28,243,233,0,0,4,0,0
12454,233,14,219,212,3,0,4,0,0
12455,1820,145,1675,1559,8,11,20,1,6
12456,590,40,550,505,7,0,6,0,0
12457,738,37,701,634,4,1,21,0,14
12458,3488,710,2778,1776,821,26,45,1,15
12459,172,12,160,144,0,0,1,0,1
12460,281,9,272,260,2,0,0,0,0
12461,1661,105,1556,1435,22,3,15,0,10
12463,1405,70,1335,1213,20,3,21,0,5
12464,955,76,879,781,12,1,21,1,21
12465,288,17,271,250,3,0,2,0,3
12466,2353,166,2187,1891,116,0,46,0,14
12468,1417,37,1380,1265,15,0,12,0,9
12469,697,21,676,635,5,1,7,0,2
12470,648,21,627,587,8,0,2,0,0
12471,231,17,214,194,1,0,1,0,1
12472,1519,80,1439,1296,26,0,26,0,10
12473,931,53,878,798,17,3,3,0,3
12474,1128,35,1093,1048,9,0,6,0,0
12475,373,36,337,299,7,0,4,0,0
12477,18559,1442,17117,15438,395,22,280,2,75
12480,604,34,570,509,6,1,5,0,5
12481,1259,63,1196,1104,15,3,28,0,8
12482,599,58,541,482,6,0,7,0,0
12483,191,45,146,116,5,0,3,0,2
12484,2809,144,2665,2442,28,8,60,0,16
12485,939,49,890,805,7,3,25,0,12
12486,1457,90,1367,1247,19,0,19,0,13
12487,3508,185,3323,3018,132,1,26,0,10
12489,267,30,237,205,9,1,0,0,1
12490,70,0,70,65,3,0,0,0,0
12491,1782,84,1698,1533,22,1,41,0,11
12492,296,16,280,263,0,0,3,0,1
12493,426,51,375,313,21,0,4,0,3
12494,712,34,678,621,5,0,4,0,9
12495,212,18,194,168,7,3,5,0,4
12496,1508,109,1399,1273,22,0,28,0,13
12498,4845,288,4557,4091,93,9,106,0,18
12501,2125,286,1839,1621,54,5,39,0,12
12502,1146,45,1101,972,20,1,19,0,9
12503,675,29,646,605,8,1,4,0,7
12504,333,35,298,218,17,1,48,0,4
12507,166,11,155,135,0,0,8,0,1
12508,19537,3768,15769,11337,3016,28,379,11,159
12512,143,31,112,73,12,0,4,2,4
12513,621,22,599,569,9,0,1,0,1
12514,2784,137,2647,2460,38,2,35,0,20
12515,1349,176,1173,1015,64,4,12,0,16
12516,1722,88,1634,1502,19,1,21,0,10
12517,430,36,394,352,13,0,1,0,9
12518,5622,689,4933,4326,211,3,169,0,30
12520,3287,307,2980,2643,76,7,66,1,21
12521,1636,91,1545,1393,30,0,15,0,5
12522,4993,871,4122,3639,156,10,84,0,22
12523,1819,96,1723,1565,29,2,15,0,13
12524,15617,2272,13345,10445,1390,24,858,6,100
12525,3359,306,3053,2749,62,2,60,0,21
12526,3687,204,3483,3204,53,3,38,2,16
12527,108,23,85,68,9,0,2,0,0
12528,14089,1553,12536,10673,777,18,363,12,78
12529,2755,137,2618,2409,41,0,22,0,15
12530,81,0,81,76,0,0,0,0,0
12531,3267,374,2893,2579,96,2,62,0,22
12533,26147,3362,22785,19439,1103,21,1158,2,153
12534,17539,1389,16150,12286,1716,25,979,6,133
12538,14181,1333,12848,10290,1095,29,670,0,91
12540,7666,701,6965,6262,200,5,217,4,30
12542,5726,737,4989,4384,293,2,69,0,30
12543,3170,801,2369,1755,414,2,43,0,19
12544,156,2,154,150,2,0,0,0,0
12545,4741,475,4266,3759,203,10,76,1,17
12546,3026,410,2616,2375,46,4,53,1,9
12547,2934,322,2612,2263,223,2,30,0,8
12548,1334,169,1165,1014,50,0,17,0,11
12549,10349,1519,8830,7673,530,12,150,1,63
12550,55869,21048,34821,20063,11264,107,1101,11,388
12553,26728,6908,19820,13819,3765,37,1103,13,160
12561,18726,2092,16634,13930,853,23,849,9,256
12563,7586,1753,5833,5088,312,6,183,1,37
12564,7159,1130,6029,5397,203,11,132,3,43
12565,1402,61,1341,1220,38,3,6,0,12
12566,10923,1381,9542,8607,294,19,124,3,59
12567,2564,148,2416,2207,23,5,37,0,12
12569,10177,954,9223,8024,419,7,238,2,79
12570,6825,738,6087,5517,188,2,151,3,16
12571,9600,638,8962,8188,132,12,221,1,28
12572,9258,613,8645,7886,131,6,196,2,46
12574,299,13,286,275,0,0,0,0,0
12575,2478,479,1999,1633,154,6,56,3,36
12577,2280,420,1860,1499,163,20,61,0,18
12578,2298,150,2148,1923,44,1,36,1,19
12580,4204,269,3935,3516,147,0,65,1,11
12581,2091,150,1941,1812,23,4,20,1,3
12582,6148,942,5206,3735,1137,19,142,0,29
12583,2212,179,2033,1852,23,3,49,0,14
12585,850,64,786,713,25,0,9,0,4
12586,13087,2564,10523,8687,856,26,253,4,76
12589,16935,3430,13505,11062,1587,22,197,4,107
12590,37051,6545,30506,24384,2855,53,1673,6,239
12592,1230,121,1109,972,21,7,26,0,4
12594,4018,776,3242,2670,223,2,174,0,15
12601,44264,8629,35635,19596,12100,81,1285,14,282
12603,41470,6041,35429,26219,4976,35,2175,6,289
12604,2011,219,1792,1142,74,2,345,0,193
12701,12360,3112,9248,5582,2372,33,433,3,139
12719,1056,67,989,923,11,2,8,0,6
12720,179,21,158,149,0,0,0,0,3
12721,7504,981,6523,5709,275,18,90,0,62
12722,120,15,105,101,0,0,0,0,0
12723,1687,135,1552,1311,139,5,24,0,13
12724,215,4,211,199,0,0,3,0,0
12725,287,27,260,219,13,2,2,0,3
12726,1168,66,1102,1020,19,0,8,0,6
12729,1708,159,1549,1233,45,6,160,0,15
12732,735,53,682,638,5,2,5,0,4
12733,1887,302,1585,1138,340,6,28,0,50
12734,870,237,633,518,46,4,10,0,11
12736,114,3,111,111,0,0,0,0,0
12737,1765,158,1607,1445,29,8,23,0,2
12738,270,46,224,192,7,0,9,0,2
12740,1714,116,1598,1486,17,4,27,0,1
12741,251,11,240,223,10,0,1,0,1
12742,200,34,166,132,10,0,6,0,1
12743,347,23,324,311,1,2,2,0,0
12745,62,7,55,47,1,0,1,0,1
12746,1010,85,925,768,31,10,70,0,3
12747,1849,354,1495,1202,122,0,82,1,13
12748,1890,147,1743,1642,25,1,12,0,3
12749,293,50,243,216,7,0,3,0,3
12750,148,14,134,125,0,0,0,0,0
12751,1151,119,1032,907,47,0,22,0,26
12752,283,21,262,251,1,0,2,0,2
12754,7654,2315,5339,4187,592,22,140,0,40
12758,4033,399,3634,3271,71,7,86,0,13
12759,1568,267,1301,976,151,3,63,0,36
12760,477,26,451,415,9,1,4,0,0
12762,433,61,372,355,3,1,1,0,1
12763,891,167,724,620,47,4,6,0,8
12764,1717,110,1607,1464,44,3,32,0,6
12765,789,30,759,719,14,3,7,0,1
12766,458,27,431,391,5,5,9,0,3
12767,61,5,56,54,0,0,0,0,0
12768,958,148,810,729,16,5,11,0,5
12769,135,21,114,96,11,0,4,0,0
12770,176,13,163,156,0,0,1,0,3
12771,14423,1952,12471,10331,879,36,291,4,161
12775,2467,405,2062,1655,184,3,98,0,25
12776,1865,117,1748,1572,27,5,16,0,11
12777,710,36,674,606,18,0,21,1,3
12778,708,64,644,583,17,2,8,1,5
12779,2665,1472,1193,727,328,1,43,1,31
12780,2218,188,2030,1778,75,3,26,0,16
12781,106,13,93,85,0,0,7,0,0
12783,1388,238,1150,972,59,1,26,1,8
12784,34,11,23,17,6,0,0,0,0
12785,749,77,672,591,21,8,17,1,1
12786,711,87,624,573,16,0,11,1,2
12787,259,27,232,216,4,0,0,0,0
12788,3596,847,2749,1921,642,9,53,0,10
12789,1930,440,1490,1159,189,2,35,0,13
12790,4817,582,4235,3624,166,9,94,0,34
12791,547,44,503,458,4,1,15,0,2
12792,311,27,284,251,13,0,3,0,0
12801,14850,554,14296,12974,299,40,166,0,42
12803,8990,235,8755,8101,92,15,66,3,24
12804,27790,742,27048,25028,310,62,420,0,89
12808,343,3,340,326,2,0,3,0,0
12809,3426,56,3370,3163,16,3,1,1,9
12810,556,9,547,526,4,0,1,0,2
12811,209,1,208,199,0,0,1,0,0
12812,173,7,166,163,1,0,0,0,0
12814,1348,27,1321,1248,15,0,4,0,3
12815,938,11,927,883,4,0,5,0,0
12816,4366,79,4287,4033,33,3,34,2,11
12817,2142,55,2087,1994,9,4,6,0,11
12819,297,5,292,278,0,0,0,0,0
12820,21,0,21,21,0,0,0,0,0
12821,2447,493,1954,730,1161,29,17,0,3
12822,6282,109,6173,5790,21,13,15,3,27
12823,243,5,238,229,0,0,0,0,0
12824,801,11,790,745,8,1,5,0,2
12827,3878,73,3805,3587,15,7,7,0,12
12828,9442,227,9215,8604,49,24,40,5,30
12831,17483,516,16967,15606,175,33,262,2,65
12832,6559,86,6473,6118,31,13,36,2,6
12833,4686,161,4525,4174,40,11,16,2,19
12834,6396,163,6233,5856,30,13,30,6,22
12835,2575,43,2532,2383,8,10,8,0,4
12836,528,8,520,503,0,0,1,0,0
12837,746,6,740,721,1,1,0,0,0
12838,560,10,550,526,2,1,3,0,2
12839,13618,310,13308,12106,197,34,112,6,35
12841,81,0,81,79,0,0,0,0,0
12842,1154,15,1139,1074,11,5,0,0,2
12843,542,5,537,508,3,1,5,0,0
12844,303,6,297,272,6,0,2,0,2
12845,4873,139,4734,4445,46,4,52,0,17
12846,3008,45,2963,2764,3,4,15,0,7
12847,692,27,665,635,3,0,0,1,1
12849,421,2,419,397,4,0,2,0,0
12850,2786,95,2691,2494,32,3,14,1,5
12851,290,3,287,266,0,0,2,0,0
12852,418,14,404,386,0,0,5,0,0
12853,1489,20,1469,1355,5,9,9,0,4
12854,44,0,44,40,0,0,0,0,1
12855,230,1,229,219,0,0,4,0,0
12856,220,5,215,202,2,4,2,0,3
12857,571,5,566,530,0,0,2,0,2
12858,123,5,118,110,0,3,1,0,1
12859,2041,45,1996,1889,4,3,2,0,5
12860,579,19,560,526,1,0,2,0,2
12861,548,9,539,520,0,0,4,0,0
12862,102,2,100,96,0,0,1,0,0
12863,762,36,726,686,1,0,1,0,1
12864,36,5,31,29,0,0,0,0,0
12865,3394,92,3302,3130,18,12,12,0,7
12866,40355,1804,38551,34888,807,31,1012,14,169
12870,1652,34,1618,1514,5,1,18,0,5
12871,3934,135,3799,3556,35,2,15,1,12
12872,44,4,40,34,0,0,3,0,0
12873,760,26,734,673,7,1,4,0,2
12874,112,0,112,106,0,1,1,0,0
12878,705,17,688,648,3,1,2,0,1
12883,4808,87,4721,4421,15,12,40,0,16
12884,541,11,530,496,2,0,1,2,1
12885,4371,78,4293,4006,20,8,27,0,5
12886,179,5,174,151,0,1,1,0,2
12887,4966,118,4848,4609,19,17,18,0,5
12901,32147,1350,30797,27262,1104,92,631,14,159
12903,1810,60,1750,1570,47,8,53,0,11
12910,1985,118,1867,1610,172,4,8,1,1
12911,35,0,35,29,0,1,0,0,0
12912,1964,22,1942,1825,8,5,0,0,7
12913,1035,22,1013,957,3,5,0,0,0
12914,888,16,872,733,5,99,1,0,4
12915,41,0,41,38,1,0,0,0,0
12916,2340,30,2310,2174,2,41,4,0,9
12917,1430,13,1417,1378,3,5,4,0,2
12918,2424,39,2385,2267,7,6,10,1,8
12919,3011,62,2949,2747,24,21,24,0,7
12920,2352,32,2320,2241,11,12,4,0,5
12921,2270,45,2225,2068,25,8,16,0,1
12922,68,1,67,66,0,0,0,0,0
12923,523,2,521,496,0,0,1,0,2
12924,148,2,146,140,4,0,0,0,0
12926,2129,23,2106,2007,6,18,5,0,2
12927,249,3,246,233,0,2,0,0,2
12928,2030,38,1992,1907,3,3,5,0,5
12929,3292,574,2718,1485,1143,24,18,0,2
12930,707,7,700,673,0,2,0,0,0
12932,1342,28,1314,1246,6,0,1,0,7
12933,7,0,7,7,0,0,0,0,0
12934,1106,8,1098,1054,0,0,2,0,5
12935,1491,16,1475,1372,2,6,14,1,9
12936,655,8,647,610,5,3,1,0,5
12937,1406,29,1377,1106,3,186,3,0,0
12939,244,0,244,221,0,0,0,0,0
12941,1330,22,1308,1198,10,2,6,0,11
12942,651,7,644,614,0,2,4,0,0
12943,478,14,464,441,2,0,1,0,1
12944,4088,68,4020,3700,48,10,27,0,8
12945,531,10,521,478,1,2,6,0,7
12946,5217,136,5081,4695,51,9,80,0,14
12950,741,20,721,652,18,0,3,0,2
12952,497,16,481,464,0,0,2,0,2
12953,13731,896,12835,10742,1495,122,91,0,22
12955,371,11,360,336,0,0,3,0,2
12956,1350,61,1289,1164,66,5,4,0,4
12957,1663,18,1645,1575,3,12,3,0,1
12958,1866,27,1839,1731,3,11,8,0,3
12959,1382,13,1369,1295,1,4,4,1,2
12960,1009,26,983,945,12,0,1,0,1
12961,148,3,145,134,2,0,2,0,0
12962,5463,104,5359,5051,30,7,40,0,7
12964,170,7,163,153,0,0,0,0,0
12965,548,12,536,516,1,5,0,0,1
12966,2848,33,2815,2686,5,16,14,0,8
12967,1145,14,1131,1082,6,13,0,0,2
12969,413,5,408,384,1,3,0,0,0
12970,682,20,662,600,23,1,8,0,0
12972,6212,185,6027,5550,91,11,60,0,18
12973,131,0,131,128,0,0,1,0,0
12974,1537,40,1497,1407,2,3,12,2,3
12975,292,4,288,270,4,0,1,0,0
12976,215,3,212,199,2,0,0,0,0
12977,693,198,495,169,314,0,8,0,0
12978,323,8,315,282,0,1,1,0,2
12979,2321,45,2276,2154,21,8,7,3,0
12980,1292,26,1266,1169,5,14,0,0,2
12981,2215,27,2188,2066,8,5,11,0,5
12983,7073,162,6911,6367,82,19,45,0,30
12985,1079,13,1066,979,8,1,6,1,3
12986,5363,72,5291,5012,68,37,12,0,7
12987,296,6,290,280,4,0,0,0,2
12989,947,15,932,889,3,2,2,0,4
12992,4796,79,4717,4437,40,11,16,2,13
12993,1657,21,1636,1509,13,2,0,4,25
12996,1879,13,1866,1786,6,8,7,1,0
12997,1139,40,1099,1056,1,2,2,0,9
12998,569,18,551,505,3,0,0,0,3
13020,149,3,146,142,0,0,0,0,0
13021,38479,1136,37343,33261,1452,118,265,19,147
13024,1122,236,886,226,646,13,1,0,0
13026,1523,108,1415,1293,62,0,14,0,2
13027,34507,1103,33404,30649,663,98,419,9,109
13028,1217,9,1208,1158,5,4,0,0,2
13029,7118,187,6931,6325,82,21,97,0,20
13030,3754,81,3673,3442,21,28,21,2,10
13031,16335,504,15831,14472,402,45,283,6,30
13032,12336,245,12091,11216,107,91,41,3,40
13033,3763,50,3713,3468,14,13,3,8,11
13034,1836,55,1781,1678,19,2,3,0,12
13035,8226,260,7966,7482,98,16,48,2,28
13036,8601,139,8462,7950,40,35,32,1,22
13037,9230,198,9032,8423,72,36,81,0,29
13039,17485,432,17053,15493,382,64,332,3,49
13040,2507,47,2460,2277,13,5,6,0,11
13041,11724,349,11375,9807,514,34,441,1,28
13042,2447,52,2395,2248,7,5,16,0,4
13044,2506,30,2476,2324,5,8,4,0,14
13045,28406,1247,27159,23909,759,75,950,1,144
13051,111,2,109,101,0,0,1,0,0
13052,1653,25,1628,1547,10,3,2,0,2
13053,4605,193,4412,3830,207,15,56,0,18
13054,1388,10,1378,1288,9,19,1,0,3
13057,14676,501,14175,12452,510,82,393,0,55
13060,2584,93,2491,2347,7,7,16,1,6
13061,987,20,967,907,3,2,3,0,2
13062,237,10,227,200,4,0,9,0,2
13063,1902,55,1847,1762,7,7,8,1,5
13065,64,0,64,63,1,0,0,0,0
13066,12949,347,12602,11102,272,38,666,0,28
13068,5189,372,4817,4309,95,15,42,2,22
13069,24071,811,23260,21571,184,111,90,6,59
13071,953,52,901,869,4,0,1,0,2
13072,772,19,753,733,1,1,2,0,1
13073,6190,236,5954,5407,44,9,57,1,21
13074,4206,94,4112,3857,15,20,13,4,8
13076,2297,26,2271,2165,7,4,2,0,2
13077,6446,134,6312,5987,28,10,45,3,15
13078,10019,211,9808,8050,328,62,916,0,30
13080,3375,66,3309,3114,10,5,16,0,13
13081,1058,60,998,963,1,2,4,0,3
13082,4539,87,4452,4191,37,18,18,0,15
13083,1896,31,1865,1759,11,7,4,0,2
13084,4101,101,4000,3715,21,75,16,0,12
13087,183,3,180,173,1,0,0,0,0
13088,22331,876,21455,17878,1090,96,1338,2,87
13090,30472,1253,29219,24848,1739,88,1001,8,111
13092,2655,95,2560,2372,19,2,2,0,9
13101,2397,45,2352,2193,13,5,4,0,13
13102,69,1,68,61,0,0,0,0,0
13103,298,6,292,274,3,4,1,0,3
13104,16430,509,15921,13450,314,42,1419,0,57
13108,6054,101,5953,5666,28,11,40,0,14
13110,2236,50,2186,2010,10,21,11,0,7
13111,1609,32,1577,1505,9,1,2,1,3
13112,1889,56,1833,1703,9,12,11,0,2
13113,77,0,77,75,1,0,0,0,0
13114,6596,114,6482,6096,44,27,26,0,20
13115,195,5,190,179,1,0,0,0,0
13116,3657,94,3563,3290,40,20,52,0,14
13117,197,1,196,181,0,1,0,0,0
13118,5849,239,5610,4942,402,34,15,3,13
13119,52,2,50,43,0,0,0,0,0
13120,2536,141,2395,1667,170,355,21,1,48
13121,52,2,50,37,0,0,0,0,0
13122,1068,9,1059,991,6,4,4,0,11
13123,104,0,104,103,0,0,0,0,0
13124,91,2,89,76,0,0,0,0,1
13126,35477,1898,33579,30400,947,130,559,3,104
13131,3649,52,3597,3386,10,22,5,0,15
13132,3865,45,3820,3585,16,11,11,2,2
13134,64,0,64,61,3,0,0,0,0
13135,6303,136,6167,5724,19,20,42,4,6
13136,409,8,401,389,3,0,0,0,0
13138,55,2,53,44,0,0,2,0,0
13140,4044,84,3960,3699,14,7,11,5,18
13141,661,32,629,593,2,0,3,0,1
13142,6323,96,6227,5935,18,23,53,2,11
13143,2619,59,2560,2401,18,14,6,0,5
13144,1401,23,1378,1306,5,4,8,0,2
13145,1793,15,1778,1690,7,2,11,0,4
13146,2205,69,2136,2003,18,5,3,0,4
13147,1213,225,988,934,3,1,7,0,2
13148,10541,348,10193,9291,182,102,142,2,24
13152,7696,178,7518,7178,8,12,67,0,19
13153,309,2,307,288,0,0,1,0,3
13154,76,2,74,74,0,0,0,0,0
13155,605,46,559,526,0,0,2,0,1
13156,2231,21,2210,2088,6,4,2,3,0
13157,570,12,558,519,9,3,0,1,3
13158,1397,35,1362,1272,3,4,3,0,2
13159,5155,91,5064,4747,31,22,48,0,15
13160,1942,99,1843,1696,32,1,12,12,13
13162,251,0,251,239,0,6,1,0,1
13163,311,3,308,255,16,11,2,1,3
13164,2730,54,2676,2519,25,13,27,0,2
13165,10354,422,9932,9176,164,21,62,1,27
13166,5398,97,5301,4955,48,21,32,3,7
13167,3263,32,3231,3084,17,8,10,0,10
13202,6967,1031,5936,2165,2808,21,585,0,68
13203,16240,1640,14600,7536,4255,161,1501,8,81
13204,19752,3704,16048,8839,5130,253,189,7,106
13205,18834,1238,17596,6502,9229,214,499,1,89
13206,16599,1339,15260,10202,2969,118,698,1,129
13207,13140,1389,11751,5359,5222,147,84,4,78
13208,23603,1848,21755,10412,5688,223,3846,7,121
13209,13018,619,12399,11048,413,116,101,5,45
13210,23150,2178,20972,11859,5142,53,2688,23,162
13211,6382,353,6029,4915,369,47,251,2,13
13212,20220,755,19465,17305,557,86,446,0,80
13214,9072,531,8541,6436,1213,20,392,5,41
13215,15007,458,14549,12867,766,106,211,3,40
13219,15436,511,14925,13526,504,70,183,0,44
13224,8705,819,7886,4280,2737,36,322,1,53
13244,6975,681,6294,4902,685,0,413,4,21
13290,0,0,0,0,0,0,0,0,0
13301,90,2,88,80,0,0,0,0,2
13302,1594,15,1579,1463,6,12,5,0,3
13303,1140,10,1130,1095,3,1,12,0,0
13304,1573,27,1546,1476,3,0,11,0,7
13305,275,0,275,267,0,1,1,0,0
13308,3722,44,3678,3532,14,14,7,1,4
13309,5906,64,5842,5588,22,6,27,2,11
13310,591,6,585,539,3,4,1,0,0
13312,332,4,328,319,0,0,0,0,3
13313,520,5,515,470,7,1,0,0,1
13314,86,0,86,81,0,0,0,0,0
13315,1228,24,1204,1154,1,3,2,0,4
13316,6512,156,6356,5894,148,14,15,0,11
13317,3758,132,3626,3353,17,8,32,2,24
13318,1306,61,1245,1134,13,2,2,1,14
13319,795,38,757,719,3,0,8,1,3
13320,2068,22,2046,1956,9,3,6,0,4
13321,1026,22,1004,939,9,2,6,0,4
13322,1102,37,1065,993,7,0,7,3,5
13323,11415,444,10971,10019,176,6,345,4,23
13324,1963,36,1927,1814,3,4,8,1,3
13325,980,14,966,926,3,6,2,1,1
13326,4893,171,4722,4314,53,0,165,0,10
13327,2234,26,2208,2133,5,5,7,0,1
13328,1147,25,1122,1062,8,0,13,0,1
13329,3789,76,3713,3497,9,7,14,0,9
13331,210,2,208,193,1,1,3,0,0
13332,2471,30,2441,2320,7,0,3,0,8
13333,92,7,85,81,0,0,1,0,1
13334,1223,14,1209,1139,4,7,0,0,2
13335,1525,29,1496,1437,8,0,4,1,1
13337,686,20,666,628,5,1,12,0,2
13338,1187,21,1166,1129,2,6,1,0,2
13339,6646,178,6468,6057,57,8,21,1,7
13340,7652,192,7460,7025,80,17,30,3,15
13342,144,3,141,139,0,0,0,0,0
13343,1594,53,1541,1478,1,2,3,0,3
13345,192,0,192,179,4,0,0,0,0
13346,6427,306,6121,5277,158,7,356,0,18
13348,1323,27,1296,1208,1,0,12,0,6
13350,9513,356,9157,8190,322,11,126,6,29
13352,81,3,78,77,0,0,0,0,0
13353,92,0,92,88,0,0,0,0,0
13354,3339,52,3287,3156,8,3,16,0,6
13355,856,25,831,773,4,2,4,0,0
13357,10330,300,10030,9214,157,9,50,3,23
13360,350,9,341,333,0,4,0,0,0
13361,825,16,809,778,2,3,3,0,7
13363,2240,50,2190,2066,23,1,4,0,1
13364,225,0,225,213,3,0,0,0,0
13365,8448,241,8207,7685,38,10,47,9,28
13367,8678,197,8481,8058,41,11,27,5,23
13368,1161,6,1155,1106,4,2,0,1,3
13402,1364,15,1349,1268,14,1,5,0,0
13403,6844,568,6276,4980,998,34,99,2,16
13404,167,2,165,161,0,0,0,0,0
13406,392,7,385,366,1,0,0,0,1
13407,4930,123,4807,4530,22,6,18,5,4
13408,3452,155,3297,2659,434,8,17,0,18
13409,2325,66,2259,2107,4,32,0,0,0
13410,336,5,331,315,0,0,2,0,1
13411,3129,43,3086,2839,12,8,12,0,9
13413,15574,552,15022,13638,171,13,733,6,41
13415,98,5,93,86,0,0,1,0,3
13416,2099,27,2072,1996,7,1,2,1,6
13417,3280,131,3149,2919,97,6,34,1,5
13418,241,4,237,229,0,0,0,0,0
13420,1263,18,1245,1190,4,2,3,0,2
13421,12807,254,12553,11483,129,229,118,4,32
13424,2450,92,2358,2145,98,5,18,0,3
13425,2052,21,2031,1920,9,1,7,2,11
13428,1592,35,1557,1477,14,0,4,0,6
13431,1960,32,1928,1842,12,1,7,3,8
13433,1537,11,1526,1451,3,2,1,0,2
13435,248,2,246,228,0,0,1,0,0
13436,106,1,105,101,0,0,0,0,0
13437,404,10,394,367,1,1,4,0,4
13438,3626,45,3581,3399,14,11,17,0,5
13439,3681,70,3611,3389,28,11,27,0,7
13440,41024,2503,38521,33662,2131,107,476,16,130
13441,130,10,120,103,4,0,9,0,0
13450,169,2,167,156,1,0,4,0,0
13452,4445,100,4345,4086,20,8,4,1,12
13454,608,8,600,573,0,0,0,0,0
13455,57,0,57,56,0,1,0,0,0
13456,3941,82,3859,3661,21,3,21,1,10
13457,78,0,78,72,3,0,0,0,1
13459,1956,61,1895,1791,13,6,13,0,7
13460,4309,70,4239,4001,20,10,12,0,3
13461,3111,45,3066,2877,11,5,47,0,5
13464,1182,16,1166,1102,3,4,4,0,5
13468,321,3,318,297,2,0,0,0,0
13469,753,6,747,706,7,2,5,0,5
13470,633,12,621,583,1,7,3,0,0
13471,3023,42,2981,2828,29,4,8,0,2
13472,292,2,290,280,2,0,1,0,0
13473,786,4,782,752,4,0,0,1,2
13475,76,1,75,72,0,0,0,0,0
13476,3092,55,3037,2847,23,11,32,0,11
13477,1279,9,1270,1215,5,5,0,1,0
13478,3084,61,3023,2826,22,27,27,0,6
13480,3231,44,3187,3019,18,2,13,0,14
13482,65,2,63,63,0,0,0,0,0
13483,310,5,305,290,1,0,0,0,0
13484,30,1,29,27,0,0,0,0,0
13485,1349,25,1324,1254,10,0,5,0,0
13486,710,11,699,665,0,0,0,1,7
13488,138,0,138,133,0,0,0,0,1
13489,556,5,551,533,5,0,0,0,1
13490,1278,30,1248,1177,20,0,2,0,2
13491,3494,58,3436,3281,11,0,17,1,4
13492,11457,330,11127,10451,123,7,111,2,35
13493,2017,30,1987,1858,11,15,2,0,13
13494,265,1,264,256,0,0,0,0,1
13495,2183,136,2047,1874,75,2,20,0,6
13501,40885,5652,35233,19556,6704,77,7084,11,154
13502,33990,3702,30288,23222,3948,73,1297,16,163
13601,37287,2374,34913,29304,2052,151,803,40,175
13602,4951,944,4007,2560,1015,32,275,12,9
13603,11808,1900,9908,6635,1581,108,513,171,120
13605,4517,120,4397,4168,29,8,13,3,5
13606,2606,65,2541,2385,9,11,5,0,2
13607,1610,26,1584,1482,8,8,11,0,3
13608,1501,19,1482,1409,12,8,3,0,0
13611,222,5,217,206,0,0,0,0,1
13612,2673,172,2501,2219,41,10,61,2,7
13613,2709,43,2666,2463,18,61,14,0,8
13614,403,8,395,374,1,0,1,0,0
13615,930,26,904,832,13,3,7,4,4
13616,1714,177,1537,1245,118,3,49,2,5
13617,12083,482,11601,10489,471,34,183,1,24
13618,1765,39,1726,1645,0,5,8,0,9
13619,10600,464,10136,9028,246,39,101,28,57
13620,2148,32,2116,2017,14,3,5,1,2
13621,690,7,683,631,7,6,4,0,5
13622,2182,46,2136,2002,11,6,8,1,2
13623,45,2,43,38,0,0,0,0,0
13624,4967,251,4716,4115,389,8,29,0,8
13625,1834,13,1821,1733,3,6,12,0,1
13626,2021,44,1977,1896,9,0,10,1,4
13628,202,14,188,166,1,3,3,0,0
13630,1486,21,1465,1400,8,10,7,0,1
13632,187,4,183,176,1,0,1,0,0
13633,296,0,296,281,1,5,2,0,0
13634,3999,76,3923,3690,16,10,24,3,5
13635,915,11,904,870,0,3,0,0,2
13636,230,11,219,215,1,0,0,0,0
13637,4980,704,4276,3187,520,16,159,22,34
13638,398,23,375,340,14,1,7,0,0
13639,80,0,80,74,0,0,0,0,0
13640,348,3,345,317,1,1,2,0,1
13641,101,0,101,99,0,0,1,0,0
13642,9397,318,9079,8204,480,32,22,5,6
13643,77,11,66,61,0,1,1,0,1
13645,9,0,9,9,0,0,0,0,0
13646,2232,19,2213,2122,8,13,7,1,5
13647,113,2,111,108,0,0,0,0,0
13648,2250,22,2228,2145,5,4,3,0,6
13649,91,0,91,86,0,1,0,0,0
13650,1336,35,1301,1232,6,0,11,1,4
13651,95,1,94,89,0,0,1,0,0
13652,1958,27,1931,1828,16,11,4,0,2
13654,2620,19,2601,2536,3,3,3,1,3
13655,3789,31,3758,147,2,3532,0,0,1
13656,2901,46,2855,2714,13,19,4,1,7
13658,2545,50,2495,2396,7,14,1,2,4
13659,514,8,506,497,1,0,1,0,0
13660,2019,47,1972,1878,2,6,7,0,4
13661,1667,33,1634,1558,8,0,9,0,1
13662,15814,306,15508,14045,89,520,141,4,42
13664,398,10,388,378,2,5,1,0,0
13665,895,21,874,796,7,6,3,0,1
13666,220,1,219,216,0,0,0,0,0
13667,3217,42,3175,2973,12,31,10,0,8
13668,3248,51,3197,2999,14,16,27,0,12
13669,14990,496,14494,13238,647,71,98,3,20
13670,446,2,444,435,0,0,1,0,0
13672,526,4,522,489,1,0,4,0,0
13673,2503,140,2363,2127,96,0,28,3,6
13674,22,0,22,17,0,0,0,0,0
13675,89,1,88,85,0,0,0,0,0
13676,13211,519,12692,11172,436,56,450,1,78
13678,180,4,176,167,4,1,0,0,0
13679,1791,37,1754,1633,10,2,8,1,17
13680,1427,36,1391,1318,7,3,8,1,8
13681,809,20,789,756,3,0,1,0,1
13682,921,24,897,839,7,2,3,0,4
13683,185,2,183,13,1,162,0,0,0
13684,1141,9,1132,1093,6,1,0,0,1
13685,2224,91,2133,1960,16,5,20,4,3
13687,496,9,487,464,0,1,3,0,4
13690,692,9,683,651,0,0,6,0,1
13691,2981,105,2876,2687,30,2,15,2,12
13692,95,1,94,91,0,0,0,0,0
13693,495,13,482,463,3,3,1,0,0
13694,1316,28,1288,1229,8,5,0,0,1
13695,124,5,119,82,22,2,0,0,0
13696,181,0,181,168,0,0,0,0,1
13697,2206,36,2170,2045,9,24,4,1,11
13699,2225,129,2096,1401,488,0,64,0,33
13730,2691,65,2626,2479,27,9,2,0,21
13731,949,37,912,846,7,3,16,0,3
13732,7569,212,7357,6911,66,3,109,0,21
13733,4809,117,4692,4473,31,6,23,2,4
13734,2160,47,2113,1988,12,5,8,0,1
13736,2433,52,2381,2161,14,4,21,0,26
13738,51,0,51,51,0,0,0,0,0
13739,908,33,875,834,7,0,7,0,0
13740,531,27,504,484,0,0,6,0,6
13743,3705,78,3627,3376,30,4,9,0,14
13744,1086,17,1069,998,11,3,7,0,1
13746,2678,36,2642,2433,19,6,2,6,24
13747,6,1,5,5,0,0,0,0,0
13748,3579,94,3485,3214,38,9,19,0,9
13750,936,27,909,862,8,1,1,0,5
13751,190,4,186,176,1,0,0,0,0
13752,808,15,793,749,10,2,3,0,4
13753,5619,401,5218,4515,385,7,113,0,20
13754,2912,112,2800,2609,66,4,5,1,6
13755,989,25,964,904,4,2,11,0,6
13756,475,10,465,424,2,1,2,0,2
13757,1002,34,968,897,10,1,11,1,6
13760,44153,2055,42098,36727,2060,64,883,25,194
13774,191,3,188,175,0,1,0,0,0
13775,1452,37,1415,1308,13,4,19,0,4
13776,404,10,394,374,3,0,0,0,1
13777,768,10,758,712,3,1,3,0,1
13778,5495,108,5387,5093,30,13,24,0,11
13780,1011,31,980,923,10,0,9,1,2
13782,642,22,620,588,3,4,2,0,1
13783,2345,89,2256,1896,235,8,12,0,3
13784,180,3,177,177,0,0,0,0,0
13786,333,12,321,307,2,1,3,0,0
13787,3359,62,3297,3118,10,8,5,0,10
13788,870,30,840,780,15,0,3,0,3
13790,18478,989,17489,13909,1230,17,1204,13,99
13795,3617,100,3517,3184,68,8,41,0,7
13796,1147,27,1120,1025,8,3,13,0,10
13797,2130,37,2093,1974,12,9,2,0,6
13801,1284,13,1271,1182,8,6,3,0,0
13802,692,11,681,631,5,2,5,0,0
13803,4208,98,4110,3779,25,8,15,2,22
13804,249,3,246,234,1,2,0,0,0
13806,111,0,111,103,2,0,0,0,0
13807,1061,39,1022,934,15,1,14,0,4
13808,1583,51,1532,1456,5,1,12,0,10
13809,1492,24,1468,1403,2,1,3,0,0
13810,1038,46,992,920,8,2,4,0,2
13811,4032,77,3955,3712,10,4,19,1,11
13812,2136,32,2104,2019,9,3,2,0,1
13813,814,37,777,698,6,1,3,0,2
13814,55,2,53,51,0,0,0,0,0
13815,13063,394,12669,11683,154,19,120,5,36
13820,21605,1444,20161,17693,934,64,478,6,91
13825,3020,96,2924,2704,22,9,23,0,13
13826,117,1,116,113,0,0,0,0,0
13827,11381,323,11058,10239,139,16,81,5,32
13830,4599,110,4489,4259,33,5,14,1,4
13832,528,14,514,498,1,1,1,0,1
13833,4004,75,3929,3665,20,13,8,0,18
13834,168,3,165,147,12,0,1,0,0
13835,1384,8,1376,1300,5,4,2,0,11
13838,4203,207,3996,3662,74,2,58,3,11
13839,1475,45,1430,1325,13,3,33,0,5
13841,421,14,407,379,6,3,3,0,2
13842,414,24,390,357,5,0,11,0,2
13843,1849,36,1813,1626,8,2,4,0,5
13844,686,16,670,637,7,1,0,0,0
13846,293,13,280,268,0,0,3,0,0
13847,23,3,20,20,0,0,0,0,0
13849,4456,97,4359,4105,30,5,17,1,5
13850,22135,713,21422,17211,630,35,2624,3,94
13856,6193,198,5995,5588,37,15,57,0,26
13859,162,0,162,148,0,2,0,0,0
13860,207,9,198,178,4,1,1,0,5
13861,426,21,405,364,10,0,6,0,0
13862,3960,87,3873,3648,23,3,12,1,10
13863,527,15,512,475,0,1,0,0,0
13864,1113,40,1073,981,12,2,6,0,5
13865,5754,132,5622,5236,38,17,21,1,31
13901,20548,1208,19340,16098,1519,61,436,4,76
13902,7260,1005,6255,4379,405,29,1400,0,1
13903,18140,1221,16919,13768,1549,56,378,2,94
13904,9236,515,8721,7230,716,23,140,4,35
13905,27672,1903,25769,18592,3199,55,2211,11,161
14001,9482,132,9350,8820,49,110,22,0,22
14004,11583,284,11299,10297,639,30,40,0,7
14005,1868,37,1831,1735,11,2,18,0,9
14006,9140,238,8902,8355,65,124,16,3,36
14008,1306,64,1242,1161,10,11,7,0,3
14009,5474,57,5417,5207,14,8,36,0,3
14011,7832,463,7369,5946,1192,34,32,2,19
14012,2334,90,2244,2066,9,14,13,1,3
14013,1317,41,1276,999,0,203,1,1,4
14020,22627,1202,21425,18750,1066,68,287,11,73
14024,1584,17,1567,1497,1,5,7,0,5
14025,2996,54,2942,2855,1,3,6,0,5
14026,792,22,770,723,13,0,11,0,0
14027,97,1,96,90,0,4,0,0,0
14028,1553,68,1485,1406,15,6,5,0,4
14029,72,0,72,71,0,0,0,0,0
14030,1755,16,1739,1662,9,10,5,0,2
14031,9983,271,9712,9163,84,12,192,2,29
14032,9368,187,9181,8483,76,6,343,0,31
14033,2173,39,2134,2062,4,1,9,0,6
14034,3743,408,3335,2314,893,65,10,0,6
14035,146,3,143,138,2,2,0,0,0
14036,4931,72,4859,4651,30,19,13,0,6
14037,1173,13,1160,1101,1,1,2,0,7
14039,96,1,95,82,0,0,3,0,0
14040,2087,24,2063,2000,5,1,6,0,3
14041,154,1,153,143,1,0,3,0,0
14042,3891,47,3844,3647,7,12,14,0,7
14043,24962,737,24225,22425,606,37,454,1,75
14047,6152,145,6007,5710,20,33,39,2,15
14048,15062,4741,10321,8965,693,54,78,2,43
14051,20721,566,20155,16827,537,33,1953,7,103
14052,17679,296,17383,16675,57,25,118,1,48
14054,1355,110,1245,1192,6,3,0,0,8
14055,1472,13,1459,1412,2,1,4,0,0
14056,164,7,157,150,0,0,2,0,0
14057,7915,211,7704,7379,27,28,25,1,11
14058,2107,251,1856,1734,20,12,7,0,1
14059,9280,128,9152,8807,34,3,33,0,23
14060,394,1,393,390,0,0,1,0,0
14061,77,2,75,66,2,0,0,0,0
14062,3375,137,3238,3048,32,36,6,2,2
14063,13028,1146,11882,10671,405,27,215,4,52
14065,1799,8,1791,1736,2,5,5,0,1
14066,1172,14,1158,1108,1,2,4,0,4
14067,4820,114,4706,4457,56,10,11,0,16
14068,7399,175,7224,5968,285,10,713,0,20
14069,773,19,754,716,0,1,2,0,0
14070,5093,150,4943,4034,109,600,16,2,6
14072,21389,668,20721,18724,451,96,689,2,33
14075,44053,1331,42722,40563,466,90,367,5,94
14080,4109,63,4046,3903,7,8,9,0,6
14081,2983,98,2885,1830,17,856,4,3,17
14082,421,7,414,408,0,0,3,0,0
14083,57,0,57,57,0,0,0,0,0
14085,8157,228,7929,7542,63,23,60,0,8
14086,35010,741,34269,32436,398,43,423,3,74
14091,1128,30,1098,793,1,247,1,0,0
14092,11030,274,10756,9773,89,388,140,2,42
14094,50969,2204,48765,42945,2640,186,354,14,138
14098,2944,68,2876,2730,20,19,8,0,7
14101,1853,29,1824,1718,6,13,2,1,3
14102,1130,14,1116,1093,1,0,2,0,0
14103,10589,483,10106,9004,422,46,61,4,45
14105,4388,97,4291,4040,67,18,15,0,5
14108,5654,84,5570,5256,50,32,25,1,25
14109,940,62,878,737,90,4,19,1,23
14111,3198,82,3116,2911,22,57,1,0,10
14112,56,5,51,42,0,0,0,0,0
14113,768,9,759,727,2,1,2,0,4
14120,44538,1207,43331,40529,671,209,414,7,95
14125,3717,277,3440,3217,40,10,12,0,7
14126,560,15,545,517,9,4,0,0,0
14127,30565,752,29813,28347,229,51,372,7,60
14129,1638,38,1600,1274,8,247,0,0,14
14130,88,2,86,83,0,0,0,0,2
14131,5207,140,5067,4740,41,65,24,1,19
14132,6155,139,6016,5305,152,316,41,2,13
14134,71,0,71,69,0,0,0,0,0
14135,78,2,76,76,0,0,0,0,0
14136,5029,235,4794,4457,35,62,24,1,14
14138,1841,56,1785,1689,9,20,5,0,7
14139,2231,32,2199,2074,6,5,5,0,7
14141,7585,143,7442,7152,47,30,35,0,13
14143,1310,63,1247,1206,6,6,5,0,0
14145,1536,19,1517,1460,3,0,3,1,3
14150,41161,1819,39342,35462,1386,149,740,2,99
14166,36,2,34,29,0,0,0,0,0
14167,1567,51,1516,1488,2,1,2,0,1
14168,60,1,59,46,0,11,0,0,2
14169,88,0,88,72,0,0,0,0,0
14170,2248,44,2204,2106,7,3,14,2,3
14171,1852,32,1820,1723,9,17,6,1,1
14172,3301,96,3205,3027,21,19,5,0,6
14173,386,3,383,361,1,0,8,0,0
14174,5654,136,5518,5211,27,44,50,1,25
14201,12364,4564,7800,4709,2301,77,293,3,65
14202,3850,821,3029,1838,941,11,130,0,10
14203,2006,177,1829,926,719,9,84,1,7
14204,9026,1360,7666,1598,5636,37,86,0,28
14206,21706,1989,19717,14096,3636,117,667,4,108
14207,26006,6006,20000,9746,4708,253,3972,6,129
14208,12088,877,11211,1499,8762,34,472,9,48
14209,8251,540,7711,4186,2833,12,285,1,45
14210,15480,2114,13366,10557,1622,106,238,1,56
14211,26449,2019,24430,2767,16570,94,3871,11,141
14212,13533,1131,12402,4131,4892,71,2619,27,93
14213,25834,5807,20027,9251,5866,212,3506,13,150
14214,20732,1371,19361,8996,7104,47,2296,10,125
14215,42447,2783,39664,4570,30827,71,2527,14,216
14216,22979,1798,21181,15558,3841,130,518,6,105
14217,23085,1165,21920,19256,1179,113,448,5,48
14218,20878,1853,19025,15498,2057,76,329,1,98
14219,11593,556,11037,10201,221,31,109,0,28
14220,23959,2439,21520,18963,1218,92,253,3,49
14221,55275,1669,53606,44310,1931,55,5479,4,189
14222,13629,1099,12530,9654,1891,62,356,2,77
14223,22658,1038,21620,18814,1191,53,605,9,76
14224,40736,1271,39465,37373,571,62,365,5,72
14225,34066,1451,32615,25195,4503,62,1363,7,139
14226,29861,1214,28647,21369,3080,60,2945,3,124
14227,23130,822,22308,19047,1891,39,663,6,34
14228,23945,1103,22842,15666,2380,54,3696,4,107
14260,787,65,722,501,79,1,110,0,9
14261,5686,535,5151,3035,843,5,1087,3,31
14301,12618,821,11797,6257,3992,261,273,3,67
14302,105,0,105,86,14,4,1,0,0
14303,5958,451,5507,2965,1677,119,191,1,30
14304,28923,827,28096,24228,1397,356,654,4,101
14305,16427,932,15495,8749,5185,228,198,7,121
14411,13334,894,12440,10388,1241,52,43,6,35
14413,171,57,114,81,16,0,0,0,0
14414,6935,290,6645,6199,67,14,46,1,36
14415,194,0,194,191,0,0,0,0,0
14416,3971,283,3688,3471,16,7,29,0,26
14418,1296,14,1282,1220,5,0,3,0,1
14420,19567,1108,18459,16313,800,29,232,3,73
14422,2182,97,2085,1992,5,2,1,0,2
14423,4557,95,4462,4126,100,5,35,0,14
14424,28353,823,27530,25399,489,49,275,8,109
14425,13068,976,12092,10839,368,25,192,2,66
14427,1990,56,1934,1818,4,2,15,0,4
14428,8259,251,8008,7415,151,6,113,0,31
14432,5746,285,5461,5141,70,5,20,2,10
14433,4707,171,4536,4139,100,4,13,2,12
14435,2761,54,2707,2558,10,11,17,0,9
14437,9141,219,8922,8413,73,24,53,1,18
14441,326,33,293,273,6,0,4,0,1
14445,7781,460,7321,6442,291,19,124,4,19
14450,42633,1392,41241,37416,916,38,1253,7,119
14453,44,3,41,28,0,0,4,0,4
14454,10759,633,10126,9052,310,14,367,0,54
14456,19602,2717,16885,14399,1222,13,318,6,75
14462,614,35,579,553,1,0,2,1,0
14463,181,5,176,172,0,0,0,0,0
14464,7065,331,6734,6210,122,25,22,1,26
14466,1616,23,1593,1509,12,4,5,1,5
14467,9526,389,9137,7075,712,10,790,2,58
14468,19174,658,18516,17309,345,36,120,3,76
14469,6265,168,6097,5718,32,18,31,1,29
14470,7648,340,7308,6807,70,26,36,3,33
14471,2610,44,2566,2453,8,3,15,0,9
14472,8566,188,8378,7850,71,17,98,1,34
14475,334,9,325,315,0,1,1,0,1
14476,2250,73,2177,2063,27,11,0,0,13
14477,1501,61,1440,1336,22,10,0,0,5
14478,1646,67,1579,1481,29,5,23,0,5
14479,263,3,260,243,0,0,0,0,0
14480,826,39,787,734,2,6,9,0,5
14481,1711,105,1606,1519,1,0,13,0,2
14482,8365,238,8127,7606,138,20,28,4,29
14485,4111,118,3993,3728,37,4,34,0,12
14486,305,12,293,280,1,0,1,0,2
14487,5889,143,5746,5382,51,5,23,1,13
14489,7347,404,6943,5994,416,15,16,0,21
14502,10760,339,10421,9681,113,25,125,0,33
14504,1648,64,1584,1517,5,7,4,0,0
14505,5202,248,4954,4614,65,9,9,0,17
14506,1289,24,1265,1181,6,2,27,0,4
14507,1298,24,1274,1238,4,2,0,0,3
14510,4902,603,4299,3987,38,16,34,0,14
14511,520,7,513,485,5,1,0,0,1
14512,4533,72,4461,4233,17,7,39,0,2
14513,13459,1082,12377,10919,642,16,75,0,42
14514,6734,348,6386,5416,479,8,162,0,25
14515,72,5,67,50,5,0,4,0,1
14516,2190,98,2092,1968,27,2,4,0,3
14517,2549,48,2501,2360,13,2,5,0,6
14519,12354,371,11983,11226,152,23,82,2,59
14521,3473,138,3335,2871,291,4,22,0,6
14522,9028,262,8766,8174,76,22,43,6,20
14525,2921,105,2816,2681,25,2,9,0,11
14526,20932,759,20173,18127,508,17,757,2,48
14527,12716,407,12309,11782,79,12,40,7,44
14529,57,0,57,54,1,0,0,0,0
14530,6583,508,6075,5181,587,14,48,1,8
14532,4174,148,4026,3801,34,5,18,0,21
14533,1753,85,1668,1571,10,3,8,0,4
14534,32834,998,31836,26304,663,33,3400,8,109
14536,607,8,599,554,9,2,3,0,4
14537,203,1,202,198,0,0,0,0,0
14539,225,2,223,220,0,0,1,0,0
14541,3298,290,3008,2336,560,14,11,0,4
14542,68,8,60,57,0,0,0,0,0
14543,3160,82,3078,2799,81,6,69,0,15
14544,2035,28,2007,1923,5,3,8,0,7
14545,157,3,154,145,1,0,0,0,0
14546,4872,221,4651,4089,205,23,84,11,24
14548,3972,122,3850,3618,30,13,25,1,12
14549,137,0,137,136,0,0,0,0,0
14550,1564,32,1532,1461,3,2,4,0,1
14551,5163,568,4595,3849,417,16,23,0,19
14555,934,42,892,836,17,0,2,0,1
14556,875,132,743,380,341,12,3,1,0
14557,136,3,133,127,0,1,2,0,0
14559,17964,634,17330,16140,325,18,153,2,45
14560,2167,55,2112,1997,10,7,2,0,4
14561,3026,113,2913,2751,20,4,6,0,19
14564,16138,505,15633,14455,160,28,402,2,51
14568,5975,215,5760,5395,46,4,51,3,14
14569,6302,181,6121,5772,38,14,53,2,12
14571,1207,118,1089,979,28,8,9,0,3
14572,4636,70,4566,4295,23,20,14,0,22
14580,54148,2467,51681,46810,1539,54,1336,10,155
14585,187,0,187,185,0,0,0,0,0
14586,13089,715,12374,7878,1405,19,2446,0,53
14588,8,1,7,3,0,0,0,0,0
14589,7637,497,7140,6516,223,19,22,3,16
14590,4902,197,4705,4409,72,8,24,0,9
14591,1451,28,1423,1364,1,1,2,0,0
14592,222,3,219,214,4,0,0,0,0
14604,3138,411,2727,1579,731,5,263,1,17
14605,12172,4561,7611,1094,5519,21,490,10,46
14606,28252,4374,23878,14220,6689,73,1493,6,103
14607,16298,1141,15157,12035,1875,24,439,6,90
14608,13177,2092,11085,2565,6960,45,817,7,70
14609,41329,7911,33418,18155,12818,89,442,9,145
14610,14311,685,13626,11467,1014,25,434,1,63
14611,18586,2769,15817,3372,10899,68,507,4,63
14612,34844,2749,32095,27137,2660,69,678,1,148
14613,14882,3229,11653,3143,6742,48,878,5,92
14614,1109,118,991,399,525,2,40,0,0
14615,16862,2985,13877,7844,4569,41,555,4,79
14616,27946,2870,25076,19599,3449,57,669,4,122
14617,22599,1626,20973,18444,1220,23,313,1,67
14618,23998,1117,22881,18732,1061,38,1826,7,123
14619,14061,990,13071,2467,9847,20,121,4,63
14620,24185,1857,22328,15243,3370,58,2428,6,147
14621,32891,12584,20307,4645,13607,42,651,10,125
14622,11930,1016,10914,9391,835,24,183,1,46
14623,27865,1765,26100,17342,2633,72,4587,6,165
14624,37200,2070,35130,28185,3947,50,1136,17,144
14625,10487,375,10112,9298,163,22,232,2,30
14626,30032,2148,27884,22934,2633,41,1019,12,83
14627,2986,252,2734,1445,287,7,890,1,13
14642,8,1,7,3,3,0,1,0,0
14701,38428,4048,34380,30628,1195,146,213,12,109
14706,5910,90,5820,5462,50,29,79,2,17
14707,151,1,150,143,1,0,0,0,0
14708,148,0,148,140,2,0,1,0,2
14709,1423,17,1406,1360,1,4,6,0,3
14710,3367,59,3308,3164,12,4,7,0,5
14711,1822,11,1811,1730,5,3,1,0,7
14712,3242,56,3186,3052,6,8,14,0,2
14714,361,2,359,340,0,0,0,1,1
14715,2613,13,2600,2482,8,6,3,0,1
14716,2638,247,2391,2011,256,9,7,1,11
14717,689,23,666,617,6,4,4,0,1
14718,1845,38,1807,1681,28,7,9,6,0
14719,3449,37,3412,3268,15,25,1,0,0
14720,633,24,609,552,16,4,5,0,0
14721,177,2,175,165,0,0,0,0,0
14722,194,9,185,170,0,0,4,0,0
14723,1222,32,1190,1139,13,2,1,0,2
14724,2595,30,2565,2475,3,1,10,2,8
14726,2016,11,2005,1932,8,3,4,0,8
14727,5257,82,5175,4823,38,14,39,0,15
14728,937,11,926,886,1,3,0,3,7
14729,763,13,750,723,4,3,2,0,0
14731,1269,24,1245,1179,6,13,8,0,1
14732,56,0,56,56,0,0,0,0,0
14733,3663,95,3568,3371,17,5,10,0,6
14735,2836,25,2811,2677,5,9,6,0,13
14736,271,5,266,256,0,0,1,0,2
14737,4101,79,4022,3842,13,22,15,0,3
14738,3561,41,3520,3367,13,7,9,0,2
14739,2853,34,2819,2652,14,8,11,0,8
14740,1301,18,1283,1237,4,2,3,0,1
14741,1881,44,1837,1663,3,24,4,0,5
14742,119,0,119,115,0,0,0,0,0
14743,1584,25,1559,1479,9,5,5,0,4
14744,1937,64,1873,1683,72,5,68,0,3
14747,2197,48,2149,2058,8,9,3,0,16
14748,659,13,646,485,5,126,4,0,4
14750,4673,113,4560,4240,21,20,96,2,17
14752,168,11,157,149,1,3,1,0,0
14753,1067,13,1054,975,4,16,2,0,3
14754,721,6,715,677,0,2,7,0,0
14755,2855,52,2803,2614,45,46,8,0,4
14756,43,0,43,41,1,0,0,0,0
14757,3072,115,2957,2783,56,8,8,2,9
14760,18031,431,17600,15567,525,95,289,0,73
14767,2171,37,2134,2062,5,4,5,2,8
14769,948,61,887,794,10,4,8,4,10
14770,2747,42,2705,2553,24,12,7,0,4
14772,4141,96,4045,3831,19,53,7,5,22
14774,142,0,142,138,0,0,1,0,0
14775,2402,53,2349,2241,10,7,1,1,4
14777,509,8,501,490,0,0,0,0,0
14778,1352,82,1270,1088,132,0,46,0,0
14779,7191,260,6931,4653,67,1531,21,0,17
14781,2114,27,2087,1968,3,3,7,0,3
14782,2236,39,2197,2073,16,6,4,0,2
14783,352,9,343,115,0,205,0,0,0
14784,967,32,935,860,4,4,2,0,3
14785,54,0,54,48,0,0,0,0,0
14787,4825,210,4615,4391,20,8,37,3,14
14788,217,8,209,193,4,0,1,0,0
14801,5202,69,5133,4904,24,8,31,1,8
14802,4016,372,3644,2806,512,11,118,3,93
14803,1216,34,1182,1103,14,0,20,0,1
14804,1300,40,1260,1174,2,0,19,0,6
14805,1108,15,1093,1019,2,3,3,0,3
14806,1963,24,1939,1836,6,2,14,1,1
14807,2834,51,2783,2645,9,5,6,0,16
14808,588,5,583,574,1,0,1,0,0
14809,2258,47,2211,2081,23,7,7,0,5
14810,11620,192,11428,10655,218,39,54,0,27
14812,3273,44,3229,3029,12,1,18,1,9
14813,2307,32,2275,2116,46,2,3,0,1
14814,1938,40,1898,1732,16,3,50,0,9
14815,928,8,920,873,5,0,0,1,0
14816,583,25,558,495,9,2,5,0,1
14817,2474,83,2391,2101,57,13,47,2,23
14818,1830,48,1782,1713,6,3,9,0,1
14819,684,9,675,642,4,0,1,0,2
14820,659,8,651,613,0,2,0,0,3
14821,3115,30,3085,2940,17,6,9,1,10
14822,926,15,911,886,1,2,0,0,3
14823,3686,56,3630,3424,19,7,16,0,6
14824,663,12,651,613,1,3,2,0,1
14825,763,7,756,718,3,0,6,0,2
14826,1936,53,1883,1780,13,11,4,0,4
14827,204,2,202,185,3,0,5,0,3
14830,18949,497,18452,16526,481,42,407,3,78
14836,963,11,952,888,0,0,1,0,3
14837,5345,83,5262,5029,20,6,18,0,19
14838,1820,21,1799,1703,3,4,6,0,1
14839,686,6,680,652,1,2,1,0,2
14840,2905,43,2862,2705,16,8,11,0,12
14841,809,16,793,756,0,3,1,0,4
14842,797,11,786,767,1,0,2,0,0
14843,12637,332,12305,11096,290,23,141,2,56
14845,20628,464,20164,17959,345,40,878,0,51
14846,653,12,641,607,0,0,0,0,2
14847,2443,42,2401,2233,17,8,14,0,16
14850,69271,5273,63998,46216,3339,128,9868,20,437
14853,1993,337,1656,1232,136,26,220,0,0
14854,47,2,45,43,0,0,0,0,0
14855,1029,8,1021,1001,1,0,0,0,0
14856,72,0,72,69,1,0,0,0,0
14858,1672,28,1644,1550,5,0,3,2,3
14859,1153,15,1138,1073,3,2,2,0,2
14860,1000,24,976,920,8,2,4,0,1
14861,1303,10,1293,1245,9,1,5,0,2
14864,1311,27,1284,1215,9,5,8,0,3
14865,2598,34,2564,2414,21,0,18,0,10
14867,5490,168,5322,4691,161,19,37,1,40
14869,1208,46,1162,1080,6,4,7,0,3
14870,9648,147,9501,7941,219,17,875,1,29
14871,4025,43,3982,3794,50,4,14,0,4
14872,641,9,632,578,4,2,1,0,8
14873,2348,50,2298,2130,30,4,12,0,13
14874,180,2,178,175,0,0,0,0,0
14877,505,5,500,485,1,0,0,0,0
14878,780,12,768,741,2,1,3,0,0
14879,2152,21,2131,2020,5,5,12,1,4
14880,1545,22,1523,1417,7,3,5,0,7
14881,254,9,245,196,1,0,14,1,0
14882,3890,155,3735,3292,107,13,64,2,25
14883,3998,109,3889,3543,53,9,39,5,27
14884,309,4,305,300,0,0,0,0,1
14885,689,4,685,675,1,2,0,0,5
14886,6648,194,6454,5942,78,9,51,6,17
14889,1514,24,1490,1391,7,2,5,1,10
14891,4140,101,4039,3772,36,19,50,0,9
14892,7949,142,7807,7343,82,10,34,0,20
14893,21,0,21,16,0,0,0,0,0
14894,1716,172,1544,1212,247,8,5,1,2
14895,9375,119,9256,8814,61,19,53,1,28
14897,850,6,844,799,1,1,0,0,10
14898,1573,10,1563,1510,4,1,0,0,6
14901,14893,943,13950,10161,2541,63,106,7,35
14903,7279,181,7098,6358,192,11,128,0,9
14904,15102,605,14497,12106,975,35,92,2,56
14905,8645,320,8325,7076,586,12,109,4,32
15001,32299,856,31443,25278,4354,40,247,5,129
15003,11672,406,11266,8850,1471,14,109,3,58
15004,224,1,223,206,0,0,0,0,0
15005,9375,195,9180,8596,149,8,91,3,27
15006,279,5,274,265,0,0,3,0,0
15007,391,7,384,348,2,0,8,0,0
15009,15594,302,15292,14305,272,17,157,6,38
15010,28736,629,28107,24021,2252,41,193,5,152
15012,15756,306,15450,14369,320,10,116,0,35
15014,3165,63,3102,2673,218,5,19,1,4
15015,1223,28,1195,1124,5,3,18,1,3
15017,16971,365,16606,14568,461,15,914,5,53
15018,763,21,742,668,24,1,6,0,0
15019,1587,20,1567,1467,14,1,8,0,2
15020,284,7,277,261,2,0,0,0,2
15021,6813,143,6670,6310,60,6,16,0,15
15022,10241,223,10018,8803,575,11,69,3,38
15024,8943,138,8805,8083,104,10,313,0,21
15025,17118,402,16716,12603,2826,28,488,1,70
15026,4071,72,3999,3788,58,4,23,0,6
15027,2236,26,2210,2047,33,2,14,0,12
15028,111,7,104,101,0,0,0,0,0
15030,1125,14,1111,998,35,1,11,0,5
15031,560,5,555,476,26,0,5,0,1
15033,4677,108,4569,3517,638,7,10,0,37
15034,1612,20,1592,1374,130,5,5,2,5
15035,2098,49,2049,1531,382,0,8,0,17
15037,10519,104,10415,9777,214,4,35,1,32
15038,291,3,288,270,0,0,0,0,0
15042,7931,126,7805,7352,82,2,31,4,12
15043,2092,15,2077,1924,9,1,3,1,12
15044,29105,506,28599,26694,235,13,757,6,113
15045,4475,128,4347,3647,398,11,16,0,31
15046,2488,57,2431,2191,91,8,37,0,6
15047,302,12,290,270,5,0,0,0,0
15049,901,14,887,842,5,2,1,0,3
15050,2429,38,2391,2305,8,4,0,0,4
15051,488,19,469,413,7,1,7,0,0
15052,3366,76,3290,3097,36,1,6,4,1
15053,146,0,146,136,0,0,0,0,0
15054,525,18,507,487,0,0,2,0,0
15055,1368,32,1336,1214,44,3,25,1,1
15056,1092,38,1054,858,89,0,23,0,0
15057,16709,307,16402,14030,248,14,1489,3,31
15059,3913,143,3770,3077,414,7,28,1,29
15060,925,15,910,866,5,0,0,0,4
15061,12591,278,12313,11100,476,18,132,4,22
15062,6880,167,6713,5045,1129,12,20,2,47
15063,11003,249,10754,10039,221,10,29,3,36
15064,339,5,334,291,9,1,8,0,0
15065,11158,156,11002,9924,418,11,115,1,51
15066,12126,226,11900,10243,745,28,22,10,49
15067,2130,25,2105,2005,12,3,2,0,7
15068,37104,650,36454,31259,3042,41,198,10,164
15071,12229,297,11932,10502,366,19,466,7,61
15072,69,1,68,54,9,0,0,0,0
15074,8617,162,8455,7135,731,11,26,2,29
15075,107,4,103,92,0,0,0,0,2
15076,995,25,970,898,17,1,3,0,0
15077,144,0,144,137,2,0,0,0,0
15078,529,8,521,491,2,0,0,0,0
15081,360,0,360,340,2,0,1,0,0
15082,358,20,338,306,12,1,0,0,5
15083,977,6,971,929,5,0,5,0,2
15084,10063,190,9873,8914,372,12,44,0,37
15085,8010,134,7876,7350,134,3,84,1,29
15086,684,45,639,532,14,1,48,0,2
15087,280,9,271,259,3,0,2,0,0
15088,405,9,396,368,6,0,0,0,0
15089,6151,56,6095,5795,90,13,13,0,12
15090,24985,705,24280,20412,361,26,2537,16,84
15101,24667,448,24219,22456,289,4,773,2,50
15102,30548,512,30036,27800,443,12,762,8,70
15104,7858,199,7659,2285,4828,6,29,1,40
15106,19166,421,18745,16157,884,20,707,4,88
15108,43422,1732,41690,35399,2433,42,1813,12,176
15110,5254,177,5077,1733,2947,8,7,1,52
15112,3314,124,3190,1578,1363,5,15,0,29
15116,14264,244,14020,13226,138,9,199,2,35
15120,17950,434,17516,12775,3638,12,191,1,122
15122,19340,440,18900,15321,2469,14,149,0,86
15123,5,0,5,3,1,1,0,0,0
15126,7335,194,7141,6518,180,4,131,2,35
15129,10901,169,10732,9753,340,10,196,5,38
15131,8144,147,7997,7226,419,7,48,7,38
15132,19418,671,18747,10364,7033,52,52,5,124
15133,6144,116,6028,5475,196,7,17,0,34
15135,4820,59,4761,4440,129,3,11,0,12
15136,23663,555,23108,16683,4745,32,421,2,133
15137,9939,194,9745,7295,1844,12,61,2,41
15139,6764,147,6617,6215,118,1,74,0,4
15140,3103,72,3031,2016,783,1,13,3,18
15142,1894,36,1858,1579,47,0,163,0,13
15143,22329,533,21796,18378,455,14,2131,8,104
15144,3998,55,3943,3683,52,4,2,0,28
15145,6923,146,6777,4292,1878,6,104,2,51
15146,28672,785,27887,19997,4333,32,2132,7,173
15147,16356,357,15999,11299,3831,14,105,0,53
15148,2363,75,2288,1397,722,5,9,0,11
15201,12802,398,12404,9607,1806,13,426,2,65
15202,20081,558,19523,16259,1795,32,295,8,79
15203,10720,437,10283,8749,629,2,411,5,58
15204,8213,246,7967,3563,3408,13,262,9,112
15205,23594,662,22932,17749,2551,18,1397,1,134
15206,28774,1116,27658,14895,9090,58,2109,10,192
15207,10615,295,10320,7145,2352,18,261,1,52
15208,9601,277,9324,3355,5211,21,248,4,61
15209,12044,264,11780,10966,225,16,129,0,32
15210,25123,1050,24073,13774,7581,61,855,11,198
15211,10935,332,10603,9035,925,7,140,10,33
15212,27016,803,26213,16763,7374,39,592,7,168
15213,31075,1322,29753,19785,3577,73,4871,1,347
15214,14072,368,13704,7233,5657,15,101,3,95
15215,12489,387,12102,10549,529,6,509,0,52
15216,22966,1345,21621,18692,1259,17,616,4,85
15217,26851,1133,25718,19719,863,19,3688,8,188
15218,13497,489,13008,8661,3368,13,310,10,68
15219,10949,312,10637,2655,7007,24,479,4,58
15220,17840,428,17412,12321,1415,16,2935,5,70
15221,28913,780,28133,13081,13121,45,437,6,172
15222,5976,305,5671,4463,500,4,476,1,56
15223,7080,163,6917,6360,179,4,71,3,38
15224,10568,420,10148,7016,2152,11,499,2,72
15225,1108,61,1047,877,87,5,8,2,0
15226,13931,487,13444,11550,772,12,393,7,82
15227,30036,703,29333,23310,1787,30,3136,8,156
15228,18110,601,17509,15517,268,10,891,3,74
15229,14625,333,14292,12930,408,9,354,3,47
15232,12042,564,11478,8111,562,3,2304,3,59
15233,2656,100,2556,1061,1304,6,48,1,17
15234,13966,408,13558,11918,393,3,698,3,70
15235,34610,879,33731,17002,14330,36,399,6,274
15236,31594,490,31104,26084,1194,19,2728,14,75
15237,45670,923,44747,39550,955,24,2627,12,135
15238,13266,337,12929,11165,192,1,1035,0,55
15239,21211,362,20849,18841,956,14,266,2,78
15241,22198,621,21577,18594,209,12,1888,3,89
15243,14329,301,14028,12737,163,3,654,0,40
15260,29,0,29,21,0,0,8,0,0
15275,50,1,49,34,5,1,2,0,0
15282,5066,293,4773,3030,1543,36,85,0,1
15290,0,0,0,0,0,0,0,0,0
15301,48963,1130,47833,41921,2905,70,400,28,140
15310,265,2,263,250,0,0,0,0,0
15311,1340,9,1331,1288,6,0,7,0,2
15312,3372,51,3321,3160,21,3,4,0,11
15313,363,3,360,346,0,0,2,0,0
15314,3515,38,3477,3265,46,9,17,0,9
15315,714,4,710,674,3,0,1,0,0
15316,246,6,240,222,0,2,1,0,2
15317,42801,860,41941,38303,1102,27,857,0,134
15320,5087,50,5037,4756,24,5,13,0,2
15321,1792,14,1778,1712,18,0,9,0,7
15322,1869,19,1850,1717,43,7,2,2,5
15323,4217,45,4172,3970,15,6,8,1,5
15324,600,6,594,561,3,0,2,0,1
15325,522,4,518,500,0,0,1,0,0
15327,1326,10,1316,1264,2,0,0,0,4
15329,1430,10,1420,1364,3,1,4,0,6
15330,5292,71,5221,4975,38,12,16,1,11
15331,1003,6,997,905,33,3,0,2,9
15332,8058,96,7962,7562,64,5,43,2,16
15333,2232,23,2209,2069,30,5,2,0,8
15334,113,1,112,110,0,0,0,0,0
15337,560,6,554,539,0,0,0,0,1
15338,1538,15,1523,1444,4,2,1,1,1
15340,1265,17,1248,1194,7,0,7,0,2
15341,744,5,739,709,3,3,1,0,1
15342,5066,104,4962,4476,210,1,37,3,25
15344,1471,26,1445,1363,13,1,3,0,1
15345,1457,22,1435,1342,24,1,2,0,5
15346,670,1,669,656,1,0,0,0,2
15347,608,9,599,553,13,4,4,3,1
15348,250,3,247,234,0,1,0,0,0
15349,1640,15,1625,1550,2,1,2,0,5
15350,612,15,597,548,6,0,2,0,3
15351,837,6,831,767,6,0,1,0,5
15352,793,8,785,746,0,2,3,0,0
15353,47,0,47,47,0,0,0,0,0
15357,1518,9,1509,1427,8,2,3,0,2
15358,852,11,841,801,16,0,0,0,0
15359,152,2,150,148,0,0,0,0,0
15360,1768,6,1762,1670,8,3,1,0,6
15361,140,0,140,136,0,0,0,0,0
15362,616,3,613,598,0,0,0,0,0
15363,782,24,758,675,28,0,9,0,7
15364,589,3,586,572,1,1,1,0,0
15365,151,2,149,144,0,0,0,0,0
15366,141,4,137,128,0,0,0,0,0
15367,9634,214,9420,8769,44,8,251,3,26
15368,473,2,471,433,6,0,2,0,6
15370,14153,297,13856,12340,968,43,87,4,30
15376,1652,16,1636,1596,1,0,1,0,3
15377,598,8,590,554,4,2,1,0,3
15378,82,4,78,61,12,0,0,0,0
15379,101,1,100,90,5,0,0,0,0
15380,624,12,612,600,0,3,0,0,0
15401,30619,482,30137,25606,2554,40,169,117,110
15410,799,7,792,704,38,0,0,0,6
15411,592,13,579,555,0,0,2,0,5
15412,257,2,255,239,2,0,0,0,0
15413,452,4,448,383,31,1,2,0,1
15416,498,0,498,473,12,0,4,0,3
15417,7973,153,7820,6818,502,4,29,11,31
15419,3574,95,3479,2945,281,12,55,8,13
15420,232,0,232,167,42,0,0,0,3
15421,136,0,136,134,0,0,0,0,0
15422,242,0,242,223,10,0,0,0,0
15423,1792,28,1764,1657,32,4,2,1,5
15424,2252,26,2226,2166,3,5,4,0,2
15425,17975,182,17793,16657,411,27,42,5,26
15427,996,8,988,870,62,0,0,2,3
15428,1764,16,1748,1643,20,10,0,0,1
15429,316,4,312,292,9,0,2,0,1
15430,263,1,262,256,0,0,0,0,0
15431,4375,31,4344,4143,41,2,9,0,0
15432,371,6,365,342,10,0,0,0,0
15433,750,3,747,708,18,1,0,0,0
15434,246,3,243,226,1,0,0,1,0
15435,199,11,188,171,7,0,0,0,1
15436,2666,15,2651,2476,58,0,4,13,1
15437,2426,66,2360,2233,25,3,10,0,13
15438,2123,20,2103,2038,12,1,2,0,3
15440,316,5,311,309,1,0,0,0,0
15442,2316,26,2290,2125,53,5,6,1,3
15443,329,4,325,289,15,0,0,0,1
15444,469,5,464,393,40,0,3,0,2
15445,2688,17,2671,2546,34,2,8,0,1
15446,112,1,111,107,0,0,0,0,0
15447,249,1,248,232,4,2,1,0,0
15448,154,0,154,134,0,0,0,0,0
15449,475,9,466,452,0,0,0,0,0
15450,2231,131,2100,1047,1033,1,1,0,1
15451,854,11,843,792,6,3,0,0,2
15454,215,1,214,188,8,0,1,0,2
15455,404,0,404,383,6,0,3,0,0
15456,2368,46,2322,2168,45,3,10,0,11
15458,2180,14,2166,1972,109,5,7,0,9
15459,1531,12,1519,1453,8,7,5,0,3
15460,113,3,110,98,1,0,2,0,0
15461,4078,27,4051,3585,183,12,15,3,18
15462,284,2,282,274,0,0,0,0,3
15463,242,1,241,207,17,1,0,0,1
15464,1378,12,1366,1334,2,1,0,0,2
15465,336,2,334,325,0,0,0,0,0
15466,374,10,364,355,1,0,0,0,0
15467,148,1,147,143,2,0,1,0,0
15468,2271,17,2254,2054,85,2,1,1,5
15469,2260,11,2249,2182,2,2,0,0,4
15470,859,6,853,828,0,0,5,0,0
15472,267,8,259,231,6,0,2,0,0
15473,3736,30,3706,3531,34,3,24,2,5
15474,2096,33,2063,1914,17,0,0,0,5
15475,970,7,963,795,70,9,2,2,9
15476,209,3,206,186,13,0,0,0,0
15477,894,17,877,826,8,0,0,0,0
15478,5889,37,5852,5584,31,8,8,3,2
15479,1942,5,1937,1817,23,2,7,0,1
15480,1657,29,1628,1560,11,5,1,2,8
15482,484,9,475,461,0,1,2,0,0
15483,421,0,421,405,0,0,0,0,0
15484,594,1,593,550,25,0,1,1,1
15486,2127,25,2102,2025,8,1,0,0,4
15488,65,1,64,57,2,1,0,0,0
15489,362,4,358,349,2,0,0,0,0
15490,550,3,547,533,0,0,0,0,1
15492,81,1,80,67,4,0,1,0,1
15501,16277,354,15923,14762,584,17,101,0,41
15502,302,1,301,293,0,0,0,0,5
15510,2320,202,2118,958,1157,0,3,0,0
15520,254,1,253,247,0,0,0,0,0
15521,1869,7,1862,1799,3,4,4,0,2
15522,11622,175,11447,10936,90,25,78,0,16
15530,5090,54,5036,4923,13,2,10,0,13
15531,3614,40,3574,3417,20,0,13,0,7
15532,120,0,120,116,0,0,0,0,1
15533,1301,19,1282,1229,6,2,5,0,2
15534,842,4,838,807,1,0,0,0,0
15535,2127,15,2112,2040,0,4,1,0,5
15536,427,3,424,395,7,0,2,0,0
15537,7629,80,7549,7271,26,9,27,0,6
15538,655,6,649,630,1,0,0,0,4
15539,418,6,412,400,0,0,0,0,3
15540,403,5,398,384,0,0,0,0,1
15541,3622,41,3581,3465,2,11,2,0,0
15542,1177,4,1173,1131,2,0,0,0,1
15544,235,0,235,232,0,0,0,0,0
15545,2612,16,2596,2502,3,4,6,0,4
15546,384,6,378,364,1,0,0,0,0
15547,402,9,393,390,0,0,0,0,0
15550,1577,20,1557,1506,3,2,0,0,3
15551,674,1,673,658,1,0,0,0,0
15552,5988,24,5964,5814,7,0,6,0,5
15554,2498,34,2464,2377,12,5,10,0,1
15555,119,0,119,117,0,0,0,0,0
15557,3657,19,3638,3519,15,4,6,2,8
15558,1914,5,1909,1860,2,0,4,0,2
15559,1895,31,1864,1810,4,1,2,0,3
15560,171,1,170,161,3,0,1,0,3
15561,151,0,151,149,0,0,1,0,0
15562,282,4,278,273,0,0,0,0,0
15563,3008,18,2990,2903,6,0,2,1,2
15564,113,1,112,105,0,0,0,0,0
15565,43,0,43,37,0,0,0,0,0
15601,57141,998,56143,51717,1489,42,589,3,130
15610,3430,28,3402,3317,11,0,0,0,6
15611,419,5,414,391,4,1,3,0,0
15612,385,5,380,360,0,1,3,0,1
15613,13462,130,13332,12629,130,10,45,5,22
15615,244,0,244,228,4,0,0,0,0
15616,379,2,377,367,0,0,2,0,1
15617,251,2,249,240,1,0,0,0,0
15618,2272,7,2265,2132,16,0,2,0,5
15619,412,1,411,403,8,0,0,0,0
15620,808,6,802,765,6,2,2,0,1
15622,1223,4,1219,1180,0,1,3,0,1
15623,760,12,748,698,4,1,4,0,3
15624,353,2,351,335,0,0,0,0,7
15625,130,1,129,123,0,0,0,0,1
15626,5095,84,5011,4692,58,0,149,4,14
15627,6461,69,6392,6131,49,6,11,0,12
15628,410,0,410,394,3,0,6,0,0
15629,602,9,593,552,25,0,2,0,3
15631,986,2,984,908,26,0,4,0,5
15632,9662,150,9512,8698,131,6,337,1,21
15633,504,11,493,474,3,0,6,0,0
15634,499,8,491,440,8,0,4,0,5
15635,270,6,264,246,4,1,2,0,1
15636,3730,64,3666,3510,25,0,34,0,14
15637,1836,26,1810,1720,8,4,1,0,3
15638,342,1,341,325,0,0,0,0,0
15639,2062,25,2037,1953,7,2,13,0,5
15640,298,10,288,274,3,0,0,0,0
15641,509,6,503,473,1,0,3,0,1
15642,46461,594,45867,43511,426,21,477,3,80
15644,18320,268,18052,16213,770,8,94,1,53
15646,201,2,199,187,0,0,0,0,0
15647,36,2,34,29,0,0,0,0,0
15650,26523,408,26115,24708,356,23,141,3,45
15655,357,4,353,341,1,0,1,0,4
15656,9827,111,9716,9162,109,15,25,1,15
15658,8149,98,8051,7776,17,7,18,3,32
15660,230,0,230,210,2,0,1,0,3
15661,543,4,539,517,1,1,1,0,1
15662,393,2,391,376,3,0,3,0,0
15663,401,3,398,378,3,0,0,0,0
15665,1558,29,1529,1436,10,3,12,0,6
15666,15585,180,15405,14671,142,8,46,0,25
15668,13433,263,13170,11864,148,12,735,2,48
15670,3435,30,3405,3244,15,4,15,2,5
15671,684,2,682,661,2,1,2,0,0
15672,3320,45,3275,3086,50,2,32,0,11
15673,1246,8,1238,1171,15,4,1,2,1
15674,281,0,281,277,0,0,2,0,0
15675,993,10,983,935,11,1,0,0,0
15676,586,6,580,556,4,2,1,0,2
15677,382,6,376,353,12,0,2,0,3
15678,603,7,596,556,9,5,1,0,1
15679,2957,31,2926,2795,16,3,7,0,10
15680,188,0,188,181,0,0,1,0,0
15681,4772,52,4720,4475,43,15,7,0,20
15682,250,0,250,240,0,0,0,0,0
15683,8285,78,8207,7803,71,7,30,4,31
15684,471,5,466,435,10,0,0,0,0
15686,925,2,923,892,3,0,2,0,5
15687,1317,12,1305,1271,1,2,1,0,2
15688,791,5,786,754,3,0,4,0,3
15689,120,1,119,117,1,0,0,0,0
15690,8754,88,8666,7775,332,18,24,1,25
15691,161,1,160,160,0,0,0,0,0
15692,944,23,921,865,4,1,7,0,8
15693,228,2,226,220,0,0,0,0,0
15695,295,2,293,275,1,1,1,0,0
15696,252,5,247,240,0,0,2,0,0
15697,2923,37,2886,2695,43,6,16,0,13
15698,767,1,766,755,0,1,1,0,1
15701,30269,733,29536,26250,1465,41,635,1,51
15705,3374,301,3073,2281,639,1,78,0,7
15710,305,1,304,284,3,2,0,0,2
15711,363,0,363,355,4,0,0,0,1
15712,77,0,77,77,0,0,0,0,0
15713,251,0,251,241,0,0,0,0,0
15714,5477,45,5432,5221,23,5,11,3,6
15715,647,9,638,594,2,0,0,0,10
15716,488,16,472,432,8,0,2,0,3
15717,9454,120,9334,8780,176,13,36,0,15
15720,224,2,222,219,0,0,0,0,0
15721,188,1,187,178,1,1,1,0,0
15722,2452,20,2432,2379,3,0,0,0,1
15723,38,0,38,36,1,0,0,0,0
15724,1941,14,1927,1876,4,4,3,0,5
15725,1184,6,1178,1130,2,0,4,0,1
15727,213,1,212,210,0,0,0,0,0
15728,3417,24,3393,3253,17,5,12,0,9
15729,1315,10,1305,1254,2,2,1,1,0
15730,129,1,128,128,0,0,0,0,0
15731,257,4,253,230,5,0,0,0,0
15732,1557,11,1546,1481,4,0,0,0,2
15733,91,1,90,84,0,0,0,0,0
15734,295,1,294,286,4,0,0,0,1
15736,397,0,397,386,0,0,0,0,1
15737,190,0,190,186,0,0,0,0,1
15738,265,4,261,252,0,0,0,0,0
15739,417,8,409,395,1,2,0,0,1
15741,57,0,57,57,0,0,0,0,0
15742,990,12,978,926,10,1,0,0,1
15744,74,1,73,64,0,0,2,0,0
15745,327,3,324,315,0,0,0,0,0
15746,195,0,195,193,1,0,0,0,1
15747,1970,5,1965,1909,4,4,3,0,1
15748,6661,98,6563,6328,34,0,15,5,7
15750,285,1,284,256,12,0,0,0,3
15752,63,1,62,58,0,0,0,0,0
15753,514,1,513,491,0,1,0,0,1
15754,498,3,495,471,2,3,1,0,1
15756,213,1,212,201,0,0,0,0,0
15757,1497,8,1489,1446,3,2,2,0,2
15759,2661,20,2641,2561,5,2,4,0,8
15760,119,0,119,118,0,0,0,0,0
15761,74,0,74,74,0,0,0,0,0
15762,875,5,870,846,0,3,0,0,0
15763,16,0,16,15,0,0,0,0,0
15764,136,1,135,134,0,0,0,0,0
15765,1549,12,1537,1487,5,3,3,0,7
15767,14501,147,14354,13740,48,20,38,5,42
15770,219,0,219,216,0,0,0,0,0
15771,898,1,897,877,2,0,0,0,0
15772,1605,12,1593,1538,7,7,1,0,1
15773,410,3,407,388,0,0,0,0,0
15774,2985,15,2970,2860,11,4,10,1,10
15775,410,3,407,393,1,0,1,0,0
15776,62,1,61,61,0,0,0,0,0
15777,118,2,116,116,0,0,0,0,0
15778,135,2,133,122,0,0,0,0,5
15779,399,9,390,337,42,0,0,0,2
15780,123,0,123,123,0,0,0,0,0
15781,107,1,106,103,0,0,0,0,0
15783,103,0,103,102,1,0,0,0,0
15784,80,5,75,72,0,1,0,0,0
15801,20246,612,19634,18613,124,23,214,0,68
15821,147,0,147,145,0,0,0,0,0
15823,1370,11,1359,1304,2,0,6,0,3
15824,5370,26,5344,5124,12,2,5,0,3
15825,9629,92,9537,9184,36,9,35,2,16
15827,259,1,258,240,0,0,4,0,0
15828,297,2,295,285,1,0,1,0,3
15829,1146,6,1140,1082,1,3,3,0,1
15831,197,1,196,172,0,0,4,0,2
15832,313,5,308,300,1,0,1,0,1
15834,4078,77,4001,3835,8,8,24,0,11
15840,1892,28,1864,1813,1,1,2,0,0
15841,208,0,208,201,0,0,0,0,0
15845,3088,44,3044,2886,21,4,7,3,4
15846,3209,18,3191,3106,2,0,6,1,5
15847,62,0,62,60,0,0,0,0,0
15848,945,3,942,925,1,0,3,0,0
15849,1195,15,1180,1124,1,0,5,0,2
15851,6537,56,6481,6195,12,8,7,0,8
15853,6457,64,6393,6101,23,1,23,0,7
15856,874,8,866,829,0,3,4,0,0
15857,12906,126,12780,12301,25,6,58,8,22
15860,1118,4,1114,1075,0,0,4,1,1
15861,135,2,133,124,1,0,2,0,0
15863,217,0,217,214,0,2,0,0,0
15864,1815,8,1807,1762,4,0,1,0,3
15865,1187,6,1181,1117,9,0,1,0,1
15866,230,0,230,220,0,0,0,0,0
15868,1570,16,1554,1501,0,4,3,0,1
15870,1262,5,1257,1215,1,1,2,0,3
15901,3379,113,3266,2188,760,10,15,2,13
15902,11107,393,10714,7939,1846,14,38,5,62
15904,16065,274,15791,14581,386,12,283,6,69
15905,19654,440,19214,17838,450,6,194,6,43
15906,10060,341,9719,7908,1216,10,26,4,26
15909,5116,72,5044,4804,69,5,8,1,15
15920,780,11,769,721,1,3,4,0,3
15921,471,2,469,436,5,2,0,0,0
15922,74,0,74,73,0,0,0,0,0
15923,1544,15,1529,1436,21,3,3,0,6
15924,979,9,970,949,2,0,0,2,1
15925,162,3,159,144,3,0,0,0,0
15926,2429,21,2408,2334,3,4,2,1,2
15927,1097,6,1091,1039,7,0,5,0,3
15928,2002,13,1989,1947,1,2,0,0,2
15929,66,0,66,63,0,1,0,0,0
15930,295,7,288,268,4,0,1,0,0
15931,9158,100,9058,8588,216,6,44,0,11
15934,87,3,84,81,2,0,0,0,0
15935,2247,18,2229,2148,4,1,10,0,7
15936,1493,13,1480,1405,3,0,1,1,3
15937,899,6,893,869,3,0,2,0,0
15938,2472,30,2442,2335,1,0,0,0,3
15940,3712,196,3516,2887,511,4,46,1,9
15942,1864,22,1842,1796,17,1,5,0,4
15943,3603,27,3576,3440,22,2,0,0,9
15944,3151,27,3124,2971,6,2,6,0,4
15945,218,3,215,199,7,0,2,1,0
15946,6642,64,6578,6364,14,1,12,1,10
15948,525,5,520,507,0,0,2,0,1
15949,631,6,625,603,1,0,1,0,0
15951,570,9,561,552,1,0,0,0,0
15952,1233,3,1230,1185,2,0,7,2,1
15953,83,0,83,78,0,0,0,0,0
15954,2153,7,2146,2070,15,0,4,0,0
15955,2116,24,2092,2034,7,0,0,0,0
15956,2626,31,2595,2504,10,0,4,0,2
15957,380,2,378,367,4,0,0,0,0
15958,2136,23,2113,2033,2,2,2,0,0
15960,280,2,278,265,1,0,0,0,0
15961,928,6,922,896,0,0,2,0,0
15962,198,2,196,195,0,0,0,0,0
15963,10733,137,10596,10170,39,10,28,1,12
16001,40085,836,39249,36651,605,59,241,14,103
16002,15379,222,15157,14512,153,3,44,1,32
16020,1155,4,1151,1100,3,2,1,0,2
16022,294,4,290,283,0,0,0,0,0
16023,3987,33,3954,3816,15,2,8,0,15
16024,212,2,210,201,0,0,2,0,1
16025,5220,32,5188,5030,12,3,5,0,3
16027,376,5,371,357,0,0,0,0,0
16028,1761,17,1744,1690,0,1,7,0,1
16029,764,11,753,728,3,0,0,0,4
16030,307,1,306,297,0,0,2,0,1
16033,6670,130,6540,6207,22,4,41,1,23
16034,1769,18,1751,1699,0,1,0,0,4
16035,128,1,127,123,1,0,0,0,0
16036,183,2,181,177,0,1,0,0,0
16037,5012,66,4946,4724,33,0,20,0,13
16038,3153,18,3135,3007,14,1,9,1,7
16040,963,8,955,911,5,0,2,0,0
16041,1781,18,1763,1711,3,2,2,0,4
16045,1195,39,1156,1058,12,2,4,0,8
16046,19257,547,18710,16489,250,10,1291,3,68
16048,168,1,167,158,0,0,2,0,1
16049,3098,29,3069,2978,8,0,6,1,8
16050,1250,9,1241,1184,3,2,0,0,6
16051,2895,18,2877,2721,7,5,7,0,4
16052,2283,30,2253,2160,4,2,15,0,1
16053,4028,44,3984,3830,5,4,15,0,11
16054,418,2,416,403,1,0,1,0,6
16055,8886,90,8796,8432,25,11,57,1,6
16056,4779,35,4744,4608,18,0,17,0,7
16057,14327,299,14028,12778,317,14,310,2,66
16059,9520,160,9360,8949,29,2,109,0,25
16061,2499,23,2476,2363,10,3,5,0,6
16063,7596,137,7459,7108,36,1,67,1,13
16066,32922,978,31944,28606,618,26,1417,12,163
16101,31960,873,31087,26108,2737,41,90,0,112
16102,5468,89,5379,4846,153,5,13,0,16
16105,15420,240,15180,14082,373,9,127,0,50
16110,357,1,356,346,0,0,1,0,1
16111,1244,6,1238,1204,2,1,2,0,1
16112,1525,21,1504,1448,5,0,0,0,4
16113,330,4,326,318,2,0,0,0,0
16114,613,3,610,585,0,1,1,0,0
16115,3324,34,3290,3135,16,1,3,3,15
16116,2573,38,2535,2436,11,1,9,0,0
16117,16459,243,16216,15100,146,11,54,3,28
16120,2221,19,2202,2121,10,0,1,0,0
16121,4258,82,4176,1852,1980,4,17,0,40
16123,2158,16,2142,2058,5,1,17,0,5
16124,1923,16,1907,1816,3,0,3,0,4
16125,17198,237,16961,16004,214,14,111,3,23
16127,15298,262,15036,14053,191,22,134,3,56
16130,1964,9,1955,1887,0,1,5,0,2
16131,971,10,961,930,1,1,2,0,1
16132,380,2,378,364,0,0,0,0,0
16133,1365,9,1356,1315,3,0,0,0,1
16134,3498,28,3470,3345,2,6,7,3,5
16136,748,9,739,689,9,0,2,0,7
16137,12654,175,12479,11380,635,7,51,0,20
16140,226,0,226,216,0,0,0,0,2
16141,1653,21,1632,1498,4,0,3,0,6
16142,5906,86,5820,5570,48,3,15,0,16
16143,2398,19,2379,2297,2,3,6,0,11
16145,2586,21,2565,2430,10,5,4,0,7
16146,13181,316,12865,9530,2165,21,90,1,73
16148,16673,224,16449,14758,793,18,213,5,68
16150,7172,92,7080,6620,99,7,34,0,22
16151,69,1,68,63,2,1,0,0,0
16153,2451,19,2432,2328,5,5,2,1,4
16154,2354,39,2315,2170,11,1,3,0,7
16155,100,0,100,92,4,0,0,0,0
16156,3218,28,3190,3031,21,1,8,0,8
16157,3112,44,3068,2879,18,1,6,2,10
16159,4264,42,4222,3952,70,1,11,1,5
16160,799,4,795,760,10,0,2,0,2
16161,597,14,583,460,89,1,1,0,3
16172,707,9,698,635,45,0,0,0,1
16201,17236,166,17070,16368,94,21,52,0,39
16210,961,2,959,932,2,1,0,0,0
16211,115,0,115,114,0,1,0,0,0
16212,324,0,324,319,0,0,0,0,0
16213,132,1,131,127,1,0,0,0,1
16214,8308,199,8109,7305,349,16,125,3,33
16217,59,0,59,58,0,0,0,0,0
16218,1041,7,1034,1003,10,0,0,0,1
16220,45,0,45,44,0,0,0,0,0
16222,2557,10,2547,2486,1,0,4,0,0
16223,142,0,142,141,0,0,0,0,0
16224,1086,12,1074,1027,4,0,0,2,4
16226,7880,55,7825,7460,79,7,12,5,24
16228,361,3,358,335,3,0,7,0,1
16229,4978,51,4927,4772,14,2,19,0,6
16230,477,3,474,461,0,0,0,0,0
16232,4479,26,4453,4308,12,3,6,2,11
16233,1161,8,1153,1139,2,0,2,0,0
16235,1223,3,1220,1175,7,0,0,0,1
16236,250,1,249,236,5,0,0,0,0
16238,382,5,377,359,1,0,1,0,0
16239,4196,300,3896,2609,1232,5,12,0,1
16240,1520,7,1513,1462,6,1,2,1,0
16242,4623,34,4589,4445,25,1,12,0,18
16244,247,0,247,243,0,0,0,0,0
16245,199,1,198,197,0,0,0,0,0
16246,220,1,219,212,0,0,0,0,0
16248,3141,15,3126,3001,12,0,7,1,5
16249,1717,19,1698,1658,3,0,2,0,1
16250,404,8,396,383,0,0,0,0,0
16253,161,0,161,151,0,0,0,0,0
16254,3174,35,3139,2964,63,5,16,3,8
16255,1932,13,1919,1861,3,7,2,0,11
16256,2076,12,2064,2021,3,1,1,0,3
16258,1774,10,1764,1688,28,2,2,2,5
16259,1725,14,1711,1657,3,2,0,0,2
16260,229,4,225,218,0,0,0,0,1
16262,2783,9,2774,2670,8,2,13,0,7
16263,330,2,328,321,0,0,0,0,0
16301,14935,242,14693,13806,196,17,34,4,20
16311,514,7,507,478,0,1,0,0,1
16312,17,0,17,16,0,0,0,0,0
16313,1691,18,1673,1609,3,1,4,0,3
16314,5296,37,5259,5068,14,12,20,1,8
16316,5056,61,4995,4811,5,6,17,1,9
16317,1306,10,1296,1259,2,0,1,1,1
16319,1401,12,1389,1337,4,3,4,0,2
16321,43,0,43,39,0,0,0,0,1
16322,123,0,123,123,0,0,0,0,0
16323,15116,174,14942,13971,167,21,63,2,27
16326,377,0,377,374,0,0,0,0,1
16327,2557,23,2534,2436,13,4,6,2,1
16328,183,0,183,175,1,0,1,0,0
16329,378,0,378,366,0,0,2,0,3
16331,87,0,87,84,0,0,0,0,0
16332,119,0,119,115,0,0,0,0,0
16333,311,1,310,307,0,0,1,0,0
16334,416,2,414,407,1,0,0,0,0
16335,27452,585,26867,24245,1002,33,207,10,87
16340,1775,17,1758,1714,2,1,2,1,0
16341,1975,21,1954,1850,7,0,7,0,5
16342,2092,17,2075,1965,20,0,7,1,9
16343,405,1,404,374,4,2,2,0,0
16344,457,1,456,432,1,3,1,0,0
16345,3562,39,3523,3368,5,4,27,0,4
16346,2846,18,2828,2732,3,9,16,0,5
16347,1924,14,1910,1829,3,7,4,1,2
16350,2669,16,2653,2532,5,7,7,0,6
16351,1493,17,1476,1406,0,2,3,0,10
16352,243,1,242,231,1,1,0,0,2
16353,2690,14,2676,2583,3,2,5,0,5
16354,10255,142,10113,9518,76,19,35,2,32
16360,1261,15,1246,1181,1,2,4,0,4
16361,61,0,61,58,1,0,0,0,0
16362,1085,11,1074,1019,4,3,0,1,4
16364,1363,3,1360,1323,1,0,3,0,0
16365,17428,229,17199,16235,113,41,92,1,25
16370,157,6,151,143,0,0,0,0,0
16371,3218,28,3190,3054,11,5,8,0,0
16372,435,2,433,402,2,0,4,0,0
16373,3355,25,3330,3149,44,8,21,0,8
16374,1789,12,1777,1706,9,0,4,0,5
16401,4209,54,4155,3981,13,6,11,2,7
16402,734,7,727,696,0,0,2,0,0
16403,6626,148,6478,5956,282,7,29,1,23
16404,3113,20,3093,2960,5,2,1,0,9
16405,646,8,638,599,0,0,0,0,0
16406,3383,21,3362,3207,18,5,14,1,7
16407,10526,106,10420,9791,48,20,20,0,13
16410,1798,18,1780,1689,1,1,0,1,5
16411,1323,18,1305,1242,5,0,1,0,0
16412,9292,166,9126,8547,111,15,51,0,27
16415,9898,242,9656,8908,84,19,293,0,17
16416,166,0,166,151,0,0,0,0,0
16417,8109,135,7974,7611,21,12,25,0,24
16420,599,3,596,566,1,3,1,0,1
16421,2351,35,2316,2229,5,0,6,0,4
16422,309,2,307,292,0,0,0,0,0
16423,4122,109,4013,3773,38,3,5,0,20
16424,4405,56,4349,4179,17,3,10,0,9
16426,3785,42,3743,3575,15,3,4,0,21
16427,238,3,235,232,0,0,0,0,0
16428,12524,282,12242,11481,99,12,51,2,32
16430,101,2,99,96,0,0,0,0,1
16433,4982,68,4914,4710,38,1,7,0,13
16434,3118,23,3095,2972,5,12,1,4,14
16435,1764,13,1751,1676,10,2,0,0,2
16436,706,8,698,664,0,0,0,2,0
16438,7504,85,7419,7032,14,11,23,2,21
16440,816,6,810,763,0,1,3,0,3
16441,10240,145,10095,9556,36,17,70,3,23
16442,2750,21,2729,2561,13,1,6,0,1
16443,1330,17,1313,1250,6,1,1,0,5
16444,1202,56,1146,976,143,1,10,0,0
16475,2275,147,2128,1069,1043,4,2,0,0
16501,2241,186,2055,1372,498,7,34,4,38
16502,15435,1490,13945,9866,2498,25,348,4,144
16503,15328,2206,13122,5829,5395,26,743,8,92
16504,16135,1061,15074,11269,2113,41,686,8,75
16505,16437,469,15968,14893,245,13,151,3,36
16506,23918,649,23269,20923,495,24,972,0,58
16507,9429,818,8611,5479,2122,22,290,3,94
16508,15172,810,14362,12078,1056,13,321,4,60
16509,28005,713,27292,24463,719,21,997,2,95
16510,24515,1319,23196,18884,2093,18,1006,13,100
16511,11347,523,10824,9411,667,5,213,0,44
16546,1166,44,1122,1047,46,3,19,1,0
16550,0,0,0,0,0,0,0,0,0
16563,1466,84,1382,1172,189,0,2,0,0
16601,32764,536,32228,29157,1287,47,227,2,138
16602,27996,474,27522,25162,792,33,194,3,111
16611,2376,43,2333,2212,15,4,3,0,10
16613,1528,16,1512,1480,0,1,2,0,0
16616,112,1,111,110,0,0,0,0,0
16617,2655,24,2631,2487,20,1,8,0,9
16619,348,1,347,335,0,2,0,0,0
16620,415,7,408,401,0,2,2,0,0
16621,646,6,640,624,4,7,0,0,0
16622,116,1,115,107,5,0,0,0,0
16623,480,3,477,466,0,0,0,0,0
16624,267,0,267,259,0,1,1,0,0
16625,3402,41,3361,3233,10,0,6,0,9
16627,2199,31,2168,2050,22,5,5,0,0
16630,4679,49,4630,4380,53,3,35,1,10
16631,85,2,83,79,0,0,1,0,0
16633,181,2,179,177,0,0,0,0,0
16634,283,4,279,265,3,0,2,0,0
16635,11661,132,11529,10980,100,10,142,0,34
16636,722,1,721,696,0,0,1,0,6
16637,2463,17,2446,2350,11,1,1,0,8
16638,73,1,72,69,0,1,0,0,0
16639,1212,7,1205,1161,2,1,1,1,2
16640,1064,8,1056,1003,3,0,1,0,5
16641,2527,33,2494,2398,6,1,6,0,3
16645,127,0,127,122,0,0,0,0,0
16646,2440,24,2416,2346,3,4,1,0,3
16647,762,2,760,732,0,3,0,0,0
16648,15149,172,14977,14202,134,10,221,4,19
16650,1826,13,1813,1768,4,0,3,0,0
16651,5796,239,5557,4362,1105,1,18,0,1
16652,15955,322,15633,14165,856,17,175,6,44
16654,2011,174,1837,742,1084,3,6,0,0
16655,1451,11,1440,1401,3,5,0,0,3
16656,1137,9,1128,1103,2,3,1,0,1
16657,1260,10,1250,1164,21,4,6,0,6
16659,261,1,260,256,0,0,0,0,0
16661,1007,12,995,965,1,0,0,0,6
16662,5574,71,5503,5364,11,4,10,1,7
16664,2089,17,2072,1998,6,1,13,0,2
16665,324,3,321,310,2,0,1,0,0
16666,2643,27,2616,2534,6,2,9,0,4
16667,1368,2,1366,1316,4,2,0,0,1
16668,3409,43,3366,3244,6,0,4,0,4
16669,2034,29,2005,1935,10,2,1,0,6
16670,133,0,133,122,2,0,1,0,0
16671,491,4,487,474,2,0,0,0,0
16672,187,0,187,186,0,0,0,0,0
16673,5317,50,5267,5101,16,2,14,0,4
16674,484,5,479,460,1,0,1,0,0
16675,102,0,102,100,0,0,0,0,0
16677,416,3,413,409,0,0,0,0,0
16678,2548,25,2523,2439,12,2,2,0,1
16679,734,12,722,709,0,0,0,0,1
16680,416,2,414,398,1,0,1,0,5
16682,206,1,205,198,0,2,1,0,1
16683,395,25,370,354,0,0,1,0,5
16684,65,1,64,62,0,1,0,0,0
16685,279,3,276,265,3,0,0,0,0
16686,13861,157,13704,13121,74,21,35,1,24
16689,379,2,377,368,0,1,0,0,0
16691,352,1,351,344,0,0,0,0,0
16692,807,3,804,771,3,1,1,0,0
16693,4061,60,4001,3879,11,3,11,1,0
16694,320,2,318,313,1,0,0,0,0
16695,967,12,955,930,2,0,2,0,0
16699,0,0,0,0,0,0,0,0,0
16701,16887,286,16601,15367,260,68,124,2,53
16720,1126,10,1116,1074,2,1,4,0,4
16724,94,0,94,92,1,0,0,0,0
16725,128,0,128,117,0,0,5,0,0
16726,493,6,487,469,2,0,1,0,0
16727,196,5,191,180,1,0,0,0,1
16729,745,0,745,707,0,0,0,0,0
16730,165,0,165,159,0,0,0,0,0
16731,2607,15,2592,2465,3,7,9,0,7
16732,251,0,251,231,0,0,0,0,0
16733,195,4,191,190,0,0,1,0,0
16734,207,1,206,204,0,0,0,0,0
16735,6208,74,6134,5836,22,4,22,0,7
16738,1985,170,1815,1240,543,3,9,0,0
16740,930,5,925,891,0,4,2,0,0
16743,3933,36,3897,3683,9,11,5,0,8
16744,219,1,218,210,0,2,3,0,0
16745,555,1,554,534,0,1,0,0,0
16746,1099,29,1070,1040,4,0,2,0,0
16748,2831,35,2796,2711,5,5,2,0,0
16749,3852,36,3816,3661,6,2,11,0,4
16750,453,8,445,418,2,1,0,0,2
16801,42446,2208,40238,32519,1212,24,4618,24,233
16802,12977,591,12386,10528,317,0,800,0,12
16803,24751,1171,23580,16246,1052,13,5265,3,115
16820,1106,11,1095,1076,1,3,0,0,3
16821,249,7,242,236,0,0,0,0,0
16822,2189,18,2171,2082,5,1,4,0,4
16823,29345,914,28431,25071,2320,25,197,9,80
16825,254,3,251,246,0,0,1,0,0
16826,581,4,577,560,0,2,0,0,0
16827,4995,132,4863,4297,188,12,146,0,18
16828,4377,57,4320,4146,20,4,14,0,17
16829,676,2,674,656,0,0,0,0,0
16830,13121,167,12954,12341,102,13,75,0,23
16832,469,15,454,427,3,0,0,1,6
16833,5309,39,5270,5095,23,1,6,0,16
16834,266,0,266,264,0,0,0,0,0
16835,226,3,223,212,0,2,0,0,3
16836,1167,6,1161,1126,1,1,3,0,0
16837,190,1,189,186,0,0,1,0,0
16838,1720,12,1708,1657,3,2,2,0,1
16839,465,1,464,444,0,0,0,0,0
16840,366,4,362,345,0,1,1,0,0
16841,5601,49,5552,5371,13,6,18,0,2
16843,702,10,692,667,3,0,1,0,0
16844,2644,23,2621,2518,10,2,8,0,18
16845,1055,49,1006,828,164,0,1,0,0
16847,313,0,313,308,0,0,0,0,0
16848,254,0,254,245,0,0,0,0,0
16849,318,0,318,308,0,0,0,0,0
16851,956,40,916,798,23,0,37,1,4
16852,350,5,345,337,0,0,0,0,0
16853,404,12,392,377,3,0,0,0,2
16854,884,14,870,846,1,2,0,0,2
16855,305,3,302,295,0,0,0,0,0
16856,159,2,157,157,0,0,0,0,0
16858,3847,19,3828,3724,5,5,0,0,3
16859,460,6,454,443,0,0,1,0,0
16860,380,0,380,359,2,2,0,0,1
16861,316,2,314,306,0,0,0,0,0
16863,727,3,724,698,0,2,0,0,0
16864,64,0,64,64,0,0,0,0,0
16865,1575,33,1542,1418,7,3,12,0,26
16866,9850,1407,8443,7860,210,20,120,0,12
16868,640,7,633,586,12,0,11,0,4
16870,7452,188,7264,6684,72,5,189,0,25
16871,33,0,33,28,0,1,0,0,0
16872,1584,16,1568,1548,3,2,2,0,1
16874,1264,10,1254,1221,3,0,4,0,0
16875,4031,30,4001,3845,14,1,12,1,9
16876,295,1,294,278,0,0,1,0,0
16877,1684,28,1656,1582,9,0,8,0,0
16878,1862,5,1857,1784,2,0,3,0,4
16879,342,0,342,317,0,2,0,0,1
16881,1923,14,1909,1848,1,1,2,0,5
16882,482,3,479,459,1,0,0,0,6
16901,10561,169,10392,9894,38,21,89,2,30
16910,72,1,71,71,0,0,0,0,0
16911,164,0,164,157,0,0,1,0,0
16912,2060,48,2012,1904,2,4,6,0,5
16914,2248,23,2225,2091,7,4,9,1,0
16915,5756,110,5646,5321,15,13,50,0,20
16917,1464,20,1444,1372,3,5,4,0,6
16920,1977,27,1950,1821,18,6,0,0,4
16921,563,2,561,543,1,0,0,0,1
16922,1775,12,1763,1703,9,2,4,0,7
16923,1360,17,1343,1276,2,2,4,0,12
16925,3328,42,3286,3139,1,7,7,0,5
16926,875,8,867,845,2,1,0,0,1
16927,595,2,593,584,0,0,1,0,1
16928,1327,27,1300,1228,5,1,2,3,3
16929,2506,35,2471,2336,6,2,3,1,5
16930,1255,9,1246,1193,10,2,3,0,2
16932,669,8,661,628,5,2,3,0,2
16933,6643,181,6462,5915,197,13,51,0,26
16935,1194,9,1185,1130,3,0,4,0,1
16936,2111,22,2089,1989,4,2,5,0,5
16937,152,0,152,145,0,0,0,0,0
16938,711,12,699,664,4,0,1,0,1
16939,198,1,197,189,2,2,0,0,0
16940,58,0,58,55,0,1,0,0,0
16941,48,3,45,45,0,0,0,0,0
16942,716,19,697,684,1,1,0,0,0
16943,462,6,456,434,0,1,0,0,4
16946,2524,16,2508,2390,13,3,8,0,3
16947,4759,60,4699,4540,28,7,15,1,2
16948,1669,28,1641,1595,8,0,2,0,3
16950,3463,29,3434,3325,7,1,8,1,2
17002,665,0,665,662,0,0,0,0,0
17003,12329,601,11728,11009,149,8,198,1,35
17004,5414,45,5369,5262,16,11,3,0,5
17005,309,7,302,294,0,0,0,1,0
17006,1071,39,1032,992,1,0,5,1,3
17007,5954,158,5796,5415,44,3,49,1,33
17009,1920,48,1872,1790,17,0,5,0,7
17010,113,4,109,105,2,0,0,0,0
17011,36184,2411,33773,28049,2303,52,1885,10,190
17013,36578,2113,34465,28628,2810,42,1124,19,123
17014,213,2,211,204,0,0,0,0,0
17015,22316,587,21729,20459,244,15,259,6,53
17016,508,19,489,477,9,0,0,0,2
17017,1723,14,1709,1666,2,0,2,1,4
17018,4324,104,4220,4014,53,4,20,0,0
17019,19156,524,18632,17567,156,10,220,6,80
17020,8587,176,8411,7951,50,8,44,0,22
17021,875,9,866,840,2,0,0,1,0
17022,31163,1456,29707,27752,479,25,432,6,100
17023,3298,76,3222,3091,16,3,31,0,7
17024,1964,26,1938,1877,3,1,4,0,4
17025,17664,824,16840,14177,625,28,1195,13,104
17026,3651,149,3502,3316,42,0,16,0,20
17027,3420,246,3174,2472,180,3,371,0,7
17028,3448,358,3090,2889,32,8,29,2,37
17029,350,14,336,321,2,1,0,0,0
17030,523,12,511,488,2,2,4,0,0
17032,7816,121,7695,7381,51,1,41,2,23
17033,16414,1755,14659,11993,826,8,1138,11,63
17034,2765,425,2340,1673,422,7,23,0,23
17035,734,3,731,704,1,0,0,0,0
17036,24146,1218,22928,19190,868,23,1784,1,68
17037,993,25,968,947,2,6,1,0,3
17038,7842,436,7406,7057,42,8,65,2,29
17039,34,0,34,33,0,0,0,0,0
17040,2555,43,2512,2408,4,0,5,0,9
17041,194,0,194,191,0,0,0,0,0
17042,40618,7034,33584,30621,1082,38,672,10,137
17043,6184,514,5670,4795,324,11,162,4,39
17044,20681,641,20040,18972,247,29,93,0,55
17045,3322,56,3266,3107,37,4,17,0,17
17046,31272,10263,21009,19150,729,26,330,8,85
17047,2688,61,2627,2569,18,2,5,0,9
17048,4006,88,3918,3733,28,5,12,2,10
17049,3121,60,3061,2968,15,2,7,0,12
17050,42722,1640,41082,31609,1071,44,6747,18,168
17051,4425,52,4373,4265,13,0,5,0,6
17052,1514,12,1502,1432,12,0,1,1,0
17053,5127,154,4973,4664,56,16,23,2,4
17054,147,0,147,144,0,2,0,0,0
17055,40353,1719,38634,33683,1901,67,1395,34,176
17056,57,0,57,54,0,0,0,0,0
17057,23112,2000,21112,17417,1658,32,790,18,108
17058,1779,189,1590,1520,19,0,4,0,2
17059,7655,474,7181,6933,34,12,41,3,10
17060,1152,8,1144,1124,3,0,2,0,1
17061,6966,164,6802,6453,103,7,44,1,16
17062,4096,45,4051,3896,12,1,13,0,13
17063,3484,75,3409,3295,19,0,7,0,1
17064,847,18,829,787,3,0,14,1,7
17065,4265,145,4120,3829,76,2,46,2,14
17066,4883,99,4784,4283,225,3,8,0,11
17067,15677,594,15083,14546,146,7,105,3,41
17068,4302,76,4226,4037,46,5,10,0,4
17069,316,6,310,304,0,0,2,0,0
17070,16359,978,15381,13949,444,14,254,3,74
17071,151,4,147,144,0,0,2,0,0
17073,5927,185,5742,5508,40,3,29,4,12
17074,7552,165,7387,6998,56,2,11,0,34
17075,119,1,118,116,0,0,0,0,0
17076,36,0,36,30,2,0,0,0,0
17077,105,9,96,95,0,0,0,0,1
17078,23496,1037,22459,20463,316,22,792,5,95
17080,292,23,269,255,8,3,0,0,0
17081,443,14,429,410,0,0,2,1,5
17082,3282,87,3195,3085,20,4,7,0,11
17084,4341,39,4302,4153,16,3,28,0,2
17086,2343,33,2310,2247,11,0,8,1,5
17087,2787,114,2673,2574,13,3,15,2,5
17088,668,22,646,616,9,0,2,0,3
17090,5093,63,5030,4800,16,8,11,0,19
17093,705,25,680,623,15,5,10,0,4
17094,2339,47,2292,2219,10,0,5,0,9
17097,845,21,824,795,3,0,7,0,0
17098,2397,88,2309,2165,52,1,0,0,1
17099,1158,13,1145,1088,3,2,11,0,0
17101,2901,291,2610,1436,831,11,177,3,23
17102,7989,950,7039,3892,2464,10,228,5,81
17103,12225,3149,9076,2069,5983,29,220,0,124
17104,20058,6981,13077,2889,8288,43,837,7,140
17109,25232,2887,22345,11998,6156,47,2701,11,159
17110,27239,2892,24347,12612,8298,38,1927,6,186
17111,36557,3790,32767,19713,6196,70,5034,7,198
17112,37137,1678,35459,29445,2447,25,1871,2,128
17113,11649,2016,9633,4911,3587,16,213,9,71
17120,4,0,4,0,0,0,0,0,0
17201,27556,5814,21742,17695,2369,58,328,10,91
17202,30805,1961,28844,26413,885,43,356,11,90
17210,241,3,238,232,1,0,0,0,0
17211,407,1,406,393,1,0,0,0,0
17212,635,6,629,593,15,0,4,0,0
17213,535,2,533,514,0,0,0,2,0
17214,1093,45,1048,965,12,0,7,0,3
17215,256,2,254,245,1,0,0,0,0
17217,148,1,147,146,0,0,0,0,0
17219,515,8,507,494,0,5,0,0,0
17220,568,6,562,552,2,0,0,0,0
17221,538,6,532,510,1,0,3,0,0
17222,11224,512,10712,9953,240,20,100,5,32
17223,287,3,284,279,0,0,0,0,0
17224,1742,26,1716,1636,17,5,4,1,3
17225,20199,510,19689,18444,302,22,203,2,66
17228,1121,8,1113,1066,2,2,4,0,1
17229,1252,9,1243,1202,1,7,1,0,0
17232,25,0,25,24,0,0,0,0,0
17233,5143,61,5082,4796,80,7,16,2,0
17235,559,24,535,506,9,0,1,0,1
17236,8620,167,8453,8011,127,8,30,1,17
17237,1765,63,1702,1550,52,6,12,0,3
17238,1748,9,1739,1672,1,0,0,0,5
17239,264,2,262,255,1,0,0,0,0
17240,3598,25,3573,3457,25,1,6,0,9
17241,11878,188,11690,11193,79,14,29,4,39
17243,1348,14,1334,1281,9,2,1,0,2
17244,2362,40,2322,2239,20,4,10,0,9
17246,282,5,277,261,5,0,2,0,0
17247,391,4,387,383,0,0,1,0,0
17249,379,9,370,363,1,0,0,0,0
17250,111,3,108,91,1,2,0,0,0
17251,140,0,140,138,0,0,1,0,0
17252,4000,107,3893,3672,44,7,7,0,24
17253,318,4,314,304,2,0,0,0,0
17254,416,23,393,342,9,0,31,1,0
17255,960,13,947,918,0,0,1,0,4
17257,28673,1089,27584,25140,779,29,540,5,97
17260,1193,18,1175,1138,4,0,2,0,2
17261,0,0,0,0,0,0,0,0,0
17262,1029,19,1010,970,2,2,3,1,0
17263,661,36,625,560,18,0,9,0,9
17264,2336,21,2315,2251,6,3,2,0,11
17265,448,18,430,408,5,0,1,0,4
17266,552,2,550,519,10,0,0,0,1
17267,2799,42,2757,2616,16,6,13,1,8
17268,29587,1053,28534,26407,687,55,207,4,118
17271,552,10,542,528,1,0,2,0,0
17301,4280,255,4025,3850,22,10,21,9,6
17302,3205,46,3159,2979,18,9,24,1,11
17303,420,97,323,309,5,0,2,0,0
17304,3097,586,2511,2371,26,10,8,0,8
17306,565,203,362,332,7,1,0,0,1
17307,5368,669,4699,4435,54,12,25,3,21
17309,2065,16,2049,1979,4,0,7,2,7
17311,256,6,250,224,8,2,4,0,4
17313,10755,597,10158,9119,491,28,101,1,39
17314,5973,132,5841,5464,56,14,15,0,20
17315,26317,1372,24945,22950,846,24,167,5,59
17316,8357,296,8061,7713,40,11,33,5,23
17317,528,22,506,480,11,1,1,0,2
17318,507,77,430,375,24,0,5,0,0
17319,10950,421,10529,9772,176,15,94,0,39
17320,8004,146,7858,7438,40,12,33,8,36
17321,2306,46,2260,2160,22,3,7,0,2
17322,5978,109,5869,5551,49,2,19,0,10
17323,88,1,87,79,0,0,1,0,2
17324,4232,306,3926,3729,27,7,23,0,16
17325,27879,2190,25689,23245,803,48,519,5,90
17327,7753,234,7519,7035,101,18,48,1,20
17329,2665,56,2609,2472,14,5,10,0,3
17331,55458,3337,52121,48077,1240,97,604,17,156
17339,6704,248,6456,6122,70,3,61,0,22
17340,11238,299,10939,10293,124,14,60,4,47
17342,309,20,289,254,16,0,10,0,0
17343,209,9,200,191,0,0,6,0,0
17344,3676,321,3355,3130,55,2,31,1,14
17345,8122,506,7616,6786,337,5,86,6,31
17347,6578,323,6255,5778,213,11,53,3,13
17349,8084,190,7894,7317,156,22,91,2,35
17350,13391,1505,11886,11365,111,10,84,2,27
17352,1205,26,1179,1101,6,0,8,0,9
17353,3196,124,3072,2922,28,4,12,0,9
17355,249,8,241,226,0,0,3,1,0
17356,23176,921,22255,20064,988,17,253,5,68
17360,6398,211,6187,5507,378,1,101,1,21
17361,5961,219,5742,5118,311,5,111,2,13
17362,13935,481,13454,12657,252,23,80,3,42
17363,9122,151,8971,8362,150,5,63,1,31
17364,4075,214,3861,3634,34,6,17,8,21
17365,2712,49,2663,2557,9,2,9,0,8
17366,5648,274,5374,4868,189,19,34,0,10
17368,7432,272,7160,6773,78,14,36,0,18
17370,6457,303,6154,5644,127,11,42,1,28
17371,262,5,257,239,3,1,0,0,0
17372,4072,526,3546,3361,21,5,32,1,13
17401,18771,7486,11285,5340,4817,37,109,9,163
17402,36978,3295,33683,28262,2615,62,1409,8,172
17403,40344,8208,32136,24325,5128,72,775,14,193
17404,37745,5816,31929,25133,3848,43,890,4,201
17406,23700,1570,22130,19328,1332,24,436,5,113
17407,2277,92,2185,1975,86,0,16,0,7
17408,24187,1312,22875,20121,1355,22,443,4,87
17501,4637,328,4309,3979,102,10,62,0,10
17502,2704,101,2603,2485,28,8,2,0,4
17504,148,40,108,83,3,0,9,0,2
17505,2018,80,1938,1859,25,3,13,0,7
17506,250,11,239,217,13,0,7,0,0
17507,78,12,66,55,0,0,7,0,0
17508,1020,56,964,892,7,0,30,1,3
17509,5066,153,4913,4708,48,1,8,0,31
17512,18267,2756,15511,13819,790,23,190,0,87
17516,4512,144,4368,4195,15,11,26,0,12
17517,16092,626,15466,14605,134,10,317,3,23
17518,1325,22,1303,1283,3,1,2,0,2
17519,7134,206,6928,6649,59,17,80,3,17
17520,4863,516,4347,3901,188,3,71,0,30
17522,33848,2128,31720,29506,493,51,636,8,90
17527,6550,283,6267,5968,92,4,33,1,22
17529,4472,132,4340,4223,16,0,43,2,4
17532,3429,97,3332,3195,10,10,9,0,13
17534,116,7,109,107,1,0,0,1,0
17535,2871,165,2706,2550,63,2,17,1,5
17536,2841,66,2775,2684,12,10,11,0,3
17538,7064,520,6544,5965,127,2,210,0,9
17540,10821,964,9857,8936,242,9,387,1,28
17543,45320,2225,43095,39927,682,17,1148,13,194
17545,22718,989,21729,20514,256,19,318,10,45
17547,8166,498,7668,7057,237,3,62,1,35
17550,765,68,697,614,32,0,3,1,2
17551,11056,814,10242,9007,562,6,279,0,43
17552,20393,1421,18972,17718,425,12,234,2,45
17554,8042,1043,6999,5961,407,16,292,4,31
17555,7464,145,7319,7113,35,3,37,4,20
17557,14761,946,13815,12954,224,12,259,4,49
17560,5253,150,5103,4901,36,11,7,1,7
17562,4655,206,4449,4279,65,0,11,0,2
17563,4016,157,3859,3699,33,4,8,0,14
17565,2646,98,2548,2430,13,5,8,0,4
17566,12724,501,12223,11769,100,10,41,1,28
17568,132,5,127,122,0,0,0,0,0
17569,6198,253,5945,5658,56,8,82,3,16
17570,263,9,254,244,1,0,3,0,1
17572,3972,186,3786,3646,31,5,37,0,3
17576,145,5,140,131,1,0,8,0,0
17578,6896,166,6730,6496,36,2,52,1,22
17579,6662,255,6407,6098,65,2,64,0,21
17581,233,10,223,221,0,0,0,0,0
17582,1948,105,1843,1805,10,0,8,0,1
17584,10409,625,9784,9203,170,8,103,0,45
17601,55710,5737,49973,42368,2209,28,3442,12,217
17602,52665,15676,36989,28267,4803,72,1994,14,222
17603,66739,18010,48729,37038,6090,83,2852,10,358
17606,1183,16,1167,1152,6,2,5,0,0
17701,43197,1417,41780,33546,4850,76,554,14,214
17702,10378,123,10255,9581,154,8,59,0,26
17720,251,1,250,245,0,0,1,0,0
17721,1777,31,1746,1670,16,0,4,2,6
17723,40,0,40,39,0,0,0,0,0
17724,4711,57,4654,4461,22,12,12,0,9
17727,37,2,35,34,0,1,0,0,0
17728,4935,78,4857,4590,33,14,28,0,20
17729,122,2,120,114,0,1,0,0,1
17730,198,1,197,184,6,0,1,0,0
17731,239,3,236,233,0,0,0,0,0
17737,6292,70,6222,5939,19,7,30,3,10
17739,39,0,39,38,0,0,0,0,0
17740,12371,100,12271,11783,53,4,57,4,15
17742,45,2,43,42,0,0,0,0,0
17744,2891,62,2829,2678,23,4,10,0,4
17745,17096,376,16720,15606,318,31,149,4,31
17747,3219,48,3171,3087,5,3,8,0,10
17748,377,1,376,362,4,0,6,0,0
17749,291,1,290,282,1,0,0,0,0
17750,119,0,119,119,0,0,0,0,0
17751,7189,123,7066,6788,39,10,24,0,11
17752,4885,74,4811,4554,25,11,28,0,13
17754,12458,172,12286,11593,80,23,112,6,36
17756,12458,237,12221,11340,422,26,42,0,24
17758,950,13,937,901,1,2,0,0,10
17760,616,2,614,597,0,1,2,0,3
17762,459,12,447,419,1,1,2,0,0
17763,296,4,292,283,0,0,0,0,0
17764,2097,30,2067,1978,20,3,1,0,5
17765,1134,8,1126,1094,0,2,2,0,3
17768,305,3,302,290,0,0,0,0,2
17769,35,1,34,32,1,0,0,0,0
17771,3041,31,3010,2885,14,9,1,0,12
17772,2433,31,2402,2341,13,2,5,0,1
17774,1060,1,1059,1010,2,0,5,0,1
17776,227,0,227,215,2,1,0,0,1
17777,6769,81,6688,6429,39,8,36,0,12
17778,94,1,93,92,0,0,0,0,0
17779,174,3,171,161,3,0,2,1,0
17801,16332,1299,15033,14004,355,10,47,6,32
17810,5270,611,4659,2963,1570,38,43,0,4
17812,1553,17,1536,1499,6,2,4,2,5
17813,2046,28,2018,1963,7,0,3,1,4
17814,4673,120,4553,4319,73,11,13,0,11
17815,28936,998,27938,25820,542,26,599,7,72
17820,5459,81,5378,5192,15,6,10,0,2
17821,18663,545,18118,16510,344,26,704,0,28
17822,27,0,27,20,0,0,4,0,0
17823,1225,6,1219,1194,3,2,3,0,1
17824,3997,68,3929,3796,17,2,31,0,4
17827,718,18,700,664,9,0,2,0,3
17829,193,3,190,185,0,0,0,0,0
17830,2017,11,2006,1943,5,2,7,0,5
17832,581,9,572,558,1,0,0,0,1
17834,3411,59,3352,3215,10,2,25,1,3
17835,69,1,68,68,0,0,0,0,0
17836,184,0,184,178,0,1,0,1,1
17837,18734,1037,17697,15534,720,30,709,5,50
17840,295,1,294,283,0,0,3,0,2
17841,4497,43,4454,4339,13,4,7,0,6
17842,8631,103,8528,8225,46,5,9,0,8
17844,9996,129,9867,9458,103,12,28,1,35
17845,2207,37,2170,2116,11,2,2,0,5
17846,3693,52,3641,3536,10,2,10,0,13
17847,11703,637,11066,10320,231,29,67,9,37
17850,595,17,578,542,6,6,2,0,1
17851,7256,316,6940,6513,119,11,49,0,13
17853,3073,38,3035,2998,2,0,5,0,2
17855,924,8,916,881,4,1,3,0,5
17856,3473,79,3394,3244,38,3,10,0,4
17857,7743,401,7342,6982,89,11,25,5,30
17858,76,0,76,76,0,0,0,0,0
17859,2993,48,2945,2818,12,7,19,0,5
17860,2172,30,2142,2090,7,0,8,0,1
17861,216,1,215,215,0,0,0,0,0
17862,423,10,413,391,6,0,5,2,0
17864,2476,22,2454,2398,9,0,3,1,8
17865,57,0,57,57,0,0,0,0,0
17866,10105,550,9555,8103,1173,11,24,0,15
17867,181,3,178,169,0,0,2,0,0
17868,774,21,753,704,11,3,15,0,1
17870,14730,627,14103,13121,364,22,218,4,14
17872,9223,502,8721,7994,279,10,44,0,29
17876,1688,63,1625,1515,32,0,29,0,5
17878,1569,13,1556,1520,1,4,7,0,1
17880,71,0,71,70,0,0,0,0,0
17881,1477,34,1443,1376,3,1,11,2,0
17884,208,1,207,195,1,0,0,0,0
17885,221,2,219,214,0,0,0,0,0
17886,777,71,706,654,9,0,13,0,5
17887,305,0,305,290,3,1,0,0,1
17888,297,3,294,287,0,0,0,0,0
17889,2979,63,2916,2783,15,1,17,2,7
17901,22608,1126,21482,19959,605,26,130,7,52
17920,279,0,279,274,0,0,0,0,0
17921,7038,334,6704,5806,745,7,25,0,7
17922,4814,133,4681,4516,23,8,13,0,10
17923,364,1,363,358,0,0,0,0,1
17925,377,13,364,354,2,1,0,0,5
17929,1611,79,1532,1455,12,1,17,0,0
17930,405,13,392,389,0,0,0,0,0
17931,8796,717,8079,5963,1923,3,66,0,8
17933,140,9,131,112,2,0,1,0,0
17934,327,21,306,293,5,0,0,0,0
17935,1528,48,1480,1412,18,0,0,0,2
17936,768,9,759,745,1,0,0,0,0
17938,2379,22,2357,2312,2,0,8,0,14
17941,766,7,759,741,4,0,2,1,0
17943,158,3,155,152,0,0,0,0,0
17944,172,7,165,154,0,0,0,0,0
17945,171,8,163,161,0,1,0,0,0
17946,292,24,268,250,0,1,2,0,0
17948,4258,611,3647,3442,69,7,16,0,10
17949,230,11,219,213,0,2,0,0,0
17951,299,5,294,282,0,0,0,0,1
17952,245,1,244,240,0,0,0,0,0
17953,435,10,425,417,0,4,0,0,1
17954,4606,282,4324,4019,101,5,33,0,7
17957,362,2,360,358,0,0,0,0,0
17959,1341,53,1288,1211,21,4,0,0,5
17960,3902,95,3807,3673,17,5,22,0,7
17961,6659,155,6504,6171,50,17,92,0,13
17963,9013,153,8860,8609,14,20,21,0,23
17964,769,19,750,741,2,0,1,0,0
17965,1990,62,1928,1841,14,6,10,0,11
17967,2364,59,2305,2248,3,2,2,0,2
17968,370,3,367,363,3,0,0,0,0
17970,2949,97,2852,2699,31,0,22,0,3
17972,11994,316,11678,11132,89,15,112,3,20
17974,314,10,304,296,0,0,1,0,0
17976,5933,1541,4392,4112,111,2,16,0,23
17978,502,4,498,496,0,0,0,0,0
17979,93,1,92,85,0,0,0,0,0
17980,3246,87,3159,3077,8,0,10,0,5
17981,2652,34,2618,2503,19,2,1,0,6
17982,375,6,369,365,3,1,0,0,0
17983,1521,19,1502,1462,3,0,7,0,9
17985,1299,42,1257,1204,8,0,5,0,1
18011,5859,515,5344,4791,154,2,167,1,14
18012,41,1,40,39,1,0,0,0,0
18013,17436,1121,16315,15288,228,21,122,0,40
18014,11560,789,10771,10065,228,7,59,2,37
18015,33286,10686,22600,17200,2393,20,1533,12,480
18017,39663,8178,31485,26146,2370,29,1504,13,212
18018,32388,7612,24776,20677,1991,21,689,12,166
18020,20582,2492,18090,15047,1193,26,1014,5,122
18030,487,14,473,446,1,1,10,0,5
18031,11369,1369,10000,7017,567,8,1895,1,47
18032,9489,1657,7832,7065,350,1,59,4,28
18034,9271,625,8646,7310,482,9,532,1,51
18035,195,4,191,179,1,0,7,0,0
18036,14084,580,13504,12458,184,13,340,8,55
18037,7444,673,6771,6191,210,4,129,2,31
18038,3180,89,3091,2960,10,2,9,1,5
18040,16980,1746,15234,12102,1394,18,1011,4,78
18041,5632,251,5381,5033,64,5,50,0,9
18042,44026,9386,34640,25385,5777,59,1080,13,248
18045,30317,3288,27029,22055,1956,16,1928,5,107
18046,66,10,56,41,4,0,4,0,2
18049,18440,1507,16933,15555,415,19,342,3,56
18051,3343,139,3204,2986,46,5,86,1,6
18052,29317,5675,23642,19049,2252,25,1321,9,123
18053,2347,63,2284,2211,15,0,8,0,4
18054,4615,101,4514,4232,43,5,29,0,23
18055,12077,776,11301,10409,132,6,281,3,43
18056,951,49,902,872,6,1,0,0,0
18058,9655,704,8951,8303,244,12,33,1,32
18059,1158,88,1070,1011,19,0,20,0,2
18062,25802,1946,23856,20419,1088,13,1487,0,110
18063,552,25,527,504,2,0,2,0,1
18064,27696,1650,26046,23903,426,19,783,5,84
18065,189,8,181,174,0,0,2,0,1
18066,5834,227,5607,5378,22,12,24,1,26
18067,19800,1503,18297,16978,492,2,219,3,77
18069,7863,558,7305,6310,189,3,515,6,45
18070,875,23,852,816,4,1,3,0,7
18071,10688,515,10173,9802,33,6,38,3,29
18072,6734,311,6423,6028,89,10,47,0,12
18073,11028,530,10498,9377,341,9,371,2,31
18074,5534,178,5356,5040,65,5,42,1,25
18076,2868,120,2748,2584,47,2,13,0,8
18077,2403,85,2318,2191,7,3,27,0,8
18078,6996,387,6609,6173,65,5,113,1,32
18079,415,31,384,353,6,0,4,0,1
18080,11454,807,10647,10063,124,4,56,2,18
18081,316,1,315,298,0,0,2,0,0
18083,679,40,639,596,13,0,9,1,1
18085,1042,68,974,888,24,1,20,0,3
18086,224,12,212,201,8,0,1,0,0
18087,747,94,653,532,39,0,56,3,2
18088,8603,349,8254,7858,77,2,26,1,27
18091,5767,259,5508,5154,91,8,47,0,5
18092,3297,149,3148,2973,11,2,35,0,12
18101,5108,2711,2397,1363,807,10,67,0,21
18102,51567,34296,17271,9254,5927,84,547,14,320
18103,48358,18918,29440,23075,3480,44,1308,7,285
18104,47289,7950,39339,31395,2953,30,3338,11,260
18106,7477,698,6779,5855,317,9,374,2,12
18109,18915,9266,9649,7093,1608,19,327,5,117
18195,0,0,0,0,0,0,0,0,0
18201,31310,19204,12106,10877,512,21,210,8,171
18202,13894,5101,8793,8161,224,1,136,2,63
18210,8787,1020,7767,6510,697,19,114,4,57
18211,1283,14,1269,1242,2,0,3,0,4
18212,42,2,40,38,0,0,0,0,0
18214,2097,25,2072,2023,2,0,4,0,0
18216,1270,204,1066,1029,7,0,1,0,0
18218,2426,159,2267,2129,18,5,7,0,6
18219,1331,79,1252,1194,14,0,5,0,4
18220,351,6,345,337,4,0,0,0,0
18221,314,38,276,259,2,0,3,0,0
18222,9114,548,8566,8132,109,7,117,1,13
18223,74,14,60,59,0,0,0,0,0
18224,6377,1131,5246,4939,80,5,27,0,8
18225,113,63,50,47,0,0,1,0,0
18229,8322,380,7942,7546,91,5,49,7,27
18230,112,14,98,87,2,0,1,0,0
18231,497,48,449,440,0,0,1,0,2
18232,4222,451,3771,3350,170,21,16,1,6
18234,411,56,355,338,3,0,4,0,1
18235,19139,760,18379,17517,150,22,95,0,66
18237,3463,760,2703,2515,40,0,34,0,11
18239,137,54,83,75,1,0,3,2,0
18240,3838,176,3662,3474,72,5,15,0,10
18241,439,6,433,425,2,0,3,0,0
18242,248,4,244,242,0,0,1,0,0
18244,316,8,308,294,0,0,0,0,0
18245,364,17,347,339,5,0,0,0,0
18246,154,1,153,149,0,0,3,0,1
18248,509,73,436,410,11,1,0,0,2
18249,4151,166,3985,3812,23,2,59,0,0
18250,3046,135,2911,2759,26,5,10,0,23
18252,11016,674,10342,9819,119,9,56,2,16
18254,832,108,724,697,1,0,0,0,0
18255,4337,140,4197,4014,19,8,14,0,11
18256,241,11,230,223,1,0,2,1,0
18301,29184,6393,22791,15123,5313,42,910,10,267
18302,17685,3708,13977,9562,3012,35,483,10,179
18321,1866,286,1580,1251,169,3,57,0,18
18322,2511,235,2276,2026,106,5,48,0,13
18323,349,31,318,303,2,0,2,0,0
18324,9739,2386,7353,4662,1940,17,236,2,89
18325,2284,174,2110,1934,76,2,26,0,10
18326,4291,363,3928,3390,249,12,78,1,24
18327,641,70,571,475,45,0,26,0,1
18328,8080,808,7272,6597,203,16,70,4,25
18330,8351,1126,7225,6078,648,5,102,1,49
18331,562,65,497,446,20,1,9,0,0
18332,2843,496,2347,1861,290,3,33,2,28
18333,212,25,187,173,4,0,3,0,2
18334,4312,920,3392,2148,859,11,131,1,59
18335,1241,214,1027,450,462,1,52,2,17
18336,3707,314,3393,3075,44,10,82,1,9
18337,15519,1504,14015,12734,371,36,241,3,58
18340,157,14,143,133,3,0,3,0,0
18342,490,37,453,400,23,0,6,0,4
18343,3819,239,3580,3203,157,5,71,1,14
18344,3497,793,2704,1814,623,11,107,0,21
18346,2711,596,2115,1468,459,4,76,0,25
18347,3283,296,2987,2721,109,3,28,0,28
18349,139,26,113,90,7,0,0,0,1
18350,1837,175,1662,1483,69,3,46,0,10
18351,494,28,466,436,4,1,3,1,1
18353,11992,1086,10906,9734,529,16,154,0,72
18354,1103,118,985,864,61,2,8,0,4
18355,1514,227,1287,1017,154,5,34,1,8
18356,179,25,154,114,17,5,8,0,0
18357,120,11,109,91,7,1,1,0,0
18360,29079,3957,25122,19802,2946,44,917,9,219
18370,829,89,740,560,107,0,38,1,7
18371,894,203,691,397,199,4,43,1,2
18372,2673,360,2313,1805,252,3,101,2,24
18403,7369,228,7141,6761,65,13,86,0,12
18405,2353,74,2279,2179,6,2,19,0,6
18407,14047,812,13235,12398,192,29,65,1,67
18411,22851,618,22233,20284,231,14,1000,0,74
18413,25,2,23,22,0,0,0,0,0
18414,5194,153,5041,4783,22,2,60,0,16
18415,1247,40,1207,1129,8,1,7,0,11
18417,1041,32,1009,962,4,2,9,0,3
18419,4556,148,4408,4104,111,4,29,0,7
18420,169,3,166,158,0,0,0,0,0
18421,4573,153,4420,4185,21,3,33,0,9
18424,5598,336,5262,4832,113,7,32,4,35
18425,1263,75,1188,1122,9,1,10,0,2
18426,3883,264,3619,3366,54,12,28,1,15
18428,12314,947,11367,10621,226,16,131,1,26
18430,70,0,70,64,1,0,1,0,0
18431,12602,409,12193,11496,73,12,109,0,28
18433,6416,172,6244,5966,54,2,21,0,14
18434,4093,176,3917,3705,42,12,26,0,13
18435,1055,91,964,873,17,2,15,0,7
18436,13576,610,12966,12234,143,15,85,0,43
18437,168,1,167,162,1,1,0,0,0
18438,1186,66,1120,1069,5,2,6,0,1
18439,474,16,458,445,3,1,4,0,0
18440,56,3,53,48,1,0,3,0,0
18441,316,3,313,299,1,0,8,0,0
18443,494,12,482,462,2,0,3,0,0
18444,13540,374,13166,12508,118,5,74,0,32
18445,2260,127,2133,1966,35,4,31,0,8
18446,3451,67,3384,3191,5,4,13,0,4
18447,10362,484,9878,9220,162,4,94,1,22
18451,388,6,382,380,1,0,0,0,0
18452,4950,180,4770,4488,71,4,56,0,10
18453,1182,18,1164,1087,7,5,9,0,6
18454,89,0,89,84,0,0,2,0,0
18455,134,6,128,122,1,0,1,0,0
18456,337,4,333,311,7,0,2,0,3
18457,96,1,95,88,3,0,0,0,0
18458,3092,236,2856,2679,33,7,10,0,8
18460,184,10,174,160,0,1,6,0,2
18461,313,8,305,293,0,0,0,0,0
18462,443,9,434,411,0,1,1,0,0
18463,144,4,140,125,7,0,1,0,1
18464,1368,64,1304,1253,19,0,9,1,0
18465,1385,38,1347,1266,6,5,0,0,3
18466,17000,4832,12168,5821,5052,36,282,11,220
18469,405,7,398,386,6,0,0,0,0
18470,2057,33,2024,1932,4,11,13,0,2
18471,722,18,704,648,1,0,28,0,0
18472,7071,526,6545,5053,1234,29,60,0,24
18473,381,15,366,341,1,3,3,0,1
18503,1792,105,1687,1277,267,12,77,1,5
18504,21267,3257,18010,15567,1282,15,262,6,73
18505,20982,4417,16565,12671,1458,31,1546,1,129
18507,4968,292,4676,4352,78,3,96,0,17
18508,11664,1864,9800,8085,787,18,361,4,50
18509,13720,1452,12268,10526,959,27,310,4,53
18510,14110,1556,12554,8780,966,59,2017,8,148
18512,12081,506,11575,10738,184,7,235,0,46
18517,5253,562,4691,4278,138,0,69,0,8
18518,8497,500,7997,7513,154,6,123,0,15
18519,5000,217,4783,4427,121,1,77,0,4
18602,291,21,270,262,0,0,2,0,3
18603,18728,1007,17721,16633,293,14,111,2,51
18610,4810,757,4053,3129,620,14,85,0,44
18612,18210,657,17553,15564,1270,12,264,2,17
18614,2110,19,2091,1979,5,3,11,0,7
18615,1716,34,1682,1577,7,2,3,2,3
18616,726,9,717,682,1,3,4,0,1
18617,1644,83,1561,1445,28,3,5,0,5
18618,3732,43,3689,3543,8,0,6,1,5
18619,180,7,173,159,0,0,0,0,3
18621,5014,120,4894,4541,141,2,19,2,9
18622,247,5,242,233,0,0,0,0,0
18623,2540,52,2488,2387,6,4,8,1,12
18624,549,28,521,484,7,0,11,0,0
18625,222,1,221,207,1,1,1,0,0
18626,556,7,549,526,2,0,0,0,4
18627,9,1,8,6,0,0,0,0,0
18628,243,5,238,228,4,0,0,0,2
18629,1666,23,1643,1574,7,6,0,0,6
18630,3013,176,2837,2702,12,0,10,0,8
18631,1122,27,1095,1065,3,1,2,7,2
18632,346,0,346,334,0,2,0,0,0
18634,13702,861,12841,11765,543,16,53,1,25
18635,3773,69,3704,3516,16,3,19,5,11
18636,1409,19,1390,1335,3,1,0,0,4
18640,16351,819,15532,14469,430,13,142,2,42
18641,6608,310,6298,5957,81,1,86,0,11
18642,4547,158,4389,4161,51,3,60,0,9
18643,12165,351,11814,11141,226,14,62,4,33
18644,7336,173,7163,6818,90,12,49,2,6
18651,8723,556,8167,7192,524,9,36,1,43
18655,5881,115,5766,5476,24,5,19,4,13
18656,2106,14,2092,2013,4,4,6,0,2
18657,10793,176,10617,10069,68,7,66,1,12
18660,3578,54,3524,3404,10,4,4,2,4
18661,5611,238,5373,5102,61,13,31,1,9
18701,4658,604,4054,3298,445,9,145,1,27
18702,42133,9413,32720,24744,5298,56,889,9,176
18704,31138,1801,29337,25887,1778,44,476,9,130
18705,14832,1805,13027,11358,942,18,198,0,52
18706,16338,1422,14916,13274,885,19,117,4,32
18707,16042,518,15524,14291,128,5,622,1,41
18708,8988,117,8871,8486,30,3,112,0,20
18709,2779,85,2694,2523,48,3,13,2,6
18801,7829,170,7659,7303,43,13,17,0,30
18810,6075,98,5977,5579,62,19,74,5,12
18812,1333,12,1321,1257,2,2,8,0,4
18814,147,2,145,140,0,0,0,0,0
18816,100,3,97,97,0,0,0,0,0
18817,115,0,115,107,0,0,0,0,0
18818,1181,11,1170,1127,0,0,2,0,7
18820,40,3,37,37,0,0,0,0,0
18821,1031,27,1004,949,4,0,1,0,3
18822,3200,79,3121,2985,14,12,7,0,3
18823,154,1,153,146,0,0,2,0,0
18824,1146,16,1130,1077,5,0,2,0,3
18825,169,3,166,158,0,1,0,0,1
18826,1594,28,1566,1489,5,2,2,0,5
18828,210,12,198,193,0,1,2,0,2
18829,786,37,749,718,1,0,4,0,4
18830,702,4,698,674,0,0,3,0,0
18831,1207,16,1191,1113,10,0,1,0,7
18832,1618,7,1611,1562,1,1,4,0,0
18833,1879,12,1867,1784,7,2,5,0,4
18834,3349,50,3299,3152,12,3,14,0,5
18837,2940,28,2912,2765,5,2,8,0,15
18840,10505,150,10355,9452,150,27,229,4,31
18842,191,2,189,172,0,2,2,0,1
18843,273,6,267,258,3,0,3,0,0
18844,1443,30,1413,1355,4,2,3,0,7
18845,386,21,365,350,0,0,0,0,0
18846,717,6,711,693,4,0,2,0,0
18847,5139,115,5024,4751,25,5,20,0,9
18848,8672,165,8507,8007,53,28,51,0,15
18850,2399,32,2367,2230,15,0,12,0,9
18851,689,18,671,647,3,0,3,0,2
18853,4086,70,4016,3801,17,7,19,1,11
18854,1299,15,1284,1215,7,5,1,0,1
18901,28395,1182,27213,25043,610,17,644,3,96
18902,22236,1164,21072,19148,243,7,823,3,94
18912,314,17,297,274,15,0,0,0,2
18913,290,13,277,243,3,0,8,0,6
18914,21475,687,20788,17676,363,10,2054,5,93
18915,1668,105,1563,909,71,2,491,1,2
18917,2227,289,1938,1753,42,0,54,0,21
18920,480,6,474,453,3,1,2,0,0
18921,264,4,260,253,2,0,1,2,0
18923,1198,29,1169,1046,13,0,61,0,2
18925,6679,208,6471,5485,103,0,638,0,20
18927,167,2,165,150,5,0,2,0,0
18929,8819,256,8563,7655,82,4,584,0,13
18930,2350,61,2289,2158,12,2,14,0,12
18932,524,26,498,432,8,1,30,0,1
18933,198,5,193,179,4,0,1,0,1
18935,254,3,251,244,5,0,2,0,0
18936,253,20,233,143,24,1,42,0,0
18938,14301,602,13699,12474,128,4,578,1,56
18940,30280,891,29389,25152,330,10,2866,3,102
18942,3118,82,3036,2901,21,1,15,0,6
18944,26396,954,25442,23710,345,29,454,9,65
18946,543,20,523,475,4,1,29,0,1
18947,6089,311,5778,5357,61,5,142,0,30
18950,89,3,86,75,4,2,2,0,0
18951,36111,1944,34167,31134,749,37,792,23,158
18954,9574,288,9286,8490,56,3,459,0,24
18955,1664,73,1591,1486,31,0,15,0,8
18960,13561,546,13015,12046,269,15,194,6,36
18962,323,13,310,307,0,0,3,0,0
18964,14366,1296,13070,11079,399,18,1078,1,45
18966,38079,1051,37028,34393,329,20,1281,5,92
18969,15808,1150,14658,12851,492,30,669,2,58
18970,666,31,635,603,2,0,6,4,2
18972,3173,97,3076,2940,21,7,12,0,4
18974,42507,3323,39184,34931,1150,16,1656,11,122
18976,22395,1544,20851,17823,401,17,1917,3,94
18977,4354,119,4235,3831,24,0,197,0,32
18980,238,15,223,192,4,0,3,0,2
19001,17215,1099,16116,11746,2779,14,753,2,85
19002,33279,1634,31645,25444,2014,17,2914,1,124
19003,13984,729,13255,10007,1623,8,893,10,75
19004,10668,448,10220,8180,519,7,998,3,86
19006,23148,767,22381,18547,480,3,2564,1,101
19007,21849,2965,18884,13518,3401,28,855,2,73
19008,21008,483,20525,17508,448,14,2077,1,37
19009,1220,24,1196,1080,52,5,10,0,13
19010,21270,996,20274,15785,1208,12,2397,3,101
19012,6699,602,6097,2711,2361,5,726,0,50
19013,34252,4142,30110,4668,23910,57,233,7,144
19014,21642,625,21017,18357,1375,26,521,4,48
19015,16260,763,15497,10277,4071,18,389,1,74
19017,200,4,196,169,1,0,13,0,0
19018,23664,957,22707,14221,5822,32,1578,0,169
19020,57043,6352,50691,35934,4353,69,8173,17,317
19021,10001,1321,8680,7270,657,22,296,1,41
19022,3797,277,3520,2302,792,11,93,0,32
19023,22180,975,21205,3930,15860,55,391,0,140
19025,6033,136,5897,4794,276,2,655,0,10
19026,32021,1627,30394,20676,6613,45,1506,12,172
19027,19170,1092,18078,8765,7045,35,1220,5,219
19029,3979,167,3812,3324,126,1,129,2,13
19030,12504,820,11684,9756,622,8,728,0,77
19031,5326,164,5162,4623,238,1,151,2,11
19032,6792,366,6426,2754,3151,6,185,0,45
19033,7798,241,7557,6678,385,9,204,4,23
19034,6685,214,6471,5304,318,8,547,0,32
19035,4096,117,3979,3520,59,0,223,0,35
19036,13102,443,12659,9567,2273,18,268,8,27
19038,32490,1553,30937,23338,5036,27,1075,7,150
19040,22396,1297,21099,18990,669,20,538,2,66
19041,6526,323,6203,5190,260,4,469,0,23
19043,2737,71,2666,2335,170,2,47,4,11
19044,16273,1173,15100,12109,945,19,1353,1,57
19046,19669,859,18810,15748,1343,21,872,0,109
19047,35452,1532,33920,29328,1367,33,1923,10,123
19050,29176,1260,27916,5594,20122,63,910,0,209
19052,412,8,404,384,3,1,0,0,1
19053,28179,1259,26920,22759,1154,33,1822,4,112
19054,17659,1184,16475,14463,793,13,480,4,60
19055,13783,1313,12470,10732,695,20,243,7,85
19056,15858,1262,14596,12092,1060,18,677,5,64
19057,16916,1669,15247,12491,1618,11,373,3,69
19060,11646,357,11289,9280,227,18,1339,4,23
19061,20207,967,19240,14445,3235,37,596,1,92
19063,38338,1178,37160,31965,1786,33,1858,14,199
19064,25045,561,24484,21811,627,8,1336,6,70
19066,6107,360,5747,4668,317,6,429,0,64
19067,53153,3372,49781,40202,3826,47,3356,11,224
19070,7306,226,7080,5492,824,4,450,0,32
19072,10008,325,9683,8318,295,4,638,1,53
19073,20853,488,20365,18198,333,6,1209,1,53
19074,5943,192,5751,4901,382,1,186,4,31
19075,7698,325,7373,6313,568,5,216,0,27
19076,6488,328,6160,5133,500,4,254,3,18
19078,11453,312,11141,10026,472,4,253,0,28
19079,9371,320,9051,1215,7243,31,155,4,74
19081,10803,501,10302,8452,465,13,815,2,44
19082,42761,4675,38086,7248,19888,64,9204,13,359
19083,36964,1025,35939,31500,1265,21,1795,6,101
19085,11313,295,11018,9209,447,14,1051,10,16
19086,12270,415,11855,9699,586,7,946,4,39
19087,33501,1256,32245,25402,996,22,4589,6,117
19090,20180,1388,18792,13005,3549,9,1260,6,107
19094,4426,236,4190,3155,701,3,81,4,16
19095,7880,401,7479,3169,3264,14,670,0,34
19096,15390,574,14816,11126,893,5,1959,1,128
19102,7568,483,7085,5215,488,6,1029,9,43
19103,28717,1599,27118,20901,1306,25,3723,3,193
19104,56839,3640,53199,19531,19649,85,11320,29,372
19106,15190,929,14261,11544,1115,18,1061,2,56
19107,17600,1075,16525,9271,1677,27,4726,2,121
19108,39,1,38,15,5,0,13,0,0
19109,26,11,15,12,0,0,0,0,0
19111,67017,12600,54417,26743,16369,71,7919,27,914
19112,3,1,2,1,1,0,0,0,0
19113,4,0,4,0,0,0,1,0,0
19114,32645,3022,29623,22629,3941,48,1743,6,193
19115,35919,2395,33524,22123,3056,38,6821,1,216
19116,35610,1924,33686,23419,1905,43,6590,9,158
19118,9728,489,9239,6889,1566,13,366,2,76
19119,27265,1165,26100,9152,14797,48,489,10,183
19120,66177,21498,44679,3368,31564,96,7797,8,418
19121,41799,2509,39290,9187,26146,90,2041,76,274
19122,26668,5566,21102,9895,7858,57,2264,94,165
19123,18793,1722,17071,9507,4795,29,1837,4,95
19124,68766,29001,39765,9503,24426,158,3413,17,411
19125,25325,2704,22621,18677,1028,21,1712,11,136
19126,16159,910,15249,832,13308,36,545,2,86
19127,6929,386,6543,5558,359,15,305,0,43
19128,36808,1978,34830,27305,4250,35,1494,6,181
19129,11437,721,10716,6058,3593,9,527,12,40
19130,31477,2260,29217,21043,4185,32,2424,7,170
19131,42705,1535,41170,5224,32774,100,1529,11,187
19132,33926,1466,32460,909,30090,76,297,14,128
19133,24772,14510,10262,814,8621,22,280,13,85
19134,57463,26703,30760,18660,9092,66,1183,10,250
19135,35422,10377,25045,13231,8888,73,1259,11,290
19136,39151,7123,32028,19549,8744,50,1928,11,382
19137,8682,892,7790,7030,331,16,73,2,51
19138,31816,938,30878,517,28993,111,144,4,168
19139,43281,1615,41666,3522,34994,103,1272,13,241
19140,52124,21674,30450,1336,27064,87,647,9,248
19141,31047,1922,29125,1302,25643,63,1154,11,170
19142,29565,1442,28123,1462,22894,42,2773,5,105
19143,64648,2618,62030,8731,48863,174,1457,27,417
19144,44481,2208,42273,7335,31832,97,884,32,332
19145,47079,3180,43899,22305,12545,65,7377,7,202
19146,41920,2816,39104,21380,12563,78,2984,3,229
19147,41096,3969,37127,27180,3358,38,4549,4,293
19148,53976,8589,45387,29658,2793,27,11225,12,231
19149,60408,16771,43637,14662,13184,92,11677,15,1558
19150,23126,570,22556,382,21212,59,107,2,163
19151,30394,979,29415,2387,25570,49,370,5,165
19152,35911,4236,31675,18184,4381,38,6555,9,781
19153,11985,410,11575,1104,9325,23,797,1,59
19154,34681,3170,31511,25780,2821,47,1737,11,140
19301,7542,242,7300,5428,303,8,1160,0,130
19310,2898,251,2647,2417,129,0,6,0,17
19311,9556,2447,7109,6174,278,6,336,0,37
19312,11848,360,11488,9332,218,8,1472,0,53
19316,166,10,156,136,4,1,0,1,1
19317,10714,343,10371,8434,204,4,1375,2,56
19319,824,147,677,465,154,0,36,1,8
19320,54149,6350,47799,33390,10732,64,978,17,238
19330,5705,589,5116,4842,70,6,38,1,19
19333,7734,265,7469,5526,183,0,1535,0,15
19335,52406,2455,49951,41070,2430,65,4252,0,201
19341,18808,754,18054,13302,624,26,3443,3,63
19342,20550,533,20017,16353,1206,15,1743,4,65
19343,8711,296,8415,7739,125,5,236,1,33
19344,12869,613,12256,11410,207,27,113,0,39
19345,788,48,740,670,48,0,8,0,0
19348,22606,5078,17528,15493,575,7,686,2,59
19350,11030,899,10131,9195,184,6,271,0,36
19352,10495,752,9743,7970,1140,3,225,0,76
19355,29273,1686,27587,21283,626,32,4606,3,130
19358,318,78,240,181,47,0,0,0,1
19362,5888,677,5211,4899,87,8,21,1,13
19363,18104,3393,14711,13162,678,33,103,3,65
19365,7410,546,6864,5813,605,22,45,1,42
19367,188,24,164,134,20,0,4,0,0
19369,252,23,229,190,24,0,7,0,0
19372,2348,174,2174,1696,279,4,98,2,7
19373,2648,50,2598,2364,37,6,86,0,12
19374,988,656,332,260,28,2,7,0,2
19375,212,27,185,171,0,0,5,0,0
19380,50692,2916,47776,41460,1913,34,2644,24,181
19382,52498,2974,49524,42153,2417,43,2979,18,177
19383,5053,305,4748,3627,795,5,93,0,10
19390,14101,3155,10946,9884,369,8,223,1,57
19401,43414,13105,30309,14546,12276,82,1346,14,302
19403,43734,2392,41342,32284,3224,39,4095,7,167
19405,5558,972,4586,3638,513,2,144,3,41
19406,28553,1806,26747,17188,2161,27,6135,5,142
19422,20117,758,19359,14687,1318,2,2695,7,56
19425,16352,490,15862,11016,243,10,4042,1,53
19426,43541,2005,41536,32484,3812,44,3604,10,166
19428,19690,886,18804,15789,1236,15,970,2,59
19435,224,3,221,214,2,0,0,0,0
19436,573,8,565,542,1,0,15,0,0
19437,955,36,919,761,61,3,63,0,1
19438,25134,827,24307,21138,810,14,1538,5,76
19440,19683,1468,18215,13148,946,41,3317,4,113
19442,61,0,61,43,4,0,7,0,0
19444,10806,308,10498,9405,356,4,412,0,40
19446,58930,2953,55977,41603,3499,62,8574,38,232
19453,1338,49,1289,1124,50,2,43,0,10
19454,28833,957,27876,19780,1664,16,5492,3,84
19456,302,10,292,243,8,0,20,0,0
19457,103,7,96,92,0,0,2,0,0
19460,43611,2920,40691,34538,1632,62,2220,6,311
19462,16267,699,15568,12481,1237,10,1238,1,59
19464,48409,3869,44540,33361,7225,51,839,15,236
19465,18217,715,17502,15900,450,13,316,12,57
19468,27869,975,26894,22755,1315,19,1614,3,96
19472,92,3,89,87,1,0,0,0,0
19473,16028,556,15472,13900,431,6,483,2,52
19474,682,13,669,606,30,0,19,0,1
19475,12028,709,11319,9865,576,16,303,1,42
19477,126,4,122,118,0,0,0,0,4
19490,316,9,307,268,5,0,21,0,4
19492,941,21,920,882,9,0,11,1,3
19501,906,27,879,813,9,1,13,1,1
19503,1270,58,1212,1085,62,0,3,0,1
19504,5343,93,5250,5103,12,4,26,1,11
19505,3397,107,3290,3153,13,0,20,0,15
19506,7443,436,7007,6650,71,15,49,1,15
19507,3434,118,3316,3171,16,5,34,0,19
19508,15855,815,15040,13980,287,12,134,1,36
19510,7717,663,7054,6481,226,9,100,0,27
19511,200,11,189,185,2,0,0,0,0
19512,16928,435,16493,15515,348,14,103,4,50
19516,140,7,133,128,0,0,0,0,0
19518,16441,635,15806,14095,629,22,384,1,47
19520,5932,218,5714,5415,48,6,34,17,26
19522,14098,678,13420,12776,122,16,111,0,22
19523,170,5,165,144,6,0,3,0,0
19525,16506,625,15881,14560,410,8,312,2,58
19526,11139,660,10479,9931,125,11,68,1,45
19529,2986,73,2913,2813,16,4,6,1,9
19530,14830,894,13936,12801,547,21,183,5,18
19533,7710,753,6957,6433,242,15,56,0,22
19534,2065,91,1974,1909,13,4,5,0,2
19535,96,2,94,88,0,0,0,0,0
19536,443,28,415,391,2,3,4,0,2
19538,124,2,122,116,0,0,2,0,0
19539,4488,167,4321,4137,28,6,27,1,2
19540,11861,719,11142,10422,161,9,139,0,47
19541,4200,208,3992,3858,17,3,9,0,15
19543,6256,169,6087,5672,75,4,74,2,38
19544,232,18,214,184,4,0,5,0,3
19545,225,7,218,210,1,0,0,1,1
19547,4429,142,4287,4123,19,6,20,0,9
19549,278,19,259,251,3,0,2,0,0
19550,581,45,536,485,20,1,4,0,2
19551,5075,349,4726,4416,101,6,29,1,16
19554,337,14,323,300,7,0,1,0,4
19555,3594,176,3418,3281,14,0,17,1,7
19559,423,36,387,368,5,0,2,0,0
19560,9290,2964,6326,5516,385,7,135,6,23
19562,2631,289,2342,2246,32,0,6,0,7
19564,171,3,168,154,0,1,1,0,0
19565,8995,701,8294,7640,305,7,100,6,24
19567,5710,454,5256,4919,135,4,43,4,21
19601,35477,25193,10284,5920,3179,42,251,4,226
19602,19782,13768,6014,3472,1794,28,138,5,97
19604,29347,21058,8289,5441,1938,24,219,6,136
19605,21356,5817,15539,13346,1011,24,460,3,123
19606,35153,5611,29542,26113,1584,39,570,5,84
19607,23431,3843,19588,17117,1247,30,467,2,76
19608,24378,2675,21703,18328,1381,14,1069,4,52
19609,10478,1767,8711,7704,408,15,226,0,41
19610,16024,1705,14319,12398,670,22,745,0,76
19611,11238,4949,6289,4773,866,5,177,0,56
19701,42717,3649,39068,20613,12245,92,3991,13,222
19702,55653,6478,49175,22662,16865,98,6979,3,304
19703,16175,1559,14616,7593,4756,49,1454,5,82
19706,1938,136,1802,1428,202,10,8,0,11
19707,17274,707,16567,12727,524,13,2618,5,63
19709,49599,3401,46198,29222,11602,51,2820,8,246
19710,108,1,107,101,2,0,3,0,0
19711,48477,3655,44822,34122,4641,41,3999,9,152
19713,31867,4621,27246,17340,5982,62,2078,11,153
19716,42,11,31,20,2,0,1,0,0
19717,6201,466,5735,3202,1981,0,189,0,0
19720,61043,10485,50558,21529,24632,128,1644,19,286
19730,472,34,438,378,36,0,0,0,5
19731,329,17,312,267,4,0,5,0,3
19732,223,1,222,187,6,0,8,0,0
19733,320,29,291,246,20,3,7,0,2
19734,14116,775,13341,9383,2857,32,235,7,56
19735,16,1,15,12,0,0,2,0,0
19736,34,1,33,28,0,0,4,0,0
19801,16219,1407,14812,2573,11079,32,403,4,83
19802,26189,1596,24593,4400,18791,52,233,7,134
19803,21886,909,20977,18066,1019,27,1015,7,67
19804,18292,4181,14111,10880,2206,20,222,4,81
19805,39985,11530,28455,13837,12568,61,456,13,163
19806,10083,540,9543,7601,1310,4,223,2,50
19807,8089,281,7808,6649,174,7,679,0,37
19808,39285,5095,34190,27507,2360,52,2650,3,124
19809,14658,870,13788,9337,2996,15,724,0,83
19810,25270,896,24374,18678,2392,32,2349,7,135
19901,36839,3777,33062,16858,12156,188,1282,43,201
19902,108,26,82,56,7,1,6,0,0
19904,36880,2515,34365,17952,12528,255,1092,21,244
19930,2657,64,2593,2464,12,1,29,1,17
19931,258,10,248,219,14,0,1,0,2
19933,9784,1843,7941,5566,1774,34,107,1,47
19934,14243,842,13401,9438,2271,71,533,6,107
19936,329,43,286,155,46,21,10,0,3
19938,10131,581,9550,7420,1452,26,88,7,29
19939,7357,508,6849,6109,397,22,51,6,26
19940,6541,273,6268,4950,825,10,114,2,40
19941,2857,456,2401,1476,724,10,22,5,12
19943,12523,751,11772,8854,1957,44,145,4,55
19944,519,7,512,481,6,0,10,0,1
19945,8041,1060,6981,5865,639,8,107,1,31
19946,4932,524,4408,3165,851,21,67,4,19
19947,20964,6880,14084,10661,2511,72,111,5,77
19950,7095,456,6639,5490,695,10,69,3,37
19951,1986,137,1849,1593,112,10,31,1,13
19952,10621,564,10057,7798,1500,33,80,0,50
19953,4500,235,4265,3727,205,29,28,2,23
19954,1629,97,1532,1225,194,3,8,0,9
19955,191,9,182,151,16,0,0,1,1
19956,16327,1727,14600,10894,2667,54,182,3,85
19958,27911,1483,26428,23838,950,76,507,8,124
19960,7121,1308,5813,3839,1526,20,35,2,46
19962,13692,1147,12545,8042,3057,62,403,11,93
19963,20827,2615,18212,13674,3157,53,291,8,89
19964,1298,119,1179,1062,45,4,2,1,3
19966,32520,2950,29570,24220,2974,262,477,6,114
19967,1802,50,1752,1669,26,0,10,0,2
19968,13800,930,12870,11183,961,42,163,3,50
19970,8591,306,8285,7849,78,5,108,7,20
19971,14348,755,13593,12408,439,31,204,7,55
19973,25550,3099,22451,14905,5768,60,398,5,135
19975,10476,980,9496,8552,518,11,126,0,35
19977,27505,1797,25708,14989,8569,83,500,3,164
19979,722,32,690,569,71,8,3,0,0
19980,235,10,225,186,24,0,0,0,0
20001,49040,5381,43659,22647,14293,58,4088,46,275
20002,69422,5355,64067,29493,27894,133,2852,42,391
20003,36501,2360,34141,22605,8063,54,1526,35,134
20004,1682,142,1540,1115,111,1,211,0,20
20005,12953,1856,11097,7252,1878,19,1344,4,68
20006,1599,176,1423,860,145,1,315,3,13
20007,26827,2523,24304,19104,1290,22,2362,14,175
20008,30143,2944,27199,20818,2261,30,2460,8,185
20009,53357,7668,45689,31130,8379,80,3371,32,241
20010,32663,9517,23146,12809,7020,93,1712,22,175
20011,67815,17164,50651,13663,32079,110,1676,16,433
20012,15485,2614,12871,3617,7972,29,339,6,135
20015,16628,1307,15321,11865,1478,16,948,0,87
20016,35068,3516,31552,24692,2082,24,2731,4,195
20017,20293,2521,17772,5114,10944,49,616,12,140
20018,20646,1693,18953,3003,14387,58,439,7,85
20019,59601,2892,56709,1294,53022,172,197,20,319
20020,51616,1416,50200,1487,46533,132,197,13,224
20024,15952,1213,14739,7005,5837,41,930,4,97
20032,38904,1487,37417,2505,33090,90,220,8,173
20036,6109,635,5474,3907,473,7,787,5,39
20037,14945,1409,13536,9428,976,23,2415,4,78
20045,7,1,6,1,4,0,0,0,0
20052,3691,402,3289,2312,300,11,467,9,14
20057,4091,454,3637,2387,337,4,621,6,28
20059,1717,199,1518,666,532,0,240,6,1
20064,1914,633,1281,571,520,13,87,18,20
20105,34475,2763,31712,14458,3025,75,11778,23,202
20106,4554,228,4326,3948,127,8,35,1,20
20109,43849,18384,25465,11677,6753,66,4627,27,291
20110,49120,20186,28934,17706,5779,76,3156,24,352
20111,38883,15530,23353,13186,3924,53,4304,26,315
20112,29459,4469,24990,17495,3280,45,2095,24,176
20115,6536,813,5723,4937,394,12,65,6,26
20117,2746,278,2468,2050,234,5,34,2,12
20119,4263,477,3786,3248,235,8,65,2,23
20120,42697,6045,36652,18633,2927,69,12636,31,290
20121,28901,5535,23366,10317,2537,41,8800,22,155
20124,14999,1081,13918,9778,424,19,2816,20,73
20129,482,45,437,389,13,0,5,0,3
20130,359,19,340,304,13,1,8,0,0
20132,18483,1456,17027,14859,503,18,533,10,91
20135,2935,149,2786,2545,49,3,44,6,23
20136,31622,4360,27262,17569,3541,49,3861,30,168
20137,1801,82,1719,1556,37,0,37,1,5
20141,8178,664,7514,6568,231,5,271,2,28
20143,1124,127,997,813,27,1,88,1,6
20144,1096,75,1021,892,85,2,12,0,4
20147,66394,7416,58978,36480,5165,89,13301,39,410
20148,61793,4530,57263,24623,4528,81,24550,36,325
20151,22653,4660,17993,8069,1332,41,7561,8,122
20152,37013,2856,34157,14560,2674,57,14617,28,164
20155,37218,4191,33027,20879,3897,42,5910,24,195
20158,4639,301,4338,3704,125,5,211,1,30
20164,40888,17525,23363,12810,2709,42,5953,15,322
20165,33777,4452,29325,20324,2088,19,4724,20,199
20166,14164,2812,11352,4250,1869,20,4346,12,126
20169,28182,2367,25815,18412,2296,28,3153,11,155
20170,42756,12998,29758,16952,3272,59,7523,15,276
20171,51759,3938,47821,21703,4676,64,18932,15,266
20175,33245,4468,28777,22443,2023,56,2264,14,157
20176,51777,9195,42582,29284,4128,37,6197,17,290
20180,8073,540,7533,6545,262,22,198,6,39
20181,9765,1002,8763,7277,403,10,446,5,46
20184,735,100,635,552,37,0,8,0,2
20186,15171,1288,13883,11269,1424,23,344,10,77
20187,18888,1298,17590,15215,857,35,427,17,106
20190,20957,2554,18403,12478,2179,24,2477,17,142
20191,29948,5176,24772,16459,3055,26,3304,7,213
20194,13171,987,12184,9229,611,8,1459,5,79
20197,2558,210,2348,2004,77,3,91,0,21
20198,2440,303,2137,1959,68,2,22,0,15
20204,0,0,0,0,0,0,0,0,0
20220,0,0,0,0,0,0,0,0,0
20230,0,0,0,0,0,0,0,0,0
20240,0,0,0,0,0,0,0,0,0
20245,0,0,0,0,0,0,0,0,0
20250,0,0,0,0,0,0,0,0,0
20260,0,0,0,0,0,0,0,0,0
20317,49,13,36,16,12,0,0,0,0
20319,72,19,53,26,7,0,4,0,4
20373,396,53,343,218,71,6,22,5,0
20388,0,0,0,0,0,0,0,0,0
20390,255,77,178,151,12,1,7,0,0
20408,13,0,13,0,13,0,0,0,0
20415,0,0,0,0,0,0,0,0,0
20418,0,0,0,0,0,0,0,0,0
20422,47,1,46,3,41,0,0,0,2
20427,0,0,0,0,0,0,0,0,0
20431,0,0,0,0,0,0,0,0,0
20510,0,0,0,0,0,0,0,0,0
20515,4,0,4,2,0,0,2,0,0
20520,0,0,0,0,0,0,0,0,0
20530,0,0,0,0,0,0,0,0,0
20535,8,3,5,2,0,0,1,0,0
20540,0,0,0,0,0,0,0,0,0
20542,12,4,8,1,3,0,3,0,0
20551,0,0,0,0,0,0,0,0,0
20560,0,0,0,0,0,0,0,0,0
20565,0,0,0,0,0,0,0,0,0
20566,5,0,5,0,5,0,0,0,0
20591,15,4,11,2,2,0,2,0,2
20601,27789,2554,25235,6855,15348,142,1064,26,188
20602,28736,2459,26277,5412,18122,167,843,32,176
20603,32485,2394,30091,5993,20032,125,1845,24,235
20606,251,0,251,226,16,1,3,0,0
20607,12762,1019,11743,1751,8632,54,622,5,85
20608,878,42,836,405,377,6,2,0,2
20609,1076,10,1066,963,61,1,3,0,3
20611,1100,56,1044,813,172,11,5,0,3
20612,232,10,222,198,4,0,1,0,0
20613,15726,1170,14556,3177,10165,111,280,8,75
20615,379,5,374,342,7,0,2,0,4
20616,7356,675,6681,1287,4647,44,242,19,40
20617,761,27,734,535,148,4,6,0,1
20618,1073,25,1048,712,246,6,13,0,7
20619,14179,1057,13122,9597,1633,39,734,16,90
20620,1588,65,1523,1163,181,8,70,3,2
20621,1214,34,1180,896,173,13,6,0,2
20622,4741,153,4588,3696,552,34,35,4,24
20623,2846,121,2725,212,2343,10,36,0,18
20624,1138,26,1112,981,78,2,0,1,7
20625,848,16,832,754,29,0,9,0,4
20626,403,6,397,346,29,1,4,0,0
20628,599,29,570,478,57,0,8,2,3
20629,1188,29,1159,987,93,1,32,0,1
20630,586,24,562,469,45,0,7,0,1
20632,538,46,492,370,53,11,15,1,2
20634,6984,571,6413,3750,1879,9,300,7,26
20636,10615,340,10275,8805,614,31,234,1,65
20637,6111,246,5865,3890,1412,26,103,2,38
20639,15344,672,14672,11713,1570,33,319,11,81
20640,9949,621,9328,3839,4570,97,251,1,29
20645,769,15,754,664,62,0,2,0,3
20646,20411,1116,19295,12571,4678,95,603,25,68
20650,15298,628,14670,12270,1092,30,385,9,89
20653,25180,2460,22720,12424,7066,82,1145,26,133
20656,106,9,97,28,60,1,0,0,1
20657,20042,1007,19035,13986,3299,53,254,6,89
20658,968,59,909,546,250,15,14,1,3
20659,24427,707,23720,20321,1780,70,207,12,71
20660,107,8,99,71,13,0,0,2,0
20661,0,0,0,0,0,0,0,0,0
20662,2564,73,2491,1530,761,21,17,0,17
20664,2940,124,2816,2019,520,30,53,7,18
20667,471,18,453,301,114,1,12,0,1
20670,1226,231,995,687,156,2,49,0,3
20674,718,39,679,554,58,3,22,0,4
20675,1728,117,1611,893,487,42,52,1,12
20676,3462,105,3357,2655,482,8,32,1,5
20677,2475,114,2361,1623,548,19,35,2,5
20678,12818,569,12249,8715,2431,49,254,12,51
20680,944,29,915,810,48,0,13,2,0
20684,1193,38,1155,985,117,4,7,0,0
20685,6648,283,6365,5172,665,13,57,7,30
20686,977,76,901,676,122,2,45,2,8
20687,304,12,292,213,35,1,9,0,2
20688,1462,46,1416,1275,59,0,37,1,0
20689,1915,76,1839,1270,459,10,15,0,7
20690,954,26,928,840,42,0,8,0,0
20692,738,39,699,563,66,8,16,1,4
20693,1067,40,1027,790,133,15,5,2,10
20695,13318,773,12545,3051,8084,62,422,2,84
20701,1195,77,1118,388,642,5,45,0,3
20705,29456,10567,18889,4049,10474,53,3156,7,241
20706,43623,11515,32108,2573,26117,54,1940,5,208
20707,37702,7416,30286,7995,16944,78,3385,23,325
20708,27832,5985,21847,3721,15616,63,1314,4,161
20710,9850,3902,5948,305,5238,26,132,5,38
20711,7193,1315,5878,4456,958,25,64,2,34
20712,9526,3858,5668,1326,3757,8,187,9,58
20714,4036,256,3780,3027,370,8,67,4,16
20715,27127,3203,23924,11731,9322,50,1156,15,184
20716,22874,1713,21161,4111,14672,39,1032,7,159
20720,25702,1663,24039,3287,17880,34,1649,5,141
20721,29847,1258,28589,1595,24998,46,759,4,151
20722,6498,3135,3363,823,1977,20,305,7,50
20723,35353,3951,31402,12006,10635,33,6602,14,321
20724,19163,4022,15141,3760,9085,32,1237,5,204
20732,10626,525,10101,7856,1282,8,130,20,56
20733,2806,116,2690,2251,288,6,22,0,10
20735,38200,3806,34394,2276,29546,100,954,9,257
20736,9632,351,9281,7664,796,19,193,10,39
20737,24555,13427,11128,2050,6858,24,1438,0,147
20740,36930,6935,29995,15878,6126,61,6027,5,240
20742,4769,185,4584,2750,492,5,1115,0,9
20743,40709,5973,34736,757,32377,81,274,12,188
20744,52747,8255,44492,3473,35575,90,3319,32,356
20745,32024,7640,24384,1495,20527,51,1247,20,206
20746,31635,2895,28740,1233,26060,65,323,12,141
20747,40696,3399,37297,930,34767,80,336,8,162
20748,39689,4625,35064,1509,31635,122,537,15,201
20751,2374,113,2261,2000,106,4,22,0,8
20754,6913,322,6591,5564,492,9,164,2,27
20755,9324,1594,7730,4517,1869,31,367,44,69
20758,741,41,700,643,17,0,8,0,3
20759,6562,307,6255,3354,798,4,1624,7,54
20762,3002,471,2531,1345,753,22,152,14,14
20763,2745,549,2196,1029,781,1,224,0,28
20764,4199,162,4037,3340,380,12,29,3,17
20765,466,18,448,371,58,0,2,0,3
20769,7009,920,6089,1126,4352,7,378,0,33
20770,28612,4831,23781,5422,14504,50,2456,10,203
20771,3,1,2,0,0,0,0,0,0
20772,51395,3366,48029,4537,40392,135,684,30,320
20774,51984,2432,49552,1715,44976,73,837,11,246
20776,3266,259,3007,2430,340,19,25,4,17
20777,3527,142,3385,2355,191,3,631,0,21
20778,1871,75,1796,1602,68,1,13,1,3
20779,1272,38,1234,1065,67,6,25,0,7
20781,13662,6444,7218,2991,3388,27,257,6,86
20782,35356,14940,20416,4606,13306,50,1105,6,268
20783,48946,33107,15839,2434,10236,97,2099,16,245
20784,32567,13871,18696,1645,15136,46,828,10,245
20785,41636,7186,34450,2661,29336,78,785,16,230
20794,16658,2133,14525,5359,7061,54,1319,3,85
20812,287,19,268,240,2,0,11,0,0
20814,31919,3071,28848,20796,1999,24,4134,23,211
20815,31517,2611,28906,22884,1713,20,2441,14,240
20816,17035,1477,15558,12859,472,4,1133,3,137
20817,38908,3540,35368,24838,1899,38,6097,4,254
20818,1832,133,1699,1340,64,0,173,2,17
20832,25969,2876,23093,14816,3452,35,3293,3,135
20833,7913,701,7212,5297,682,5,794,2,42
20837,6634,664,5970,4717,371,13,436,0,47
20838,218,20,198,181,3,1,3,0,1
20839,176,5,171,157,13,0,0,0,0
20841,9538,913,8625,3175,1192,8,3761,5,54
20842,2021,218,1803,1540,125,1,64,0,5
20850,51045,6074,44971,22917,6424,60,12613,28,386
20851,14327,4878,9449,4964,1332,40,2375,8,139
20852,48347,6967,41380,24450,4452,74,9582,25,381
20853,30611,8398,22213,13228,3291,34,4031,13,248
20854,50698,3437,47261,29183,2723,43,12698,11,369
20855,17003,2388,14615,8102,1938,24,3460,10,135
20860,2079,194,1885,1110,414,2,226,3,17
20861,3067,290,2777,1511,543,2,572,1,12
20862,453,63,390,309,23,2,25,1,2
20866,15199,1974,13225,2621,7490,26,2422,7,120
20868,671,142,529,242,147,4,101,1,8
20871,28557,3404,25153,7910,5306,18,10433,7,210
20872,13349,2570,10779,7915,1308,28,808,3,88
20874,62908,14189,48719,18380,16309,120,10501,33,527
20876,26034,6656,19378,6258,6098,69,5587,9,182
20877,37577,16230,21347,7325,7526,71,4874,39,308
20878,65990,9468,56522,29179,6501,81,17274,39,497
20879,26176,8472,17704,6666,5517,29,4194,4,251
20880,504,45,459,385,25,0,17,2,5
20882,13890,1918,11972,8908,1100,26,1064,5,125
20886,35649,13241,22408,8647,8142,73,3840,5,320
20889,1010,208,802,466,144,5,135,5,5
20892,2,0,2,0,0,0,2,0,0
20894,0,0,0,0,0,0,0,0,0
20895,19753,2833,16920,13101,1282,13,1310,5,147
20896,1019,73,946,824,11,0,50,2,5
20899,125,10,115,29,65,0,10,0,4
20901,36537,8755,27782,13693,9521,40,2636,6,291
20902,52533,19328,33205,16214,9550,58,4708,20,539
20903,24103,12929,11174,2071,6304,36,2161,4,167
20904,59051,10512,48539,11916,27128,58,6933,24,360
20905,17700,2784,14916,6529,4374,23,2846,17,202
20906,71641,24784,46857,17435,17022,98,8592,16,871
20910,45610,6227,39383,19413,13678,55,3341,24,456
20912,25463,5989,19474,8458,8528,27,1079,6,140
21001,25714,2105,23609,13226,7628,64,808,47,124
21005,1709,250,1459,722,473,6,84,4,21
21009,31835,1820,30015,21682,4995,44,1517,15,178
21010,153,33,120,76,29,0,3,0,2
21012,22377,1248,21129,18097,954,29,712,17,103
21013,4861,133,4728,4398,54,0,107,0,11
21014,38395,1768,36627,31466,1887,39,1411,17,119
21015,30400,1430,28970,23989,1695,31,1788,15,115
21017,6526,377,6149,3793,1636,17,216,8,60
21023,89,14,75,57,6,0,4,0,5
21028,3172,102,3070,2752,100,9,53,0,0
21029,12919,417,12502,6119,972,11,4809,0,67
21030,26156,3136,23020,14534,4386,49,2994,17,114
21031,11,0,11,2,4,0,3,0,1
21032,9180,634,8546,7250,467,14,205,5,53
21034,3314,96,3218,2953,94,12,9,1,9
21035,8298,345,7953,6938,357,11,182,2,53
21036,2307,75,2232,1676,112,0,293,3,18
21037,21453,1751,19702,17529,629,26,447,4,115
21040,25138,2583,22555,9015,11236,54,403,22,173
21042,43147,1625,41522,24408,2924,37,11971,4,203
21043,48775,2571,46204,22748,6059,59,14969,7,241
21044,44284,3978,40306,20108,12048,75,5178,21,362
21045,39321,5335,33986,15243,11671,73,4308,24,338
21046,16023,1310,14713,7830,4174,21,1536,3,116
21047,12876,365,12511,11367,240,21,322,2,42
21048,10774,342,10432,9323,380,20,181,6,21
21050,18681,587,18094,16390,467,19,375,1,79
21051,256,5,251,238,0,0,2,0,2
21052,430,10,420,382,2,1,4,1,0
21053,3199,91,3108,2862,50,4,41,1,4
21054,13970,1015,12955,8846,2113,28,996,16,97
21056,329,18,311,253,8,0,9,0,8
21057,4060,106,3954,3635,48,2,95,3,13
21060,38269,4244,34025,21276,8475,136,1722,29,222
21061,57352,7514,49838,27395,15713,163,3000,67,359
21071,619,33,586,482,41,1,26,0,10
21074,15279,559,14720,13488,268,22,203,4,83
21075,35900,4419,31481,14373,7820,73,7116,24,240
21076,22299,2129,20170,8210,6729,38,3786,18,119
21077,336,58,278,145,62,1,25,0,1
21078,20321,1119,19202,14465,2985,57,493,25,107
21082,815,15,800,733,6,0,3,0,4
21084,7600,138,7462,6944,98,8,68,1,41
21085,17142,790,16352,11828,3079,32,421,11,83
21087,5634,187,5447,5112,66,4,70,11,21
21090,10623,583,10040,8251,652,26,553,20,65
21093,38677,1747,36930,29282,1825,30,4273,12,149
21102,12100,403,11697,10759,286,16,171,3,46
21104,5686,172,5514,4399,251,10,615,0,17
21105,56,3,53,48,1,2,0,0,0
21108,18065,924,17141,13296,1989,21,805,12,83
21111,5062,193,4869,4502,97,3,58,2,29
21113,35670,2952,32718,17653,10335,76,2041,43,217
21114,26404,1928,24476,17313,3752,23,1629,4,144
21117,59154,5143,54011,17783,29716,72,3917,14,369
21120,7178,194,6984,6380,100,18,147,3,39
21122,62368,3077,59291,50051,4126,143,1344,25,299
21128,14861,531,14330,9684,1616,19,2349,0,46
21130,140,25,115,98,3,0,1,0,0
21131,7468,244,7224,6551,93,9,236,0,33
21132,2930,50,2880,2708,8,1,14,0,12
21133,30527,1113,29414,2550,25055,34,560,8,176
21136,34973,3650,31323,18268,8985,46,2343,7,197
21140,3625,195,3430,3063,60,3,71,2,15
21144,37295,3586,33709,15970,12578,86,2496,31,221
21146,28593,1202,27391,23783,1081,20,997,2,106
21152,6045,222,5823,4966,220,7,398,3,18
21153,865,43,822,670,42,0,58,1,8
21154,6309,163,6146,5745,96,6,41,5,12
21155,2553,120,2433,2248,38,2,32,0,21
21156,259,6,253,234,1,0,0,0,0
21157,38584,2385,36199,31764,1757,66,762,15,146
21158,20917,846,20071,17780,815,28,491,0,72
21160,2449,46,2403,2202,44,9,13,0,2
21161,5333,132,5201,4841,68,17,45,4,18
21162,5029,196,4833,3398,599,8,581,0,11
21163,7657,209,7448,3391,1519,10,2231,2,39
21201,18382,931,17451,5229,9591,25,1683,6,128
21202,22247,1113,21134,6907,11690,55,1543,4,97
21204,20967,1052,19915,14484,3297,21,1222,4,71
21205,14691,3178,11513,2257,8164,40,471,1,59
21206,49470,1809,47661,9199,35802,132,618,24,269
21207,46595,2796,43799,3587,37465,111,944,10,301
21208,35007,1633,33374,16408,14819,42,846,10,197
21209,28659,913,27746,19749,4980,27,1606,2,369
21210,14441,815,13626,9259,1062,3,2603,2,75
21211,17721,896,16825,12498,1935,43,1494,2,93
21212,32317,1531,30786,16304,11516,31,1450,4,154
21213,28217,788,27429,1473,24864,67,112,6,110
21214,19344,748,18596,6503,10785,73,223,10,140
21215,54198,3090,51108,8538,40083,133,447,21,385
21216,27729,508,27221,712,25271,50,339,1,158
21217,30448,847,29601,3705,23747,62,841,16,176
21218,46238,2560,43678,12287,24989,68,4062,16,231
21219,9594,240,9354,8353,422,23,87,1,27
21220,44568,3212,41356,24593,12672,121,1521,11,185
21221,43381,3330,40051,23410,12867,222,953,14,282
21222,59062,7356,51706,37464,8845,418,1212,13,249
21223,20438,1384,19054,2837,14975,61,302,6,96
21224,54266,16553,37713,26317,7315,222,1673,10,262
21225,34138,5412,28726,11946,13953,110,807,12,149
21226,7368,711,6657,4682,1305,18,141,9,40
21227,35837,4827,31010,20471,5739,66,2635,7,205
21228,50418,2959,47459,28708,9783,78,6368,21,286
21229,43464,1544,41920,6755,31503,88,1823,6,200
21230,36660,4149,32511,20891,8297,59,1502,7,191
21231,17062,2252,14810,8858,3944,41,1098,4,97
21233,4,0,4,0,4,0,0,0,0
21234,67308,3827,63481,35799,21070,142,3337,22,354
21236,40555,1778,38777,23659,8259,52,4915,13,195
21237,31477,2841,28636,12795,11301,86,3014,7,183
21239,26605,756,25849,3294,20844,40,669,10,144
21240,0,0,0,0,0,0,0,0,0
21244,38015,2557,35458,3111,27840,80,2999,8,266
21250,3391,195,3196,1472,785,3,667,1,23
21251,277,15,262,95,24,1,125,0,0
21252,5775,422,5353,2512,2251,5,269,1,25
21285,2,0,2,2,0,0,0,0,0
21286,21470,1192,20278,14166,3697,37,1430,12,90
21287,0,0,0,0,0,0,0,0,0
21401,39308,4878,34430,25363,6390,67,1054,15,155
21402,1026,138,888,640,115,3,67,1,8
21403,31521,6031,25490,19096,4412,26,700,12,125
21405,622,33,589,540,2,0,6,0,0
21409,20326,1390,18936,16065,1242,16,451,14,77
21502,41153,835,40318,33312,4499,76,460,11,114
21520,2060,24,2036,1948,8,2,3,0,9
21521,1171,6,1165,1150,3,0,0,0,0
21523,271,2,269,265,0,2,0,0,0
21524,500,7,493,480,0,0,3,0,2
21529,651,13,638,607,3,0,1,0,0
21530,1520,7,1513,1445,14,0,3,3,5
21531,2176,45,2131,2042,13,1,6,0,6
21532,13328,189,13139,11637,714,30,250,5,50
21536,4029,33,3996,3870,27,0,6,0,22
21538,622,6,616,596,2,0,0,0,0
21539,2536,15,2521,2445,16,4,2,0,2
21540,85,1,84,84,0,0,0,0,0
21541,1626,53,1573,1403,96,5,21,0,2
21542,110,3,107,101,0,0,0,0,0
21543,230,0,230,213,0,1,2,0,1
21545,1719,3,1716,1658,17,0,0,0,0
21550,13499,135,13364,12918,61,16,31,2,12
21555,1619,9,1610,1549,10,1,4,2,4
21557,1911,25,1886,1782,9,0,6,0,4
21560,35,0,35,34,0,0,0,0,0
21561,2571,17,2554,2475,19,7,9,0,3
21562,2857,38,2819,2734,14,3,8,0,3
21601,23945,2791,21154,16838,2969,30,438,11,99
21607,492,100,392,349,31,1,4,0,1
21610,297,8,289,257,16,0,1,0,1
21612,432,14,418,406,6,0,0,0,0
21613,17967,1247,16720,9202,6471,41,237,2,72
21617,10719,368,10351,9124,732,9,100,2,24
21619,6598,336,6262,5538,322,9,110,2,22
21620,12726,582,12144,9435,1944,21,210,0,38
21622,475,22,453,407,15,6,5,0,1
21623,2244,201,2043,1627,274,5,22,0,11
21624,201,3,198,164,22,0,2,0,0
21625,2329,96,2233,1944,171,0,11,0,18
21626,101,0,101,94,1,2,1,0,0
21627,27,1,26,24,2,0,0,0,0
21628,496,45,451,396,23,2,6,0,4
21629,9911,432,9479,7524,1305,35,145,3,21
21631,2644,91,2553,2208,212,5,15,0,7
21632,6616,232,6384,4281,1672,11,114,5,16
21634,302,9,293,290,0,3,0,0,0
21635,1969,126,1843,1690,70,2,19,0,10
21636,1186,148,1038,926,51,0,4,0,8
21638,5058,328,4730,3969,448,13,72,2,24
21639,4354,342,4012,3387,307,12,30,0,23
21640,1798,547,1251,1134,53,1,4,1,6
21641,128,5,123,99,17,0,0,1,0
21643,5820,220,5600,3526,1722,17,39,0,29
21644,93,7,86,81,4,0,0,0,0
21645,1005,141,864,781,40,0,5,0,6
21647,248,2,246,225,18,0,0,0,0
21648,233,10,223,195,21,3,1,0,0
21649,1764,845,919,815,27,0,5,1,6
21650,206,42,164,150,5,0,2,0,0
21651,2718,230,2488,2058,319,3,13,0,9
21652,161,1,160,156,3,0,0,0,0
21653,124,20,104,99,4,0,0,0,0
21654,1129,41,1088,1031,31,0,8,0,6
21655,4798,169,4629,3887,516,6,29,2,10
21657,1108,51,1057,912,59,1,9,0,5
21658,3723,231,3492,3122,182,6,41,0,17
21659,1102,38,1064,859,147,0,10,2,8
21660,3927,248,3679,2920,523,5,38,1,15
21661,2427,60,2367,2040,216,0,11,0,13
21662,668,37,631,527,78,0,5,0,0
21663,3142,109,3033,2603,286,6,25,0,18
21664,472,26,446,405,19,2,0,0,3
21665,291,10,281,266,4,0,0,0,2
21666,12848,378,12470,11411,246,12,207,2,53
21667,285,10,275,247,13,0,1,0,2
21668,1745,183,1562,1395,91,0,3,3,3
21669,189,1,188,173,5,0,3,0,0
21671,773,17,756,723,8,3,3,0,1
21672,158,3,155,148,1,3,0,0,2
21673,3122,174,2948,2249,545,6,37,0,18
21675,87,3,84,81,0,0,1,0,0
21676,315,8,307,271,15,0,4,0,0
21677,415,10,405,380,10,0,11,0,1
21678,2145,63,2082,1504,496,3,4,0,8
21679,429,8,421,405,12,0,1,0,0
21701,39629,4077,35552,27316,4703,50,1249,6,212
21702,46412,9258,37154,23440,8377,83,2593,58,298
21703,41138,8860,32278,19384,7171,65,3151,27,276
21704,19275,2171,17104,10778,1939,26,3176,4,132
21705,9,3,6,3,2,0,0,0,0
21710,4769,323,4446,3723,276,10,146,1,32
21711,1108,20,1088,1024,10,3,3,1,4
21713,9800,370,9430,8623,187,11,152,2,33
21714,358,16,342,321,4,2,6,0,8
21715,87,3,84,76,1,0,0,0,0
21716,6753,543,6210,5146,518,4,127,0,48
21717,199,26,173,149,4,0,9,0,0
21718,134,4,130,114,1,0,2,0,3
21719,1230,37,1193,1114,22,3,10,0,1
21722,5674,90,5584,5335,41,4,29,1,16
21723,937,49,888,584,100,0,166,0,1
21727,6593,341,6252,5283,535,10,116,23,12
21733,1134,53,1081,1005,12,0,13,0,2
21734,845,19,826,773,15,2,10,0,0
21737,2318,77,2241,1337,128,2,617,0,13
21738,3373,124,3249,2703,124,1,244,0,11
21740,65619,6125,59494,42697,10769,119,1438,33,410
21742,33069,2293,30776,24066,3605,37,1095,16,164
21746,2861,210,2651,729,1900,12,6,1,0
21750,3662,36,3626,3443,18,10,19,4,5
21754,7115,505,6610,5441,259,14,513,2,33
21755,5627,438,5189,4674,137,9,94,2,19
21756,3669,65,3604,3370,43,8,14,1,14
21757,2870,84,2786,2586,62,2,16,1,9
21758,4809,267,4542,3934,292,9,68,0,7
21762,233,17,216,162,19,1,7,0,3
21766,633,4,629,607,0,0,0,1,0
21767,1150,77,1073,932,58,2,16,0,11
21769,11759,563,11196,10093,260,10,270,2,45
21770,7575,661,6914,5551,445,8,529,0,44
21771,30697,1994,28703,25816,693,42,573,7,105
21773,5410,198,5212,4783,96,9,69,4,14
21774,15496,977,14519,12436,492,20,583,5,71
21776,5726,137,5589,5141,110,10,50,2,9
21777,1890,155,1735,1469,99,4,41,0,10
21778,1145,39,1106,1055,4,1,16,0,6
21779,971,26,945,905,3,1,2,0,2
21780,1688,62,1626,1495,38,2,9,3,0
21781,165,10,155,42,28,2,75,1,1
21782,3866,93,3773,3574,24,6,16,0,18
21783,9306,385,8921,8317,164,17,64,1,26
21784,40028,1594,38434,33052,1846,62,1613,6,140
21787,11066,399,10667,9512,514,23,89,0,42
21788,11491,449,11042,10366,111,21,108,4,36
21790,93,24,69,57,1,2,3,0,0
21791,5292,122,5170,4761,117,2,47,0,19
21793,10447,1026,9421,7782,756,21,238,5,62
21794,2532,103,2429,1698,159,0,429,0,16
21795,9873,349,9524,8691,308,11,113,2,25
21797,8956,324,8632,7475,283,13,420,1,42
21798,2366,102,2264,2076,58,5,19,1,11
21801,31183,1845,29338,15242,11616,79,1014,10,112
21804,40049,3696,36353,21746,11106,82,1281,20,197
21810,199,9,190,169,16,0,0,0,0
21811,23907,951,22956,19872,1885,31,327,1,78
21813,2862,76,2786,2489,160,5,53,1,7
21814,342,7,335,270,44,1,1,0,0
21817,4825,241,4584,3369,936,10,47,0,18
21821,847,11,836,739,50,0,1,0,0
21822,2548,143,2405,1726,520,7,23,0,9
21824,166,5,161,157,1,0,1,0,0
21826,5436,440,4996,2714,1691,11,253,0,32
21829,479,5,474,393,48,1,12,0,0
21830,4217,118,4099,3366,477,6,50,0,8
21835,472,26,446,373,61,1,1,0,2
21837,2647,74,2573,1992,428,1,30,0,1
21838,1717,121,1596,1237,267,7,17,0,9
21840,371,3,368,290,52,0,2,0,1
21841,903,28,875,736,96,1,7,0,0
21842,11104,547,10557,9747,222,21,175,2,35
21849,3162,102,3060,2687,196,3,41,1,13
21850,3167,144,3023,2659,158,7,54,2,10
21851,7229,274,6955,3946,2495,22,130,0,30
21853,10179,415,9764,4018,5189,23,136,0,31
21856,879,35,844,640,152,2,8,0,4
21861,830,17,813,741,31,2,2,0,3
21862,119,7,112,95,14,0,0,0,0
21863,4843,165,4678,3216,1187,5,44,1,15
21864,590,17,573,438,90,0,11,0,0
21865,439,9,430,328,72,1,5,0,4
21866,36,1,35,35,0,0,0,0,0
21867,78,5,73,53,14,0,0,0,1
21869,908,35,873,594,222,5,3,1,3
21871,1918,68,1850,1386,372,8,16,1,8
21872,684,24,660,571,51,1,4,0,1
21874,2240,104,2136,1905,84,2,43,1,5
21875,7231,429,6802,4777,1237,13,321,5,46
21890,3258,111,3147,872,2244,27,0,0,0
21901,18517,922,17595,14887,1197,34,258,4,77
21902,414,7,407,209,173,0,0,0,2
21903,5835,221,5614,4639,509,24,67,2,28
21904,6689,212,6477,5797,253,30,45,1,21
21911,11207,420,10787,10144,95,24,72,3,29
21912,1312,214,1098,998,41,5,9,0,7
21913,682,87,595,488,67,1,1,0,3
21914,736,28,708,642,19,3,7,0,1
21915,2981,123,2858,2705,34,7,4,0,7
21917,2384,71,2313,2202,11,6,11,1,2
21918,4269,128,4141,3842,42,13,35,2,11
21919,3124,86,3038,2865,42,0,12,0,8
21920,555,23,532,496,17,0,5,0,1
21921,44983,2913,42070,33537,4992,84,707,10,211
21930,56,1,55,44,8,0,1,0,0
22003,59372,16243,43129,22189,4470,60,13557,18,318
22015,43941,6909,37032,23334,2639,42,8292,29,235
22025,18470,2426,16044,9528,4028,34,1215,17,94
22026,20225,4760,15465,4062,8334,36,1835,45,151
22027,2330,172,2158,1172,91,2,749,2,14
22030,60431,8602,51829,28386,5935,139,13815,34,394
22031,35256,4611,30645,15860,2273,58,10256,19,200
22032,29909,3205,26704,17314,1365,29,6246,18,176
22033,40692,3994,36698,19042,3120,27,12057,16,242
22035,22,6,16,0,7,0,0,0,5
22039,18278,1064,17214,12949,807,15,2274,5,85
22041,28039,10082,17957,8830,4075,38,3708,5,185
22042,34638,11154,23484,13775,1514,55,6521,13,247
22043,25850,4248,21602,12566,1066,26,6432,9,163
22044,13847,4584,9263,5414,937,17,2292,8,85
22046,18576,2323,16253,12060,639,19,2152,15,162
22060,9677,1436,8241,5382,1579,21,404,73,48
22066,18165,960,17205,11943,356,21,3752,5,116
22079,35225,5480,29745,11272,9160,43,6963,56,233
22101,31414,2033,29381,20824,577,25,5968,11,205
22102,27743,2115,25628,14452,1404,8,8221,10,186
22124,18488,1436,17052,11780,565,11,3576,6,91
22125,917,102,815,616,68,8,62,1,6
22134,7357,1465,5892,4307,671,31,267,50,75
22150,27955,8307,19648,8400,2740,28,7349,7,156
22151,18026,4269,13757,7424,950,25,4377,18,135
22152,29843,4491,25352,15238,2908,52,5091,17,222
22153,32697,4383,28314,17204,3634,47,5153,40,186
22172,10679,2632,8047,2441,4177,25,679,28,114
22180,26666,3122,23544,15802,843,38,5216,15,152
22181,15555,1562,13993,9258,492,8,3077,9,123
22182,27778,1729,26049,16433,1005,7,6836,6,213
22191,74189,25599,48590,14872,22146,90,7307,76,518
22192,60299,12539,47760,24342,12777,102,6340,69,462
22193,83064,27940,55124,20906,19940,154,9081,93,712
22201,39331,3935,35396,26729,1975,37,4504,17,198
22202,28472,2974,25498,16116,2751,41,4798,24,201
22203,25437,4338,21099,14879,1517,29,3242,9,154
22204,52761,15477,37284,19688,8119,91,6719,35,383
22205,18594,2042,16552,13477,508,15,1353,3,77
22206,21645,3468,18177,12187,3139,14,1494,16,134
22207,33734,3052,30682,25005,1222,26,2249,9,233
22209,14859,1801,13058,8629,911,10,2683,6,96
22211,924,76,848,661,125,0,7,1,3
22213,3600,270,3330,2657,93,1,379,0,17
22214,0,0,0,0,0,0,0,0,0
22301,14356,1343,13013,10525,991,28,613,7,77
22302,17972,2685,15287,10758,2418,24,1062,8,91
22303,16109,3889,12220,7301,2293,24,1706,13,112
22304,49237,8615,40622,18735,13921,70,4819,30,375
22305,17849,7040,10809,7366,2004,19,635,14,121
22306,33330,11835,21495,9175,7926,44,2921,31,189
22307,10271,1353,8918,7431,573,13,409,7,52
22308,13935,865,13070,11551,296,16,402,10,78
22309,33773,10580,23193,10816,7995,54,2861,35,195
22310,29611,4920,24691,14444,4342,52,3938,25,203
22311,19934,5547,14387,6144,5237,41,1945,4,137
22312,30447,7993,22454,8737,7325,29,4855,16,210
22314,35784,2900,32884,24442,4773,35,1739,12,214
22315,28184,3398,24786,14316,5005,45,3414,52,147
22401,27799,3445,24354,15132,5907,84,1315,24,280
22405,34430,3555,30875,22391,4736,281,998,45,201
22406,27129,2839,24290,16535,4606,80,1110,40,183
22407,62668,9216,53452,35705,11167,142,2341,49,401
22408,32043,4357,27686,18126,6310,94,933,33,168
22427,3379,368,3011,1882,845,27,39,2,21
22432,351,7,344,248,65,0,1,0,2
22433,192,3,189,175,10,0,1,0,0
22435,2124,118,2006,1415,471,4,18,0,20
22436,618,13,605,313,259,3,5,0,2
22437,694,36,658,449,163,2,0,0,2
22438,426,19,407,200,176,6,1,0,6
22443,9151,436,8715,6640,1334,46,102,11,38
22448,724,115,609,413,92,1,26,0,6
22454,1994,85,1909,1380,429,14,2,1,4
22460,1817,58,1759,1298,372,4,9,0,0
22469,1722,69,1653,810,777,6,4,0,3
22472,1023,87,936,378,543,0,6,0,2
22473,5409,125,5284,3406,1644,5,34,0,28
22476,333,4,329,137,179,5,0,0,1
22480,850,11,839,799,26,2,5,0,0
22482,2794,40,2754,1894,760,2,27,1,12
22485,26025,1467,24558,18325,3824,151,376,13,142
22488,1211,52,1159,544,554,4,1,0,11
22503,3997,45,3952,2467,1344,5,16,0,11
22504,251,10,241,164,67,2,0,0,0
22508,14748,1016,13732,11151,1403,51,198,6,82
22509,74,9,65,36,20,2,0,0,0
22511,1143,34,1109,875,205,0,1,0,6
22514,2605,150,2455,1691,525,40,36,1,9
22520,5659,379,5280,3383,1581,11,36,0,16
22529,276,53,223,93,125,1,0,0,0
22534,3102,133,2969,2534,163,7,30,1,9
22535,667,60,607,420,132,4,4,0,6
22538,255,3,252,189,51,0,0,1,1
22539,2113,59,2054,1709,265,3,14,0,4
22542,2048,85,1963,1711,152,6,9,1,5
22546,17757,997,16760,10660,4653,66,179,8,102
22548,88,2,86,67,9,0,0,0,0
22551,21236,1331,19905,16081,2102,70,282,24,113
22553,16476,1450,15026,11151,2368,46,322,12,118
22554,64354,10858,53496,30503,15276,158,2841,83,516
22556,29688,6067,23621,15418,4799,71,1117,64,203
22560,6465,206,6259,3364,2485,37,54,2,25
22567,2949,168,2781,2384,215,5,12,4,8
22572,6283,497,5786,3972,1585,12,24,0,2
22576,1672,17,1655,1177,426,1,7,0,5
22578,2449,33,2416,1869,425,6,26,0,10
22580,5293,392,4901,3583,932,22,38,6,34
22601,29720,5892,23828,18617,2923,66,722,14,140
22602,30865,3535,27330,23834,1341,42,654,10,148
22603,16298,2348,13950,12685,490,11,153,3,62
22610,2125,61,2064,1887,27,1,11,1,19
22611,9176,537,8639,7580,385,22,146,8,51
22620,2595,193,2402,2138,109,6,23,0,14
22623,660,33,627,573,17,0,2,0,1
22624,2595,91,2504,2343,39,5,17,0,3
22625,3784,126,3658,3416,70,7,20,3,11
22627,668,29,639,568,20,2,9,0,7
22630,33829,2065,31764,27871,1604,106,448,7,198
22637,2122,50,2072,1952,16,4,11,1,22
22639,664,44,620,549,33,2,1,0,3
22640,498,23,475,423,17,0,0,0,5
22641,299,10,289,272,0,0,4,0,6
22642,4701,379,4322,3867,124,22,59,5,32
22643,362,21,341,287,34,1,0,0,1
22644,2381,112,2269,2121,34,9,15,0,14
22645,4208,260,3948,3618,110,12,15,0,22
22646,80,7,73,54,15,2,0,0,0
22650,962,21,941,903,5,2,1,0,1
22652,1535,54,1481,1351,5,9,20,0,5
22654,894,39,855,784,9,0,9,0,7
22655,22395,2102,20293,17406,1115,30,471,18,105
22656,5454,490,4964,4203,251,4,221,3,12
22657,11974,650,11324,10269,380,28,95,4,53
22660,1715,69,1646,1566,18,1,6,0,7
22663,1761,547,1214,1038,56,9,23,2,9
22664,9383,1177,8206,7364,353,16,111,0,33
22701,37411,6415,30996,23083,5075,79,662,15,174
22709,945,19,926,817,55,2,1,0,5
22711,148,1,147,130,10,0,6,0,0
22712,10587,2277,8310,6527,974,15,154,4,47
22713,1454,91,1363,1162,73,3,20,0,9
22714,921,76,845,717,83,3,3,0,1
22715,1124,22,1102,1016,26,0,12,0,2
22716,883,25,858,807,13,0,7,0,1
22718,690,52,638,543,34,1,4,0,5
22719,312,8,304,283,11,0,0,0,0
22720,916,54,862,725,61,5,14,4,7
22722,238,7,231,215,8,0,0,0,1
22723,114,10,104,97,4,0,1,0,0
22724,2400,197,2203,1891,191,4,21,1,11
22725,38,6,32,28,1,0,0,0,0
22726,766,32,734,605,84,1,0,0,0
22727,5495,158,5337,4521,505,8,20,1,20
22728,3133,263,2870,2416,255,6,37,1,12
22729,1192,170,1022,610,372,1,7,0,0
22730,157,5,152,139,7,0,2,0,1
22731,316,12,304,270,21,0,0,0,1
22732,325,13,312,237,57,0,0,0,1
22733,1391,114,1277,915,246,1,38,1,8
22734,3470,522,2948,2308,384,7,25,1,8
22735,2259,64,2195,1810,248,2,10,0,15
22736,620,30,590,527,28,8,0,0,0
22737,3382,180,3202,2823,178,6,16,2,14
22738,1225,47,1178,1030,85,0,4,0,0
22740,1240,80,1160,1039,35,2,18,0,7
22741,226,16,210,173,22,0,0,0,0
22742,1726,101,1625,1470,63,1,3,0,2
22743,145,2,143,129,1,0,3,0,0
22746,216,13,203,180,10,1,1,0,2
22747,1081,32,1049,961,39,5,5,0,3
22749,469,18,451,419,12,2,3,0,5
22801,40460,7579,32881,27245,2318,49,1726,9,118
22802,28383,7416,20967,17557,1761,30,568,11,102
22807,5575,326,5249,4292,367,5,321,3,15
22810,798,31,767,730,6,0,3,0,0
22811,435,6,429,413,2,0,0,0,0
22812,9799,555,9244,8429,425,9,68,4,42
22815,9083,667,8416,7979,74,18,61,2,27
22820,281,10,271,254,4,0,0,0,1
22821,5848,399,5449,5185,57,1,42,0,24
22824,6070,426,5644,5346,65,7,17,4,20
22827,10769,464,10305,9679,270,8,55,0,31
22830,1671,24,1647,1585,3,2,6,0,4
22831,918,58,860,805,14,0,4,0,1
22832,1181,101,1080,985,35,3,8,0,1
22834,1354,84,1270,1224,4,0,1,0,8
22835,11561,225,11336,10413,347,21,69,7,24
22840,4524,331,4193,3843,106,7,30,0,26
22841,3047,198,2849,2739,14,2,12,0,16
22842,5215,590,4625,4361,78,9,25,0,5
22843,2374,131,2243,2184,17,0,1,0,3
22844,4599,596,4003,3716,83,5,41,0,8
22845,72,0,72,71,0,0,0,0,0
22846,2254,221,2033,1865,32,1,76,0,1
22847,993,58,935,896,12,3,5,0,2
22849,4891,127,4764,4564,52,13,27,0,10
22850,971,32,939,922,2,0,0,0,2
22851,5771,122,5649,5479,29,13,17,1,5
22853,4608,399,4209,3983,60,7,17,0,11
22901,36938,3488,33450,24496,4646,28,2304,13,202
22902,22457,2434,20023,14951,2970,27,889,13,105
22903,42170,2770,39400,27130,5286,54,4720,17,215
22904,4917,219,4698,1613,644,1,2316,2,0
22908,0,0,0,0,0,0,0,0,0
22911,19236,1228,18008,14008,1517,9,1429,10,117
22920,4192,242,3950,3472,243,4,24,0,23
22922,1997,110,1887,1347,434,9,6,0,4
22923,5819,322,5497,4574,435,9,175,2,19
22931,357,25,332,281,24,0,1,0,4
22932,10443,447,9996,8933,256,8,301,2,44
22935,1068,32,1036,952,15,1,4,0,4
22936,5356,284,5072,4624,131,6,87,2,34
22937,1401,83,1318,846,396,1,8,0,6
22938,1314,51,1263,1075,129,2,8,1,11
22939,6478,259,6219,5371,471,14,92,6,30
22940,1081,29,1052,966,36,3,6,0,2
22942,9435,441,8994,7128,1306,9,78,7,42
22943,543,14,529,454,44,0,3,1,0
22946,182,9,173,133,28,0,0,0,1
22947,5000,193,4807,4088,354,8,117,0,27
22948,252,6,246,219,4,0,8,0,0
22949,1322,66,1256,1068,114,3,20,0,5
22952,1939,48,1891,1779,32,5,14,1,7
22957,5,0,5,4,0,0,0,0,0
22958,1981,72,1909,1795,32,4,10,0,13
22959,1712,103,1609,1358,147,5,20,0,21
22960,11067,601,10466,7941,1855,25,60,3,46
22963,16279,676,15603,12696,1793,34,141,3,93
22964,193,21,172,154,13,0,0,0,1
22967,1857,116,1741,1440,203,14,15,1,5
22968,10632,887,9745,8026,810,24,269,2,60
22969,1313,41,1272,1161,59,0,1,0,4
22971,1709,48,1661,1341,249,5,4,1,7
22972,391,45,346,283,31,3,1,0,1
22973,6588,227,6361,5696,344,3,33,0,23
22974,5427,329,5098,3967,863,15,64,0,25
22976,307,15,292,273,10,0,0,0,0
22980,33049,2290,30759,25792,2973,53,322,20,123
22989,170,7,163,149,2,2,0,0,5
23002,10555,312,10243,7807,1965,17,52,0,40
23004,759,13,746,383,314,9,0,0,2
23005,17818,1105,16713,12997,2564,49,289,3,79
23009,7737,187,7550,6216,878,67,33,2,32
23011,1555,43,1512,1059,382,6,18,0,5
23015,4590,110,4480,3907,312,17,23,0,30
23021,78,3,75,67,4,0,1,0,1
23022,910,24,886,445,382,5,3,1,5
23023,395,10,385,315,45,5,1,0,4
23024,9108,234,8874,7792,553,33,35,4,35
23025,531,10,521,401,112,1,5,0,0
23027,1345,20,1325,961,273,3,10,0,6
23030,4678,59,4619,2078,2079,181,31,6,29
23032,252,7,245,159,68,0,0,0,0
23035,1410,27,1383,1215,103,0,11,2,1
23038,1935,54,1881,1234,514,11,16,1,10
23039,1124,83,1041,791,202,4,3,0,7
23040,4555,123,4432,2744,1478,21,10,4,15
23043,1627,60,1567,1446,44,5,6,0,9
23045,133,0,133,129,2,0,0,0,0
23047,2064,68,1996,1480,391,5,6,0,24
23050,671,10,661,586,40,0,4,2,6
23055,831,44,787,525,196,1,13,3,2
23056,425,12,413,342,38,0,0,0,4
23059,40249,1688,38561,22426,4325,88,9907,12,212
23060,38288,2108,36180,21291,6557,69,6243,25,202
23061,22256,720,21536,18275,1766,94,138,15,96
23062,2652,103,2549,2290,118,1,31,1,0
23063,5527,156,5371,3720,1368,18,41,1,33
23065,1602,36,1566,1217,253,5,9,3,16
23066,578,11,567,537,2,1,3,2,1
23068,241,6,235,204,23,0,1,0,0
23069,3835,124,3711,2584,888,21,30,2,13
23070,463,3,460,431,9,0,1,0,2
23071,1567,25,1542,1335,115,3,4,2,4
23072,12312,511,11801,10215,717,28,123,5,42
23075,10236,415,9821,3041,6240,46,60,3,64
23076,433,14,419,373,30,0,1,0,1
23079,401,7,394,255,129,0,0,0,0
23081,8,2,6,5,0,0,0,0,1
23083,2180,97,2083,1522,447,1,8,0,9
23084,1842,61,1781,1296,350,13,10,0,15
23085,384,7,377,237,117,1,3,1,0
23086,3416,83,3333,2526,589,86,9,2,13
23089,5507,183,5324,4414,435,59,49,2,19
23091,329,21,308,210,77,8,2,0,2
23092,657,12,645,467,143,0,2,0,8
23093,14170,511,13659,9906,2832,24,80,4,61
23102,3195,101,3094,2584,373,5,30,0,20
23103,5836,229,5607,4872,422,9,121,0,32
23106,960,44,916,657,164,16,8,4,12
23108,149,6,143,108,13,2,0,0,0
23109,1806,59,1747,1475,141,0,12,8,3
23110,687,23,664,543,88,4,0,0,0
23111,38151,1281,36870,31081,3178,162,611,19,139
23112,54592,3518,51074,38594,7094,133,2270,13,279
23113,26190,994,25196,21343,1480,40,1218,11,125
23114,21160,965,20195,15859,1923,28,1397,7,90
23116,32410,823,31587,27013,2051,44,887,8,188
23117,10324,384,9940,8160,1162,34,70,6,38
23119,289,1,288,282,1,0,5,0,0
23120,14424,654,13770,10983,1334,18,720,5,75
23123,1827,22,1805,1034,693,3,4,0,3
23124,4879,184,4695,3928,493,33,23,5,26
23126,459,5,454,270,160,9,0,0,2
23128,707,33,674,518,100,1,7,1,2
23129,300,16,284,230,35,1,4,0,1
23130,163,2,161,157,1,0,0,0,0
23138,1156,27,1129,1017,57,2,2,0,10
23139,27015,716,26299,23111,1756,57,146,14,96
23140,5956,149,5807,3743,1378,310,54,1,40
23141,7739,213,7526,6164,749,78,83,0,35
23146,3151,78,3073,2665,228,6,36,0,14
23147,5,0,5,0,5,0,0,0,0
23148,1504,27,1477,908,493,22,5,1,0
23149,3031,113,2918,2262,472,14,16,0,6
23150,12556,829,11727,7560,3381,67,157,4,58
23153,1609,34,1575,1247,219,4,18,2,6
23156,1472,37,1435,1027,325,8,9,1,6
23160,1009,39,970,327,642,0,0,0,0
23161,130,0,130,73,54,0,0,0,0
23163,186,8,178,152,20,2,0,0,0
23168,8624,471,8153,6047,1391,28,141,4,37
23169,1077,19,1058,820,169,0,4,1,6
23173,2098,199,1899,1341,186,0,257,2,13
23175,1931,46,1885,1484,349,3,3,0,3
23176,732,22,710,621,56,3,1,0,3
23177,612,14,598,418,148,12,0,0,2
23180,438,13,425,329,67,2,2,0,0
23181,5626,200,5426,4138,799,102,81,1,18
23185,51566,4139,47427,32596,10583,105,1530,58,237
23188,45438,2694,42744,32828,5836,77,1540,33,216
23192,6592,128,6464,5435,728,18,41,0,30
23219,5307,418,4889,2551,1445,16,526,2,38
23220,36942,2239,34703,20948,9392,32,2252,12,173
23221,14841,722,14119,12356,837,12,288,4,56
23222,24337,851,23486,4831,17211,87,253,6,177
23223,51960,1949,50011,10192,36802,134,762,18,271
23224,39468,9307,30161,5578,22347,89,482,13,310
23225,40876,5444,35432,15775,16895,90,744,15,237
23226,16955,964,15991,13959,741,20,556,4,96
23227,25283,1098,24185,10694,11762,63,543,8,116
23228,36384,4992,31392,17883,9141,131,2291,28,230
23229,34471,2823,31648,25484,2650,38,1881,4,237
23230,8263,821,7442,5505,927,12,576,4,43
23231,37455,1496,35959,11892,21841,178,359,18,269
23233,32610,1394,31216,22666,2030,55,5005,7,151
23234,46610,14113,32497,8282,21138,119,1217,16,351
23235,34058,3333,30725,22247,5594,52,1082,13,225
23236,27516,2616,24900,17076,5345,60,1090,9,203
23237,24906,5466,19440,11104,6426,89,543,19,179
23238,26200,1566,24634,19170,2949,23,1195,3,144
23250,0,0,0,0,0,0,0,0,0
23284,3074,305,2769,1204,981,2,379,0,20
23294,18538,2124,16414,7708,3608,66,3953,5,160
23298,28,3,25,6,14,0,1,0,1
23301,1600,283,1317,702,555,3,11,0,0
23302,78,41,37,28,4,0,0,0,1
23303,685,27,658,445,188,1,4,0,0
23304,101,9,92,80,4,1,0,0,3
23306,1066,43,1023,763,224,1,3,0,11
23307,547,64,483,189,280,3,0,0,7
23308,2068,449,1619,1101,425,1,8,0,2
23310,5260,404,4856,3118,1504,16,37,5,7
23314,9523,447,9076,6406,1909,30,164,7,51
23315,1479,27,1452,1266,136,2,3,0,11
23316,107,9,98,71,25,0,0,0,0
23320,60412,4885,55527,29293,18294,205,3808,84,370
23321,37752,2004,35748,19479,12465,126,1358,64,145
23322,66994,3587,63407,50724,6703,147,1966,55,244
23323,42736,3760,38976,21591,13269,126,1034,80,262
23324,24239,2430,21809,6668,13425,76,303,22,113
23325,17601,1187,16414,7951,6920,56,407,9,98
23336,3345,96,3249,3035,28,8,19,0,7
23337,524,39,485,391,54,5,7,0,6
23347,447,48,399,314,71,2,4,0,5
23350,3433,317,3116,1696,1241,25,19,2,8
23354,327,18,309,263,38,3,0,0,0
23356,1736,67,1669,1521,73,4,15,0,1
23357,730,304,426,184,210,1,4,0,6
23358,123,5,118,109,1,0,2,0,0
23359,653,82,571,373,173,1,1,0,0
23389,180,13,167,139,11,1,1,0,0
23395,922,13,909,628,251,1,1,0,6
23398,83,3,80,66,9,0,4,1,0
23401,168,16,152,114,32,0,0,0,0
23405,1075,113,962,662,258,7,10,0,1
23407,313,125,188,118,62,0,0,0,0
23408,49,8,41,29,10,0,0,0,1
23409,149,23,126,115,2,0,2,0,0
23410,2440,177,2263,1268,912,4,15,0,5
23413,799,74,725,397,304,2,6,0,1
23414,96,27,69,31,36,0,0,0,0
23415,2021,58,1963,984,876,8,21,0,3
23416,330,11,319,206,78,2,7,0,5
23417,3625,183,3442,2368,898,10,23,1,9
23418,1010,152,858,547,231,0,37,0,4
23420,2387,233,2154,815,1254,3,14,0,18
23421,4172,799,3373,1740,1451,4,39,0,8
23422,226,21,205,179,13,1,0,0,1
23423,384,22,362,311,34,0,1,0,0
23426,140,17,123,111,7,0,0,0,0
23427,173,2,171,166,2,0,1,0,0
23430,18232,504,17728,12000,4662,70,169,19,74
23432,1539,43,1496,1040,370,1,15,0,2
23433,1291,42,1249,1100,53,6,34,0,7
23434,51430,2052,49378,21120,25117,131,553,31,257
23435,32597,1903,30694,15277,12176,82,1032,33,254
23436,962,29,933,718,167,12,8,0,1
23437,4448,120,4328,3154,903,14,20,1,10
23438,1839,43,1796,1408,265,8,6,2,3
23440,438,0,438,428,0,0,2,0,0
23441,53,13,40,35,4,0,0,0,0
23442,1074,67,1007,557,392,5,10,0,5
23451,44879,3671,41208,33861,3783,133,1023,66,222
23452,59076,5439,53637,35126,10702,177,3234,85,333
23453,36292,3751,32541,16430,8656,118,4443,55,203
23454,58665,4500,54165,41054,6859,146,2158,81,311
23455,50599,4334,46265,32984,6801,138,3076,65,323
23456,59454,4629,54825,36745,7557,73,6235,84,323
23457,4481,161,4320,3887,190,5,34,3,21
23459,1055,287,768,424,219,1,64,9,1
23460,1227,282,945,557,232,7,77,5,4
23461,603,146,457,331,59,4,20,3,1
23462,68045,7380,60665,30011,20827,181,4588,90,414
23464,75118,5826,69292,38156,16720,201,8804,125,443
23480,331,20,311,271,31,1,1,0,1
23486,148,10,138,121,16,0,0,0,0
23487,6397,162,6235,4733,1134,29,38,5,53
23488,173,2,171,42,127,0,0,0,0
23502,20547,1681,18866,6590,10235,75,808,33,89
23503,31932,4035,27897,17392,7100,119,915,90,182
23504,22465,944,21521,2161,18217,109,195,10,76
23505,27785,2932,24853,12758,9025,101,1178,45,164
23507,6460,322,6138,4972,390,0,322,9,69
23508,20485,1075,19410,10078,7188,37,876,19,112
23509,12963,1004,11959,5020,5854,24,306,12,54
23510,8778,527,8251,4134,3249,14,432,13,43
23511,12831,2939,9892,5580,2665,75,662,96,119
23513,29105,2912,26193,7592,15432,86,1351,62,183
23517,5237,375,4862,3157,1124,13,197,6,32
23518,30278,3669,26609,16594,6338,133,1466,70,175
23523,7061,271,6790,318,6167,25,41,1,27
23551,2054,442,1612,859,547,21,79,9,6
23601,25729,1885,23844,13419,7916,97,693,40,176
23602,42004,4681,37323,18304,13937,107,2062,68,263
23603,3526,450,3076,1526,1208,11,90,3,26
23604,5160,994,4166,2529,1000,28,227,55,33
23605,14053,1326,12727,4338,7361,68,156,27,79
23606,31684,3696,27988,15481,9942,39,854,29,149
23607,23498,1182,22316,2991,17852,104,192,27,110
23608,43943,5400,38543,13752,19294,134,2022,161,297
23651,494,22,472,404,45,0,3,2,4
23661,13771,662,13109,3980,8087,56,189,24,96
23662,12460,463,11997,10937,107,33,253,2,67
23663,13374,792,12582,4474,6879,44,249,31,77
23664,10301,595,9706,6409,2348,31,200,4,66
23665,5935,912,5023,3299,874,14,234,39,45
23666,52845,3461,49384,16846,27232,195,1779,86,401
23667,80,1,79,5,74,0,0,0,0
23668,739,18,721,3,706,0,2,0,0
23669,41030,2378,38652,15486,19485,138,938,47,232
23681,0,0,0,0,0,0,0,0,0
23690,3937,433,3504,1799,1276,7,103,9,16
23691,577,112,465,362,69,2,10,0,0
23692,19539,1134,18405,14896,1356,34,843,15,104
23693,23814,1599,22215,15171,2680,68,2589,46,165
23696,3805,142,3663,3295,86,7,70,5,16
23701,24629,819,23810,9342,13060,74,202,17,103
23702,12239,774,11465,4233,6213,45,172,31,79
23703,26388,1214,25174,10588,12514,65,452,46,131
23704,19505,868,18637,4345,13129,83,231,26,83
23707,14316,602,13714,6022,6454,84,138,13,94
23708,120,27,93,43,26,0,8,0,0
23709,624,100,524,332,142,0,37,0,0
23801,9874,2351,7523,3867,2680,29,372,96,64
23803,44377,2588,41789,13379,26049,153,289,23,194
23805,19656,876,18780,6320,11253,63,257,21,135
23821,1778,36,1742,789,904,10,7,0,3
23824,7021,337,6684,3850,2487,29,40,1,45
23827,1273,45,1228,600,555,6,4,2,3
23828,431,11,420,180,227,0,0,1,4
23829,2473,53,2420,1213,1150,2,4,1,2
23830,1678,40,1638,1202,337,12,14,0,8
23831,37216,3977,33239,19980,10398,104,867,53,238
23832,39640,3867,35773,22273,10064,105,1233,10,180
23833,2147,45,2102,1778,235,1,10,1,7
23834,26635,2010,24625,16246,6037,62,759,20,129
23836,14643,1391,13252,7768,3683,22,1000,4,68
23837,4109,58,4051,2539,1338,4,25,8,18
23838,16997,654,16343,13169,2173,38,267,9,62
23839,848,17,831,380,423,3,0,0,1
23840,1642,19,1623,1245,319,2,3,0,5
23841,3509,60,3449,2321,969,16,16,0,10
23842,7103,337,6766,5153,1205,26,37,5,38
23843,538,15,523,317,199,0,1,0,0
23844,691,30,661,302,330,9,0,0,0
23845,358,10,348,265,63,1,2,0,0
23846,872,9,863,564,262,4,6,0,3
23847,12768,448,12320,4135,7723,15,83,4,44
23850,1081,32,1049,767,245,4,0,0,2
23851,13258,290,12968,5995,6351,38,106,3,34
23856,888,15,873,299,551,0,0,0,0
23857,399,9,390,300,78,0,0,0,0
23860,32139,2422,29717,14202,13296,181,371,27,155
23866,2189,34,2155,1604,430,5,11,3,6
23867,5298,177,5121,1840,3175,9,2,0,4
23868,6379,178,6201,1708,4333,2,15,5,20
23870,7,3,4,3,0,0,0,0,0
23872,2322,56,2266,1567,558,4,5,0,10
23874,986,13,973,607,303,9,2,2,1
23875,11791,949,10842,5793,4080,56,228,22,35
23876,435,4,431,261,158,2,1,0,1
23878,1162,24,1138,895,187,6,1,2,2
23879,629,17,612,331,247,2,0,0,4
23881,1876,45,1831,960,765,5,9,3,7
23882,2219,65,2154,960,1095,4,4,0,5
23883,2169,51,2118,1152,892,4,3,4,3
23884,50,0,50,16,30,0,0,0,1
23885,2779,79,2700,2122,480,1,19,0,12
23887,529,6,523,387,125,0,2,0,1
23888,2124,32,2092,1137,844,2,2,1,12
23889,569,11,558,205,340,0,1,0,1
23890,3988,114,3874,1596,2129,7,5,5,12
23891,1917,80,1837,525,1307,1,0,0,0
23893,419,10,409,220,176,2,2,0,0
23894,626,12,614,503,82,4,0,0,3
23897,563,11,552,353,180,0,0,1,0
23898,2186,42,2144,1706,321,7,12,0,6
23899,292,10,282,210,63,0,0,2,0
23901,14967,950,14017,8105,5107,27,178,1,60
23909,1329,35,1294,84,1161,0,0,0,0
23915,1196,26,1170,657,480,2,2,0,0
23917,2704,54,2650,1564,989,1,9,0,7
23919,2310,53,2257,1885,264,11,4,0,18
23920,3182,99,3083,1586,1407,4,10,0,5
23921,2060,54,2006,1401,484,3,8,0,18
23922,4300,175,4125,2109,1929,3,15,0,6
23923,2474,59,2415,1738,581,1,3,0,8
23924,5538,95,5443,2923,2305,15,8,0,18
23927,4483,85,4398,3108,1105,6,52,0,11
23930,5231,297,4934,3064,1639,19,11,2,21
23934,811,12,799,566,200,0,0,0,1
23936,7850,222,7628,4467,2925,17,30,1,16
23937,1841,47,1794,1099,605,4,1,0,3
23938,416,17,399,246,133,1,1,0,1
23942,1123,43,1080,755,263,3,3,0,5
23943,759,16,743,92,626,1,0,0,2
23944,3620,363,3257,1833,1278,12,5,1,5
23947,4119,136,3983,2858,904,8,13,2,17
23950,3482,232,3250,1897,1216,10,19,0,15
23952,219,4,215,152,49,1,1,0,1
23954,2030,48,1982,976,907,4,5,0,10
23955,21,1,20,16,0,2,0,0,0
23958,3261,48,3213,2089,1007,3,3,0,11
23959,1127,13,1114,828,238,6,1,0,10
23960,1823,36,1787,1060,631,2,9,0,1
23962,660,7,653,433,193,3,1,0,3
23963,454,0,454,281,158,1,0,0,3
23964,997,15,982,642,309,1,3,4,0
23966,2449,59,2390,1379,905,4,15,0,7
23967,840,17,823,524,271,3,0,0,2
23968,804,21,783,498,254,2,0,0,3
23970,8002,195,7807,4140,3237,27,115,0,28
23974,4700,118,4582,2634,1745,5,8,4,10
23976,187,0,187,133,49,0,0,0,0
24011,908,47,861,680,64,0,69,0,5
24012,30037,4291,25746,17761,5250,67,1080,23,164
24013,7835,616,7219,5215,1306,19,64,4,32
24014,16869,521,16348,13986,1246,48,201,3,75
24015,15973,706,15267,12572,1457,29,366,3,86
24016,9371,527,8844,4618,3324,20,301,2,55
24017,23902,1766,22136,5949,14193,58,495,8,131
24018,39144,1500,37644,32101,1807,54,1966,9,191
24019,27630,1554,26076,20924,2930,47,894,9,119
24020,524,36,488,339,73,0,50,0,2
24022,0,0,0,0,0,0,0,0,0
24053,2356,127,2229,2080,91,1,5,0,7
24054,6208,677,5531,3777,1525,18,30,0,9
24055,12236,685,11551,9806,1224,10,56,2,37
24058,316,8,308,291,3,0,0,0,3
24059,1037,45,992,910,24,2,8,0,8
24060,46755,2399,44356,34247,1789,43,5998,29,191
24061,9836,661,9175,6628,478,2,1712,1,6
24064,5017,82,4935,4610,107,11,28,2,14
24065,6267,194,6073,5534,188,6,33,0,21
24066,4787,56,4731,4474,97,7,13,0,24
24067,2400,86,2314,2201,40,0,7,1,6
24069,1805,126,1679,1049,571,1,5,0,4
24070,1375,24,1351,1274,20,1,1,1,5
24072,1450,25,1425,1335,10,1,1,0,7
24073,32093,1210,30883,27143,1572,53,565,12,80
24076,1050,14,1036,977,21,0,3,0,7
24077,922,40,882,779,34,4,15,3,5
24078,7062,807,6255,4612,1284,6,67,1,26
24079,1631,24,1607,1533,38,2,0,0,4
24082,412,19,393,315,67,0,3,0,0
24083,3814,82,3732,3472,100,1,42,0,9
24084,10894,186,10708,9766,473,17,53,1,30
24085,2220,17,2203,2032,69,4,0,0,4
24086,198,2,196,186,1,0,0,0,0
24087,3604,240,3364,3138,69,5,11,2,12
24088,4805,194,4611,4158,222,15,47,14,10
24089,2388,108,2280,1654,515,3,4,0,9
24090,4712,74,4638,4298,144,11,38,0,19
24091,7416,304,7112,6630,163,3,29,0,38
24092,2999,136,2863,2627,148,5,10,0,3
24093,185,1,184,171,0,0,1,0,0
24095,4275,90,4185,3872,114,14,13,1,14
24101,6490,142,6348,5904,150,10,38,1,29
24102,1508,36,1472,1318,69,2,8,1,4
24104,3551,57,3494,3210,133,4,17,3,3
24105,449,10,439,418,1,2,1,0,0
24112,30978,1878,29100,16061,11609,43,215,7,102
24120,1858,48,1810,1725,7,4,9,1,3
24121,10537,252,10285,9575,312,21,50,5,28
24122,1624,18,1606,1491,44,7,4,1,6
24124,4370,57,4313,4143,43,5,12,0,0
24127,3980,41,3939,3776,7,3,10,3,10
24128,1767,20,1747,1661,5,2,5,0,2
24129,29,0,29,19,7,0,0,0,0
24131,106,0,106,98,0,1,0,0,1
24132,460,6,454,427,2,0,0,0,0
24133,2345,58,2287,2085,126,9,2,0,3
24134,5638,73,5565,5249,90,6,36,0,9
24136,3259,62,3197,3009,83,5,3,0,6
24137,2506,76,2430,2088,233,2,4,0,8
24138,1445,33,1412,1347,1,2,2,0,12
24139,560,5,555,392,137,1,2,0,0
24141,20308,808,19500,16311,1815,35,233,1,128
24142,2608,143,2465,1563,695,5,32,0,167
24147,1088,17,1071,1013,8,5,9,0,1
24148,7633,329,7304,5677,1246,16,39,0,21
24149,3632,57,3575,3422,24,8,13,0,8
24150,691,18,673,621,10,6,4,0,2
24151,18785,941,17844,14311,2594,25,143,4,56
24153,38728,1352,37376,32645,2337,55,761,7,121
24161,393,6,387,338,28,0,0,0,0
24162,2254,48,2206,2006,41,13,10,0,7
24165,1655,62,1593,1226,291,1,4,0,6
24167,329,3,326,320,3,0,0,0,0
24168,214,7,207,183,13,0,0,0,0
24171,8090,258,7832,7147,384,11,14,1,37
24174,2362,38,2324,2161,47,10,11,0,19
24175,8165,125,8040,7547,158,7,57,0,14
24176,1527,39,1488,1345,72,4,10,0,2
24179,19024,559,18465,16542,838,21,215,7,58
24184,4582,97,4485,4119,171,4,7,1,11
24185,796,29,767,713,13,0,2,0,11
24201,16267,437,15830,13840,967,52,127,2,33
24202,12716,215,12501,11892,120,23,71,2,19
24210,17284,317,16967,15858,326,29,176,0,48
24211,9864,133,9731,9346,28,17,83,0,22
24216,2441,19,2422,2271,59,3,7,0,1
24217,407,6,401,396,2,0,0,0,0
24219,10429,137,10292,8913,919,13,31,2,22
24220,621,3,618,612,1,0,0,0,0
24221,785,9,776,740,2,1,0,0,3
24224,5438,25,5413,5211,41,2,3,0,7
24225,1674,10,1664,1633,2,0,0,0,2
24226,1260,10,1250,1185,21,0,0,0,0
24228,6418,23,6395,6249,8,9,7,1,12
24230,7708,70,7638,7274,142,18,17,1,9
24236,2984,55,2929,2779,16,4,6,0,9
24237,1108,9,1099,1072,16,0,0,0,0
24239,90,0,90,90,0,0,0,0,0
24243,1867,10,1857,1786,4,2,4,0,1
24244,5398,74,5324,5133,32,11,8,1,3
24245,1000,21,979,929,4,0,0,1,0
24246,399,3,396,379,1,0,1,0,0
24248,2181,24,2157,2102,2,9,0,0,3
24250,1209,9,1200,1154,2,1,0,0,6
24251,8405,91,8314,7984,81,12,6,0,10
24256,3124,26,3098,3034,14,3,2,1,0
24258,1259,13,1246,1208,0,0,1,0,3
24260,5072,25,5047,4930,33,7,1,1,7
24263,5770,60,5710,5541,12,6,6,0,11
24265,703,5,698,683,1,0,1,0,0
24266,8705,88,8617,8236,120,6,31,0,7
24269,225,0,225,216,0,2,0,0,0
24270,455,3,452,428,7,0,1,0,7
24271,2538,25,2513,2443,7,1,0,0,4
24272,517,3,514,500,0,1,0,0,0
24273,5730,110,5620,5147,195,6,36,0,22
24277,6463,347,6116,5103,839,40,24,0,3
24279,4693,65,4628,3985,538,3,7,0,3
24280,772,0,772,753,0,0,0,0,0
24281,2279,17,2262,2199,5,4,1,0,7
24282,454,1,453,448,0,0,0,0,0
24283,2133,23,2110,2021,16,11,2,2,7
24290,1777,16,1761,1694,8,5,7,0,1
24292,352,5,347,345,0,0,0,0,0
24293,9442,128,9314,8842,92,8,81,6,44
24301,14040,319,13721,12130,797,27,66,2,39
24311,1705,23,1682,1603,4,4,0,0,5
24312,2161,32,2129,2057,11,0,1,0,1
24313,923,9,914,866,4,3,1,0,2
24314,1332,13,1319,1253,12,0,0,0,1
24315,3548,34,3514,3293,123,0,4,0,0
24316,47,0,47,45,0,0,0,0,0
24317,3756,126,3630,3506,26,6,2,0,6
24318,601,3,598,584,0,1,2,0,1
24319,6500,152,6348,6082,56,7,12,0,5
24322,190,1,189,184,2,0,0,0,0
24323,692,5,687,663,4,0,0,0,0
24324,2012,23,1989,1880,28,1,4,0,3
24325,975,8,967,922,4,3,7,0,0
24326,1019,27,992,935,28,1,4,0,0
24327,684,21,663,565,69,1,8,0,19
24328,1999,49,1950,1893,7,3,0,2,3
24330,3056,87,2969,2852,32,0,19,0,7
24333,17309,1617,15692,14496,519,23,71,0,41
24340,5319,88,5231,4957,92,7,13,0,10
24343,8849,221,8628,8321,35,5,34,1,11
24347,1767,20,1747,1636,30,0,6,0,4
24348,4725,257,4468,3645,695,16,4,2,9
24350,1173,16,1157,1095,10,0,3,0,1
24351,528,13,515,485,1,3,2,0,1
24352,929,25,904,880,2,1,1,0,0
24354,14446,301,14145,13275,313,20,73,1,32
24360,5653,35,5618,5402,45,7,12,0,7
24361,4555,55,4500,4334,34,11,4,0,1
24363,1242,21,1221,1183,4,4,3,0,1
24366,631,13,618,568,28,0,0,0,3
24368,4896,59,4837,4621,20,10,7,1,17
24370,5832,62,5770,5609,17,0,16,0,6
24374,705,2,703,669,10,3,0,0,0
24375,1451,13,1438,1372,13,5,4,0,2
24377,278,2,276,270,0,0,0,0,0
24378,1065,21,1044,979,12,3,1,0,3
24380,2696,92,2604,2490,15,4,9,0,9
24381,3657,174,3483,3311,43,5,5,0,4
24382,14109,245,13864,12604,600,32,97,1,40
24401,38522,1508,37014,31323,3307,86,429,17,184
24411,35,0,35,35,0,0,0,0,0
24412,106,4,102,97,2,0,0,0,0
24413,220,2,218,212,0,0,2,0,0
24415,63,3,60,57,0,0,0,0,0
24416,8888,267,8621,7696,332,50,28,27,20
24421,3723,53,3670,3518,25,7,14,0,8
24422,5821,80,5741,5061,441,15,17,5,12
24426,13695,250,13445,11937,896,17,64,6,23
24430,2858,122,2736,1962,678,7,3,0,1
24431,2712,74,2638,2447,62,9,2,0,9
24432,283,3,280,275,1,0,0,0,0
24433,96,4,92,92,0,0,0,0,0
24435,1695,38,1657,1559,27,11,4,0,8
24437,1048,31,1017,950,24,2,2,2,8
24439,1119,23,1096,1045,6,1,3,0,2
24440,2742,45,2697,2489,113,5,4,0,1
24441,6327,357,5970,5519,180,10,19,2,19
24442,88,1,87,83,1,0,0,0,1
24445,2289,51,2238,2039,81,0,23,1,2
24448,311,5,306,269,17,1,0,0,0
24450,17654,560,17094,15287,696,31,431,1,59
24457,372,3,369,331,26,0,1,0,0
24458,364,5,359,343,0,1,1,1,1
24459,734,8,726,685,10,2,2,0,5
24460,1493,18,1475,1399,16,0,2,0,2
24464,138,4,134,121,4,2,0,0,0
24465,1305,18,1287,1256,1,0,2,0,4
24467,2204,37,2167,2076,19,3,6,0,2
24469,16,0,16,13,2,0,0,0,0
24471,1471,43,1428,1365,4,3,6,0,5
24472,2501,67,2434,2297,34,5,4,0,5
24473,871,9,862,822,9,3,0,1,6
24474,360,4,356,341,6,1,0,1,0
24476,315,5,310,299,0,0,0,0,0
24477,11269,290,10979,10042,388,14,81,9,36
24479,1485,25,1460,1370,31,2,3,0,2
24482,5200,261,4939,4427,287,9,28,0,13
24483,670,14,656,605,8,7,4,1,4
24484,699,17,682,636,22,3,1,0,0
24485,438,6,432,413,1,0,0,0,0
24486,3826,399,3427,3183,71,5,24,1,12
24487,286,3,283,275,0,0,1,0,2
24501,27160,1266,25894,13545,10281,94,351,8,168
24502,41058,2318,38740,28288,6999,91,1234,13,240
24503,19810,615,19195,15800,2128,48,268,3,145
24504,9585,283,9302,4669,3997,31,54,4,45
24515,6685,480,6205,5410,333,17,205,9,214
24517,5306,114,5192,3663,1292,6,25,0,17
24520,2308,44,2264,1574,593,4,10,2,0
24521,9902,327,9575,7463,1480,71,45,1,52
24522,10041,258,9783,7441,1855,34,25,3,62
24523,18992,411,18581,15452,2118,37,82,3,106
24526,1408,18,1390,1211,125,5,2,0,4
24527,2796,99,2697,1683,900,3,6,0,8
24528,2994,42,2952,2050,791,13,8,0,12
24529,1532,53,1479,1043,398,7,0,0,6
24530,1062,19,1043,857,159,4,2,0,0
24531,8836,264,8572,6011,2314,8,21,3,24
24534,1471,21,1450,829,586,2,1,0,5
24536,317,6,311,265,21,3,6,0,2
24538,4729,117,4612,3643,723,22,6,0,19
24539,124,8,116,66,45,0,0,0,0
24540,32094,1206,30888,15563,13924,62,357,7,78
24541,27529,1368,26161,14407,10592,48,309,2,93
24549,4121,107,4014,3404,464,6,12,3,10
24550,7772,256,7516,6191,868,16,90,2,40
24551,25601,859,24742,21245,1596,27,776,13,77
24553,1827,60,1767,1353,306,11,6,2,7
24554,3952,65,3887,2938,783,8,2,1,21
24555,2012,66,1946,1650,172,8,10,0,5
24556,3357,109,3248,2937,137,13,36,1,17
24557,7550,112,7438,5442,1710,14,27,1,16
24558,6036,116,5920,3668,2000,15,50,1,31
24562,467,12,455,328,118,0,1,0,1
24563,5028,80,4948,3840,941,12,19,0,11
24565,907,34,873,388,456,1,2,0,1
24566,1325,29,1296,1119,138,2,3,0,5
24569,938,24,914,484,381,4,1,1,6
24570,41,4,37,21,7,0,1,0,0
24571,1904,22,1882,1533,261,2,7,0,5
24572,16399,358,16041,11554,3306,122,102,17,59
24574,3868,85,3783,3056,453,41,13,4,35
24577,4821,33,4788,3145,1493,9,2,0,14
24578,1043,21,1022,958,18,5,3,0,6
24579,1304,23,1281,1194,16,13,1,0,7
24580,582,4,578,410,152,0,0,0,2
24581,38,1,37,32,4,0,0,0,0
24586,5124,95,5029,3957,890,7,16,1,17
24588,9196,195,9001,7487,1063,38,63,0,19
24589,2092,59,2033,1404,545,2,6,0,15
24590,7909,209,7700,6600,695,11,31,0,40
24592,13453,408,13045,7040,5506,34,139,0,41
24593,2132,26,2106,1731,291,5,15,0,2
24594,1595,31,1564,1177,325,4,3,0,2
24595,522,46,476,391,45,3,18,0,0
24597,1171,32,1139,774,327,2,4,0,2
24598,1785,29,1756,1408,276,11,4,0,3
24599,621,25,596,455,119,3,0,0,1
24601,59,4,55,49,0,2,0,0,0
24602,787,6,781,750,3,1,0,0,1
24603,804,9,795,787,0,0,0,0,0
24604,167,1,166,155,8,0,0,0,0
24605,9104,199,8905,7910,530,12,102,8,35
24606,158,2,156,143,2,0,0,0,0
24607,322,2,320,314,1,0,0,0,1
24609,6620,53,6567,6373,16,5,19,5,7
24612,293,6,287,261,2,0,7,0,1
24613,849,18,831,797,2,0,2,0,5
24614,7252,48,7204,6908,155,3,19,1,3
24620,2208,7,2201,2175,3,0,1,0,0
24622,987,7,980,956,2,3,0,0,0
24630,5971,52,5919,5595,102,4,21,1,6
24631,2578,63,2515,2026,441,1,6,0,3
24634,446,3,443,430,0,2,1,0,0
24635,766,13,753,657,73,0,0,0,0
24637,3302,27,3275,3160,24,5,13,0,2
24639,3099,23,3076,2963,11,4,9,0,7
24641,5377,43,5334,5105,29,10,23,1,11
24646,607,5,602,600,0,1,0,0,0
24649,2242,6,2236,2191,2,3,2,0,0
24651,5976,70,5906,5449,174,12,30,0,15
24656,2875,18,2857,2797,4,4,13,0,2
24657,258,3,255,242,0,1,0,0,0
24701,19137,223,18914,15478,2421,74,52,1,59
24712,2174,25,2149,1933,112,5,32,3,1
24714,323,1,322,315,0,0,1,0,0
24715,359,3,356,327,5,1,1,0,0
24716,317,6,311,294,5,1,0,0,0
24719,154,0,154,152,0,0,0,0,2
24724,158,0,158,142,8,0,1,0,2
24726,610,4,606,583,0,0,0,0,0
24729,172,0,172,162,3,1,0,0,0
24731,202,1,201,194,2,1,1,0,0
24733,314,3,311,307,0,0,0,0,0
24736,592,3,589,552,0,0,4,0,0
24737,1314,3,1311,1248,20,0,1,0,1
24738,11,0,11,11,0,0,0,0,0
24739,13670,142,13528,12596,349,25,60,0,23
24740,16238,261,15977,14235,760,41,135,2,50
24747,2734,16,2718,2608,7,8,2,0,1
24801,5143,331,4812,3544,1107,8,10,0,19
24808,444,1,443,388,18,3,0,0,2
24811,685,3,682,641,5,0,0,0,3
24813,262,1,261,252,1,0,0,0,0
24815,315,1,314,271,22,0,0,1,2
24816,184,4,180,174,6,0,0,0,0
24817,1383,5,1378,1298,11,0,0,0,1
24818,1109,8,1101,1085,1,1,2,0,0
24822,1086,11,1075,1050,4,1,0,0,0
24823,317,1,316,309,2,0,0,0,0
24826,98,1,97,90,1,0,1,0,0
24827,1058,11,1047,1015,7,0,0,1,0
24828,602,2,600,562,9,0,0,0,0
24830,160,0,160,132,15,2,0,0,5
24831,265,5,260,175,78,0,0,0,0
24834,327,0,327,325,0,0,0,0,0
24836,522,2,520,369,131,0,1,0,2
24839,620,8,612,599,1,3,0,0,1
24843,104,0,104,100,1,0,0,0,0
24844,1585,7,1578,1532,4,1,0,0,1
24845,525,1,524,518,0,2,0,0,0
24846,316,1,315,309,0,0,0,0,0
24847,259,0,259,249,1,0,0,0,0
24848,82,0,82,59,12,0,0,0,0
24849,278,2,276,270,2,3,0,0,0
24850,90,0,90,84,0,0,0,0,0
24851,324,4,320,319,0,0,0,0,0
24853,725,10,715,542,138,1,1,0,4
24854,860,8,852,834,2,0,0,0,1
24855,35,0,35,15,20,0,0,0,0
24857,1443,10,1433,1405,1,2,0,0,0
24860,536,2,534,512,0,0,0,0,0
24861,138,2,136,74,57,1,0,0,0
24862,588,0,588,583,0,0,0,0,2
24866,434,0,434,412,13,1,1,1,0
24867,364,3,361,333,2,0,0,0,4
24868,917,8,909,558,305,1,3,1,1
24869,470,1,469,466,0,0,0,0,0
24870,1852,7,1845,1784,4,4,2,0,0
24871,540,0,540,493,29,1,0,0,0
24872,799,3,796,783,2,0,0,0,1
24873,448,0,448,436,2,0,0,0,1
24874,2069,7,2062,1973,10,2,2,0,0
24878,382,0,382,337,27,1,0,0,0
24879,399,0,399,389,0,0,0,0,0
24880,248,0,248,246,1,0,0,0,0
24881,400,0,400,371,4,0,0,0,1
24882,501,0,501,497,0,0,0,0,0
24884,40,1,39,34,4,0,0,0,0
24887,43,0,43,38,4,0,0,0,0
24888,127,0,127,88,34,0,1,0,0
24892,1271,3,1268,1193,35,0,0,1,0
24894,470,0,470,448,16,1,1,0,0
24895,47,1,46,24,21,0,1,0,0
24898,330,2,328,314,3,0,0,0,0
24901,9145,207,8938,8216,264,14,114,1,31
24910,4519,121,4398,3857,306,13,26,0,12
24915,515,5,510,492,0,0,0,0,1
24916,412,3,409,394,0,1,4,0,1
24918,1625,10,1615,1561,12,0,0,0,6
24920,269,2,267,258,1,0,0,0,0
24924,465,1,464,453,1,2,0,0,0
24925,1042,16,1026,972,12,1,1,0,4
24927,369,9,360,335,3,2,0,0,0
24931,1508,14,1494,1451,8,1,3,0,0
24934,489,6,483,468,1,2,0,0,0
24935,512,8,504,481,5,1,0,0,2
24938,1477,15,1462,1434,4,5,1,0,0
24941,1000,6,994,968,5,7,0,0,3
24943,115,1,114,114,0,0,0,0,0
24944,448,6,442,415,0,2,2,0,6
24945,400,1,399,375,3,2,1,0,0
24946,1289,18,1271,1200,30,7,0,0,5
24951,1763,9,1754,1677,19,0,5,0,3
24954,3079,46,3033,2934,12,8,4,0,10
24957,538,14,524,495,2,0,1,0,1
24962,104,0,104,99,4,0,0,0,0
24963,3697,25,3672,3541,25,7,4,0,7
24966,1201,9,1192,1128,1,3,6,0,1
24970,3976,64,3912,3635,118,3,19,0,12
24974,203,7,196,191,2,1,0,0,2
24976,1008,8,1000,965,3,1,0,0,1
24977,465,6,459,423,2,2,0,1,0
24981,529,3,526,489,25,0,0,0,0
24983,1756,21,1735,1618,27,6,0,0,2
24984,145,2,143,138,2,0,0,0,1
24985,299,3,296,280,4,0,0,0,2
24986,4529,79,4450,3980,255,3,27,0,14
24991,451,2,449,424,4,1,2,0,0
24993,15,0,15,10,1,0,0,0,0
25002,62,2,60,53,3,2,0,0,0
25003,2272,31,2241,2146,5,7,6,0,8
25005,241,3,238,235,0,2,0,0,0
25007,538,1,537,522,5,1,0,0,0
25008,243,0,243,239,0,0,0,0,0
25009,1029,13,1016,972,3,2,1,0,0
25011,739,5,734,714,7,1,2,0,1
25015,4043,53,3990,3767,48,5,10,0,8
25019,538,6,532,509,0,7,0,0,1
25021,260,1,259,241,0,0,0,0,0
25022,87,1,86,79,6,0,0,0,0
25024,455,0,455,443,7,0,0,0,0
25025,139,1,138,127,0,0,0,0,1
25028,308,2,306,294,0,0,0,0,0
25030,394,4,390,370,0,0,2,0,0
25031,832,5,827,710,52,1,1,0,4
25033,2117,27,2090,1989,6,4,1,0,5
25035,964,9,955,888,7,1,5,0,0
25036,318,0,318,277,26,0,0,0,2
25039,921,3,918,860,7,1,1,0,4
25040,478,3,475,440,7,1,2,0,0
25043,1247,14,1233,1169,2,4,6,0,0
25044,221,2,219,212,0,1,0,0,0
25045,4770,30,4740,4533,12,9,10,2,7
25047,281,2,279,259,7,1,0,0,1
25048,282,5,277,266,0,3,0,0,1
25049,705,9,696,681,3,0,0,0,1
25051,170,1,169,160,0,0,0,0,0
25053,4227,17,4210,4027,10,10,6,0,4
25054,225,0,225,212,3,0,1,0,0
25057,264,1,263,202,43,0,1,0,3
25059,424,4,420,403,0,4,0,0,1
25060,207,3,204,203,0,0,0,0,0
25061,681,1,680,649,3,1,0,0,7
25062,165,1,164,158,2,0,2,0,0
25063,1417,6,1411,1360,3,3,2,0,0
25064,9229,188,9041,6498,1768,25,118,4,34
25067,913,1,912,865,5,2,0,0,3
25070,1873,20,1853,1792,3,3,11,0,0
25071,10505,81,10424,10016,34,12,24,2,23
25075,602,7,595,562,9,1,0,0,2
25076,279,1,278,270,2,0,0,0,0
25081,1211,6,1205,1170,4,2,0,0,0
25082,1988,17,1971,1891,14,1,3,0,1
25083,475,4,471,440,6,0,3,0,0
25085,650,3,647,591,3,5,0,0,1
25086,792,0,792,746,6,1,1,0,10
25088,100,0,100,88,0,0,0,0,0
25090,238,2,236,220,3,5,0,0,1
25093,159,0,159,157,1,0,0,0,0
25102,265,4,261,219,19,0,0,1,1
25103,358,4,354,317,12,0,2,0,0
25106,518,2,516,504,2,0,3,0,0
25107,552,3,549,521,3,1,0,0,3
25108,599,0,599,584,2,0,1,0,0
25109,527,4,523,500,0,0,0,0,1
25110,436,4,432,393,11,1,0,0,0
25111,480,3,477,453,3,3,0,0,0
25112,245,8,237,105,125,0,2,0,0
25113,763,4,759,727,2,5,0,0,0
25114,530,11,519,487,1,0,0,0,4
25115,77,0,77,67,6,0,0,0,1
25118,474,6,468,404,48,0,0,0,3
25119,367,5,362,337,8,0,2,0,1
25121,899,6,893,876,4,0,0,0,4
25123,3287,24,3263,3148,11,6,4,1,0
25124,1219,3,1216,1187,0,2,0,0,3
25125,878,2,876,848,3,4,0,0,0
25126,170,0,170,130,33,0,0,0,0
25130,3437,13,3424,3186,69,6,24,0,5
25132,273,2,271,266,2,0,0,0,0
25133,711,4,707,691,0,1,0,0,0
25134,494,3,491,480,0,0,0,0,0
25136,1366,24,1342,1019,203,4,22,0,13
25139,245,3,242,224,7,1,0,0,0
25140,939,13,926,874,2,4,0,0,5
25141,218,6,212,207,0,3,0,0,0
25142,345,8,337,320,1,0,0,1,1
25143,8792,195,8597,7746,306,37,43,1,40
25148,314,2,312,298,4,1,0,0,0
25149,245,2,243,232,2,0,0,0,0
25152,306,1,305,278,14,0,0,0,0
25154,778,5,773,756,0,2,0,0,0
25156,59,2,57,56,1,0,0,0,0
25159,4777,36,4741,4532,44,9,5,0,10
25160,238,3,235,228,0,0,0,0,0
25161,489,2,487,436,26,0,2,0,1
25162,483,1,482,447,4,1,1,0,3
25164,1136,4,1132,1073,0,2,1,0,0
25165,566,6,560,531,3,0,1,1,0
25168,2280,17,2263,2163,3,3,14,0,6
25169,395,1,394,380,0,0,0,0,0
25173,304,7,297,225,49,1,1,0,2
25174,408,3,405,388,2,4,0,0,1
25177,22870,312,22558,20283,942,45,107,4,93
25180,103,1,102,101,0,0,0,0,0
25181,1503,0,1503,1463,1,8,1,0,0
25183,83,0,83,80,0,0,0,0,0
25185,1093,14,1079,925,147,0,1,0,5
25186,756,9,747,664,35,0,0,0,4
25187,690,6,684,662,1,0,0,0,0
25193,311,1,310,289,4,2,1,0,0
25201,111,0,111,110,0,0,0,0,0
25202,1445,12,1433,1355,10,4,0,0,3
25203,107,0,107,94,0,0,0,0,1
25204,166,0,166,153,0,1,0,0,2
25205,246,3,243,227,0,0,0,0,0
25206,305,6,299,285,3,0,0,0,0
25208,779,2,777,747,2,2,0,0,0
25209,953,11,942,916,0,3,1,0,1
25211,109,0,109,108,0,0,0,0,0
25213,6214,78,6136,5735,89,7,53,0,16
25214,477,3,474,445,2,2,0,0,0
25231,78,1,77,74,2,0,0,0,0
25234,939,5,934,908,0,2,1,0,1
25235,983,5,978,945,2,0,1,2,0
25239,1674,8,1666,1595,3,1,8,0,5
25241,1668,6,1662,1580,3,5,3,0,2
25243,924,7,917,872,6,1,0,0,0
25244,680,8,672,647,0,1,0,0,0
25245,916,5,911,870,9,0,6,0,2
25247,487,2,485,452,2,0,0,0,2
25248,2849,22,2827,2713,14,5,11,0,7
25251,491,5,486,473,0,0,0,0,0
25252,1089,10,1079,1034,1,2,5,0,0
25253,1943,10,1933,1889,7,2,3,0,0
25259,770,7,763,723,0,6,1,0,0
25260,1404,15,1389,1296,5,3,12,0,9
25261,254,2,252,245,1,3,1,0,0
25262,771,10,761,734,2,0,1,0,2
25264,404,4,400,383,0,0,0,0,3
25265,1457,11,1446,1398,12,5,3,0,0
25266,658,7,651,614,2,4,1,0,0
25267,658,6,652,625,0,1,1,0,0
25268,593,1,592,581,1,0,1,0,0
25270,849,7,842,807,0,1,5,0,0
25271,8893,53,8840,8515,23,10,30,1,26
25275,2087,14,2073,2031,5,2,1,0,1
25276,7226,99,7127,6796,22,10,28,0,9
25285,703,2,701,675,0,0,2,0,0
25286,1407,10,1397,1335,0,0,2,0,0
25287,1376,6,1370,1311,36,1,2,0,2
25301,2908,85,2823,1884,619,13,70,2,22
25302,14307,251,14056,10607,2381,45,93,7,95
25303,6946,127,6819,5771,534,14,70,3,33
25304,8466,170,8296,6770,717,12,308,2,47
25305,8,1,7,4,1,0,0,0,0
25306,6493,71,6422,5382,614,6,62,0,27
25309,13146,221,12925,11196,883,21,210,4,57
25311,9487,179,9308,7215,1395,30,118,2,40
25312,8823,88,8735,8255,147,8,25,1,10
25313,12546,235,12311,10820,738,13,144,1,39
25314,14673,246,14427,12382,585,13,664,7,73
25315,3016,42,2974,2731,121,7,6,1,4
25320,5447,43,5404,5187,15,11,13,0,10
25387,5215,95,5120,3478,1205,18,20,3,31
25401,15086,1183,13903,10462,2096,48,170,3,72
25403,15316,931,14385,12167,990,29,318,4,35
25404,23034,1521,21513,17019,2415,64,288,7,113
25405,14294,872,13422,10980,1254,35,123,5,94
25411,12367,184,12183,11515,70,24,58,0,47
25413,9299,460,8839,7761,445,20,95,7,34
25414,19541,1769,17772,14766,1447,30,332,6,108
25419,11781,460,11321,9781,677,18,163,6,41
25420,4402,116,4286,3965,60,7,29,0,2
25421,31,1,30,24,1,0,0,0,1
25422,1634,22,1612,1550,6,2,6,0,1
25425,13389,687,12702,11508,318,21,117,1,70
25427,16219,424,15795,14454,363,41,101,4,74
25428,12749,790,11959,10518,587,19,117,7,38
25430,8343,454,7889,6786,522,19,95,0,45
25431,322,6,316,283,2,0,2,0,3
25432,100,9,91,83,1,0,0,0,0
25434,2382,34,2348,2191,18,5,9,0,1
25437,519,6,513,500,0,0,3,0,1
25438,7090,868,6222,4716,713,16,190,0,46
25442,2080,134,1946,1726,66,3,30,0,9
25443,7852,317,7535,6491,499,14,90,1,34
25444,498,10,488,466,3,0,3,1,1
25446,1373,56,1317,1182,64,5,20,2,4
25501,1092,7,1085,1046,8,2,2,0,1
25502,1062,8,1054,1042,0,0,1,0,0
25503,807,7,800,785,1,0,0,0,0
25504,12972,139,12833,11916,205,14,186,0,23
25505,376,1,375,363,1,0,0,0,0
25506,5019,31,4988,4831,17,9,8,0,2
25507,1102,29,1073,1022,9,1,0,1,1
25508,8930,66,8864,8594,21,10,27,0,8
25510,5191,69,5122,4892,31,4,23,0,7
25511,922,4,918,898,0,0,0,0,2
25512,1066,5,1061,1024,0,5,0,1,1
25514,3950,13,3937,3844,9,1,0,0,4
25515,2062,13,2049,1982,8,2,4,0,0
25517,1810,15,1795,1752,1,0,0,2,6
25520,1443,18,1425,1361,1,6,6,0,0
25521,1019,5,1014,991,2,2,0,0,2
25523,2620,9,2611,2530,6,1,0,0,2
25524,3437,29,3408,3358,2,0,9,0,4
25526,22578,330,22248,20662,332,24,312,6,72
25529,915,13,902,859,15,1,1,0,0
25530,5721,45,5676,5468,18,11,9,0,8
25534,174,1,173,167,1,0,0,0,1
25535,2249,12,2237,2147,6,7,10,0,0
25537,1818,14,1804,1746,9,3,2,0,0
25540,285,8,277,275,1,0,0,0,0
25541,9364,99,9265,8899,42,10,43,0,18
25544,48,1,47,46,1,0,0,0,0
25545,4682,32,4650,4409,25,4,62,2,7
25547,545,4,541,525,3,0,2,0,2
25550,8432,55,8377,7995,97,14,42,4,7
25555,2073,11,2062,1999,1,1,8,0,0
25557,1320,18,1302,1264,5,0,0,0,0
25559,2095,14,2081,2027,2,9,4,0,5
25560,9215,175,9040,8400,92,16,167,1,28
25564,1213,15,1198,1162,1,1,3,0,0
25565,668,5,663,628,2,4,2,0,2
25567,894,6,888,866,0,0,1,0,1
25570,5898,34,5864,5661,23,5,13,3,10
25571,1999,9,1990,1944,2,3,2,0,0
25573,798,6,792,778,0,1,1,0,2
25601,4642,33,4609,4262,146,7,13,0,3
25606,1060,7,1053,992,29,5,0,0,5
25607,846,10,836,787,16,1,0,0,0
25608,1000,7,993,988,1,0,0,0,0
25611,689,0,689,660,2,0,0,0,1
25612,219,0,219,214,1,0,0,0,0
25617,250,0,250,239,2,0,0,0,1
25621,2104,8,2096,2061,1,0,0,0,2
25624,396,6,390,366,1,0,0,0,0
25625,1528,20,1508,1390,83,1,2,0,1
25628,478,1,477,428,22,3,0,0,0
25630,523,4,519,506,4,0,0,0,0
25632,740,2,738,717,4,1,0,0,0
25634,1457,11,1446,1399,12,0,1,0,0
25635,1203,7,1196,1147,18,1,6,0,1
25637,983,7,976,881,65,0,3,0,0
25638,758,3,755,687,33,4,0,0,2
25639,579,5,574,560,2,0,3,0,0
25644,441,1,440,409,19,0,1,0,2
25646,677,1,676,634,13,1,0,0,1
25647,608,3,605,564,16,1,1,0,1
25649,1273,4,1269,1253,1,0,0,0,0
25650,96,1,95,88,0,0,0,0,0
25651,969,4,965,930,9,0,1,0,0
25652,1472,12,1460,1384,37,5,2,1,0
25653,228,0,228,212,9,0,0,0,0
25654,139,1,138,135,0,0,0,0,0
25661,5162,43,5119,4568,292,18,23,0,12
25666,198,2,196,183,1,0,1,0,0
25667,545,1,544,532,2,0,0,0,1
25669,689,3,686,673,1,0,3,0,2
25670,3417,22,3395,3284,8,5,2,0,6
25671,1450,9,1441,1400,6,1,0,0,3
25672,266,4,262,245,11,0,0,0,1
25674,2656,21,2635,2571,6,2,1,0,1
25676,1126,11,1115,1090,1,0,0,0,1
25678,1108,4,1104,1047,19,2,2,0,1
25685,527,4,523,521,0,0,0,0,1
25688,376,3,373,341,15,1,2,0,0
25690,489,1,488,470,1,0,0,0,0
25692,1231,5,1226,1157,31,4,0,0,0
25696,1290,10,1280,1239,1,0,0,0,5
25699,130,2,128,122,0,0,0,0,0
25701,22342,417,21925,18388,1909,39,380,10,85
25702,7223,132,7091,6324,300,30,51,5,12
25703,4950,142,4808,3375,868,24,160,1,30
25704,14975,206,14769,13717,289,38,47,3,40
25705,20552,401,20151,17731,967,21,382,1,92
25755,1602,57,1545,1253,223,5,26,1,1
25801,31369,605,30764,24433,4033,52,573,14,92
25810,80,0,80,67,9,0,1,0,1
25811,148,0,148,136,9,1,0,0,0
25812,1589,11,1578,1513,10,2,2,0,2
25813,7017,203,6814,5337,1242,18,17,0,13
25817,514,4,510,496,0,0,0,0,0
25818,486,14,472,435,16,0,2,0,2
25820,450,7,443,417,0,1,0,0,0
25823,1044,5,1039,1008,1,0,0,0,2
25825,2045,13,2032,1978,2,3,2,0,0
25826,345,2,343,335,0,0,0,0,1
25827,2077,20,2057,1967,16,1,6,0,3
25831,1464,5,1459,1405,5,1,3,0,1
25832,4487,71,4416,4114,56,11,80,0,6
25836,813,12,801,760,4,1,3,1,0
25837,380,0,380,361,0,0,0,0,0
25839,974,5,969,937,0,4,3,0,0
25840,7290,130,7160,6773,107,15,16,0,11
25841,536,3,533,514,1,0,0,0,0
25843,936,8,928,884,0,0,3,0,0
25844,1219,7,1212,1173,3,2,3,0,0
25845,674,5,669,658,0,2,0,0,1
25846,124,3,121,81,28,1,0,0,1
25848,329,36,293,276,6,0,0,0,0
25849,263,0,263,229,21,0,0,0,0
25851,51,0,51,48,2,0,0,0,0
25853,224,1,223,215,3,0,0,0,0
25854,867,3,864,851,0,1,1,0,1
25855,340,2,338,301,15,0,0,1,0
25857,167,0,167,166,1,0,0,0,0
25862,244,2,242,232,0,1,0,0,1
25864,119,5,114,92,3,1,2,0,0
25865,1649,7,1642,1535,51,3,0,0,1
25866,322,3,319,303,3,0,0,0,0
25868,408,2,406,396,0,1,0,0,0
25870,215,1,214,203,2,2,0,0,0
25871,922,6,916,807,65,3,2,0,0
25873,582,10,572,537,11,1,7,0,0
25875,567,3,564,551,2,0,0,0,0
25876,67,1,66,65,1,0,0,0,0
25878,1192,13,1179,1121,8,1,5,0,2
25879,203,6,197,167,5,0,4,0,5
25880,5340,95,5245,4486,393,7,53,1,19
25882,1746,16,1730,1624,36,4,1,0,3
25901,10338,210,10128,8928,562,43,44,0,15
25902,362,2,360,343,0,0,3,0,0
25904,675,2,673,648,3,0,0,0,0
25907,120,0,120,116,0,0,0,0,0
25908,82,0,82,82,0,0,0,0,0
25909,494,9,485,426,11,1,10,0,1
25911,250,5,245,210,18,2,0,0,0
25913,284,4,280,272,0,2,0,0,0
25915,275,4,271,250,5,2,2,0,0
25916,117,1,116,112,2,0,0,0,1
25917,1887,18,1869,1678,92,4,1,0,12
25918,4517,40,4477,4280,31,4,18,0,15
25920,211,4,207,186,0,1,3,0,0
25921,2663,26,2637,2490,35,1,13,0,3
25922,212,1,211,202,4,2,0,0,1
25928,405,5,400,379,0,0,0,0,5
25932,224,2,222,211,1,0,0,0,1
25936,34,0,34,31,0,0,0,0,1
25938,1403,9,1394,1348,0,3,0,0,10
25942,176,2,174,172,0,0,0,0,0
25943,39,1,38,30,2,0,2,0,0
25951,5024,50,4974,4616,96,12,12,0,16
25958,633,3,630,596,3,4,0,0,1
25962,3273,64,3209,3056,25,6,5,1,12
25966,123,1,122,118,0,0,0,0,0
25969,1177,9,1168,1106,5,4,5,0,1
25971,1072,13,1059,1023,2,0,3,0,0
25972,352,3,349,335,4,0,0,0,0
25976,2035,12,2023,1951,4,5,2,0,3
25977,62,1,61,58,0,0,0,0,0
25978,609,0,609,580,3,1,0,0,0
25979,744,20,724,672,0,5,0,0,1
25981,738,10,728,697,6,3,0,1,0
25984,1650,24,1626,1529,23,5,1,1,5
25985,384,6,378,368,0,1,0,0,1
25986,362,0,362,352,0,0,0,0,1
25989,319,4,315,289,1,1,9,0,0
26003,40591,609,39982,35894,1589,55,355,19,129
26030,553,3,550,521,1,2,2,0,2
26031,1790,24,1766,1632,33,0,9,0,0
26032,994,26,968,812,123,2,5,0,1
26033,2597,22,2575,2483,4,6,2,0,1
26034,4451,48,4403,4218,23,3,21,2,6
26035,2295,39,2256,2132,7,1,3,0,6
26036,437,6,431,409,0,1,0,0,0
26037,6365,73,6292,5923,41,5,4,0,24
26038,2793,47,2746,2629,13,5,14,0,5
26039,847,6,841,828,0,1,0,0,0
26040,1767,20,1747,1648,14,0,9,0,4
26041,15147,185,14962,14148,166,19,52,6,46
26047,5718,50,5668,5366,19,5,8,2,11
26050,1334,36,1298,1238,7,3,3,0,4
26055,1516,16,1500,1444,1,0,4,0,0
26056,309,2,307,289,0,0,0,0,1
26058,59,0,59,52,2,0,0,0,0
26059,3164,39,3125,2980,38,4,27,1,4
26060,1616,18,1598,1483,0,6,7,1,5
26062,21116,346,20770,18807,758,23,111,4,60
26070,7820,82,7738,7319,73,24,7,0,21
26074,1324,13,1311,1194,58,3,16,0,12
26075,495,4,491,471,6,0,1,0,0
26101,28337,465,27872,25710,528,64,113,5,89
26104,16763,300,16463,15328,220,25,145,5,57
26105,12247,188,12059,11080,159,16,225,7,27
26133,1395,8,1387,1359,0,0,1,0,1
26134,749,14,735,692,4,2,2,0,0
26136,426,3,423,407,2,1,1,0,0
26137,811,8,803,772,3,1,4,0,0
26138,134,1,133,133,0,0,0,0,0
26141,392,0,392,377,0,0,1,0,0
26142,2455,33,2422,2299,13,9,13,0,2
26143,4037,23,4014,3848,10,4,1,4,7
26146,1100,9,1091,1023,3,1,0,0,0
26147,1711,15,1696,1649,4,4,2,0,0
26148,158,2,156,151,0,0,0,0,0
26149,2140,2,2138,2088,0,4,1,0,0
26150,5811,56,5755,5527,27,11,25,0,5
26151,467,10,457,440,0,2,0,0,1
26152,129,0,129,125,0,0,0,0,1
26155,8095,101,7994,7678,25,15,44,0,8
26159,2598,23,2575,2452,3,7,5,0,1
26160,900,3,897,876,0,0,0,0,0
26161,374,7,367,355,0,0,0,0,0
26162,39,0,39,31,0,0,0,0,0
26164,7674,94,7580,7177,44,18,28,1,15
26167,738,5,733,709,0,0,0,0,0
26169,772,4,768,748,0,2,1,0,0
26170,6296,49,6247,5943,86,19,15,0,10
26175,3077,22,3055,2939,3,2,2,0,12
26178,402,0,402,393,3,0,0,0,0
26180,2199,20,2179,2078,4,2,2,0,4
26181,5938,30,5908,5698,18,4,12,0,12
26184,2237,16,2221,2114,15,3,3,0,5
26187,6209,48,6161,5856,31,12,23,0,7
26201,19008,277,18731,17744,209,36,80,4,18
26202,568,1,567,565,0,0,0,0,0
26203,341,1,340,326,1,2,0,1,2
26205,3337,20,3317,3196,12,7,3,0,1
26206,2623,17,2606,2543,3,1,0,1,4
26208,850,3,847,820,1,0,0,0,0
26209,203,6,197,188,2,0,3,0,1
26210,95,0,95,90,0,0,0,0,0
26215,132,0,132,130,0,0,0,0,0
26217,286,5,281,280,0,0,0,0,0
26218,2680,21,2659,2564,1,1,3,1,6
26222,477,3,474,464,0,0,0,1,0
26224,176,2,174,164,0,1,1,0,0
26228,110,3,107,101,0,0,0,0,0
26230,90,1,89,83,0,0,0,0,0
26234,1122,6,1116,1088,1,0,0,0,4
26236,48,0,48,44,1,0,0,0,0
26237,574,2,572,554,0,0,3,0,0
26238,796,8,788,774,2,0,0,0,1
26241,13931,192,13739,12822,222,30,84,1,41
26250,5448,61,5387,5187,13,14,4,0,6
26253,3229,26,3203,3091,12,12,5,0,3
26254,346,4,342,321,0,0,0,0,0
26257,701,3,698,664,3,0,1,0,1
26259,316,2,314,308,1,2,0,0,0
26260,1261,16,1245,1197,5,0,4,0,0
26261,2300,6,2294,2215,14,2,4,0,1
26263,405,6,399,380,2,2,0,0,0
26264,540,6,534,526,0,0,0,0,1
26266,239,4,235,227,0,0,0,0,1
26267,556,7,549,516,1,1,2,0,0
26268,41,2,39,36,1,0,0,0,1
26269,1001,3,998,969,1,2,0,0,0
26270,666,7,659,637,0,0,0,0,6
26271,239,1,238,224,1,0,1,1,0
26273,1964,15,1949,1754,164,2,0,0,10
26275,609,3,606,587,0,0,1,0,0
26276,398,3,395,364,2,3,1,0,2
26278,600,3,597,566,2,0,0,0,0
26280,1490,13,1477,1421,3,2,0,0,6
26282,146,0,146,135,1,2,0,0,3
26283,1655,10,1645,1559,2,1,2,0,6
26285,492,1,491,462,7,0,2,0,0
26287,2924,25,2899,2786,8,0,1,0,6
26288,3439,18,3421,3299,5,13,3,0,0
26289,57,0,57,52,1,0,0,0,0
26291,174,0,174,163,1,0,0,0,1
26292,806,5,801,776,0,0,0,0,0
26293,540,6,534,515,2,0,0,0,1
26294,537,1,536,527,0,0,0,0,3
26296,123,0,123,121,0,2,0,0,0
26298,67,0,67,63,0,0,1,0,0
26301,28586,692,27894,25479,764,60,121,20,81
26320,719,6,713,692,0,0,0,0,0
26321,332,4,328,317,1,0,0,0,0
26323,371,9,362,323,5,2,3,0,0
26325,255,1,254,250,0,0,2,0,0
26327,56,0,56,52,1,0,0,0,0
26330,15887,369,15518,14371,143,31,317,3,31
26335,1100,12,1088,1051,1,1,2,1,2
26337,1006,5,1001,971,1,5,2,1,0
26338,638,3,635,609,0,0,0,0,0
26339,206,0,206,195,0,4,1,0,0
26342,464,2,462,439,1,1,0,0,0
26343,538,1,537,524,0,0,0,0,0
26346,675,3,672,656,0,0,1,0,0
26347,2353,17,2336,2240,14,3,3,0,2
26348,206,1,205,201,0,0,0,0,0
26349,181,1,180,170,1,0,1,0,0
26351,4264,221,4043,3012,920,7,25,0,1
26354,10421,120,10301,9739,88,11,24,0,18
26361,204,2,202,195,0,0,0,0,0
26362,2919,34,2885,2811,8,0,10,3,4
26366,85,0,85,82,0,0,0,0,0
26369,596,14,582,546,7,3,0,0,0
26372,702,11,691,662,2,0,1,0,0
26374,1464,19,1445,1360,3,2,10,0,1
26376,467,2,465,447,1,4,0,0,0
26377,584,6,578,552,0,0,0,0,1
26378,4246,53,4193,4040,8,10,5,3,5
26384,396,4,392,377,0,1,0,0,0
26385,3380,61,3319,3189,10,6,10,1,7
26386,1973,11,1962,1856,3,7,2,0,3
26404,222,10,212,199,0,1,0,0,0
26405,1155,7,1148,1083,0,1,2,0,0
26408,2745,46,2699,2591,26,2,4,0,3
26410,983,7,976,912,3,0,1,0,5
26411,703,5,698,682,2,0,0,0,0
26412,569,2,567,538,1,0,0,1,0
26415,3598,29,3569,3358,113,1,6,3,10
26416,7026,135,6891,6317,245,20,23,0,9
26419,761,5,756,729,1,0,0,0,0
26421,232,7,225,212,0,1,0,0,0
26422,332,3,329,305,2,0,0,0,0
26424,199,2,197,192,0,0,0,0,0
26425,994,8,986,953,1,2,0,0,1
26426,6849,122,6727,6320,137,14,24,0,14
26430,396,2,394,382,2,0,0,0,0
26431,5759,66,5693,5352,59,6,15,3,9
26435,87,1,86,77,0,0,1,0,0
26436,165,0,165,161,0,0,0,0,0
26437,419,1,418,410,1,0,0,0,1
26438,244,6,238,223,0,1,0,0,2
26440,1243,7,1236,1178,1,2,1,0,1
26443,229,4,225,217,0,0,1,0,0
26444,3228,12,3216,3107,11,3,0,0,1
26447,1174,9,1165,1114,0,1,3,1,0
26448,1154,21,1133,1076,4,8,1,0,1
26451,449,4,445,432,1,2,3,0,0
26452,9861,121,9740,9275,54,8,53,3,23
26456,3134,31,3103,2959,5,7,6,0,5
26463,412,0,412,398,1,0,0,0,0
26501,19200,592,18608,16271,993,44,214,8,65
26505,39057,1613,37444,30596,2036,56,2529,43,184
26506,1328,61,1267,1084,64,0,8,0,10
26508,36907,915,35992,32438,818,35,941,9,101
26519,1825,20,1805,1742,4,2,0,1,3
26520,791,7,784,757,2,2,2,0,0
26521,242,1,241,226,0,0,0,0,1
26524,172,1,171,169,0,0,0,0,0
26525,8542,468,8074,5913,1912,47,24,2,0
26534,868,31,837,699,56,1,3,0,6
26537,5498,58,5440,5202,27,4,13,1,3
26541,3337,56,3281,3003,63,6,20,0,10
26542,2439,20,2419,2294,11,2,3,2,5
26543,122,1,121,98,18,0,0,1,0
26544,135,1,134,126,0,1,0,1,0
26546,114,0,114,106,3,0,1,0,0
26547,2626,22,2604,2506,6,0,4,0,2
26554,42133,738,41395,37037,1684,89,244,40,97
26559,1369,15,1354,1270,25,4,2,0,3
26560,165,3,162,151,1,1,0,0,0
26562,621,4,617,603,1,0,0,0,0
26563,380,3,377,307,41,0,0,2,0
26568,467,5,462,443,2,0,0,1,0
26570,3278,18,3260,3169,9,2,0,0,2
26571,1800,26,1774,1688,18,0,3,0,3
26572,422,1,421,416,1,0,0,0,0
26574,672,4,668,606,30,2,0,1,0
26575,574,7,567,531,0,2,0,0,0
26576,601,9,592,570,4,1,0,0,0
26581,822,5,817,773,4,1,1,0,0
26582,4597,68,4529,4342,8,9,7,0,11
26585,523,1,522,506,0,0,0,0,1
26586,88,0,88,75,0,0,1,0,0
26587,290,1,289,278,3,1,4,0,0
26588,2758,17,2741,2560,22,9,2,0,1
26590,702,3,699,684,0,0,0,0,0
26591,1320,9,1311,1229,18,3,3,0,4
26601,4220,31,4189,4006,34,4,10,7,8
26610,1095,11,1084,1045,2,1,4,0,1
26611,214,1,213,206,0,0,0,0,0
26615,165,0,165,164,0,0,0,0,0
26617,231,2,229,214,0,1,0,0,0
26619,558,1,557,538,2,0,3,1,4
26621,694,5,689,669,0,1,0,0,0
26623,1048,8,1040,1016,1,0,1,0,0
26624,2507,17,2490,2421,2,2,5,0,1
26627,368,2,366,356,3,5,0,0,0
26629,407,1,406,395,0,0,0,1,0
26631,217,2,215,200,1,0,0,0,0
26636,363,4,359,349,1,0,1,0,0
26638,222,0,222,217,0,0,1,0,0
26651,8774,83,8691,8326,20,16,47,6,6
26656,474,5,469,451,3,1,0,0,0
26660,330,0,330,310,0,2,0,0,0
26662,658,5,653,632,0,0,2,0,0
26667,95,0,95,95,0,0,0,0,0
26671,309,2,307,298,0,0,0,0,0
26676,409,5,404,396,0,0,0,0,0
26678,1203,2,1201,1167,1,0,1,0,4
26679,1753,10,1743,1683,3,2,5,0,0
26680,441,1,440,415,0,0,1,0,1
26681,1860,11,1849,1796,3,5,5,0,0
26684,179,1,178,173,2,0,0,0,0
26690,468,2,466,436,1,3,2,0,0
26691,468,3,465,441,3,2,0,0,2
26704,5532,62,5470,5247,32,3,15,0,22
26705,959,4,955,940,1,0,0,0,1
26707,226,0,226,211,0,3,1,0,1
26710,1967,23,1944,1863,16,0,3,1,0
26711,2527,53,2474,2350,12,0,9,0,7
26714,565,10,555,505,1,5,0,0,4
26716,656,8,648,634,5,0,0,0,0
26717,1063,14,1049,1014,5,0,1,0,1
26719,2375,24,2351,2262,3,4,3,0,1
26720,186,0,186,180,0,0,0,0,0
26722,702,9,693,661,3,2,3,0,4
26726,13137,174,12963,11707,500,25,78,4,29
26731,253,0,253,250,0,0,0,0,0
26739,749,2,747,724,5,0,2,0,5
26743,1436,4,1432,1394,4,1,2,0,1
26750,726,13,713,504,133,1,1,0,3
26753,5991,49,5942,5647,45,7,23,0,16
26755,571,12,559,529,2,0,0,0,1
26757,6218,94,6124,5767,86,16,15,1,25
26761,637,5,632,616,4,0,0,0,1
26763,1577,29,1548,1481,17,0,5,2,1
26764,4085,50,4035,3888,18,5,4,0,16
26767,644,2,642,612,4,0,1,0,0
26801,1304,10,1294,1247,11,0,7,0,2
26802,937,15,922,884,13,0,0,0,3
26804,480,3,477,468,0,2,0,0,0
26807,2426,19,2407,2290,49,3,0,0,10
26808,814,13,801,775,8,2,0,0,1
26810,372,1,371,360,1,2,0,0,1
26812,1791,33,1758,1699,3,0,0,0,5
26814,407,6,401,393,3,0,0,0,0
26815,581,5,576,546,10,0,0,0,0
26817,403,2,401,385,1,0,0,0,0
26818,986,25,961,919,7,1,1,0,0
26823,150,2,148,140,0,0,1,0,0
26833,2253,13,2240,2173,5,3,0,0,3
26836,6331,538,5793,5173,341,12,36,0,17
26838,48,1,47,47,0,0,0,0,0
26845,823,7,816,785,7,0,1,0,0
26847,6014,73,5941,5667,67,14,20,0,9
26851,2012,33,1979,1872,27,1,8,0,5
26852,931,8,923,895,9,0,0,0,0
26855,654,4,650,635,2,0,1,0,1
26865,448,7,441,423,2,0,0,0,3
26866,776,5,771,733,4,1,0,0,0
26884,271,0,271,265,0,0,0,1,0
26886,185,3,182,179,2,0,0,1,0
27006,14963,524,14439,13324,427,34,146,3,38
27007,2051,160,1891,1840,12,3,1,0,2
27009,2860,141,2719,2432,169,12,14,0,6
27011,5210,518,4692,4308,181,8,11,0,10
27012,29954,1803,28151,23900,1952,57,1027,14,91
27013,6257,475,5782,4656,740,32,43,1,11
27014,798,62,736,591,71,1,2,0,1
27016,1693,36,1657,1600,28,2,4,0,0
27017,8976,2076,6900,6445,147,25,45,1,11
27018,7550,571,6979,6559,165,5,24,0,17
27019,3768,132,3636,3378,96,11,13,1,9
27020,6168,834,5334,5059,100,11,18,1,9
27021,17345,691,16654,15623,260,54,111,3,42
27022,1399,43,1356,1315,11,5,2,0,0
27023,13214,623,12591,10942,631,32,463,1,27
27024,2589,120,2469,2382,13,3,0,0,5
27025,10769,494,10275,8613,1157,48,58,3,33
27027,4006,184,3822,3313,336,4,15,0,10
27028,26479,2767,23712,20487,1890,57,130,2,83
27030,36995,4443,32552,29389,1709,74,232,7,80
27040,12409,773,11636,9490,1342,31,325,6,40
27041,7501,359,7142,6567,230,15,32,0,23
27042,664,26,638,541,56,5,1,1,0
27043,6322,186,6136,5748,139,8,12,0,8
27045,9548,987,8561,6128,1900,28,63,5,55
27046,1977,91,1886,1794,26,2,9,0,0
27047,1169,69,1100,1051,3,3,1,0,4
27048,7910,661,7249,6139,826,5,14,1,22
27050,3929,170,3759,3390,198,0,20,0,9
27051,8195,737,7458,5739,1302,34,34,4,21
27052,9861,241,9620,8295,911,35,13,6,14
27053,2883,40,2843,2609,108,16,0,0,4
27054,2602,232,2370,1931,303,7,7,3,4
27055,14109,2030,12079,11177,352,35,63,0,29
27101,21654,2654,19000,8654,8942,45,401,1,93
27103,36023,5033,30990,20159,7593,73,1510,7,178
27104,30533,2204,28329,21764,3982,47,1354,7,122
27105,39977,8700,31277,7020,22527,141,201,24,149
27106,49115,6789,42326,26806,11629,92,1632,132,277
27107,49834,11853,37981,22574,12988,135,383,15,198
27109,3120,225,2895,2260,277,3,231,1,10
27110,2138,59,2079,21,2009,11,5,0,3
27127,39809,7439,32370,18792,10909,118,822,13,187
27201,93,1,92,89,2,0,1,0,0
27202,41,1,40,39,1,0,0,0,0
27203,21869,6920,14949,10700,2945,109,316,3,76
27205,33562,4822,28740,25909,1359,90,284,0,83
27207,3724,215,3509,2922,418,16,11,0,4
27208,1790,66,1724,1586,59,2,2,3,3
27209,4016,1379,2637,1935,600,9,21,0,7
27212,2667,117,2550,1307,1167,16,11,0,2
27213,83,12,71,58,5,0,0,0,1
27214,12417,964,11453,6579,4144,53,144,5,41
27215,44620,5243,39377,27967,8245,136,1183,35,202
27217,39556,9578,29978,15941,12167,146,277,29,192
27229,3228,935,2293,1573,587,8,38,0,10
27231,1939,133,1806,1293,432,5,12,1,6
27233,3477,170,3307,3016,100,43,8,2,7
27235,4876,217,4659,3953,240,24,275,0,17
27239,8839,183,8656,8286,45,20,51,2,8
27242,1807,235,1572,1058,425,20,7,2,2
27243,4622,351,4271,3443,492,14,77,0,19
27244,16671,938,15733,13223,1521,38,312,2,64
27247,111,22,89,89,0,0,0,0,0
27248,4535,449,4086,3776,90,14,7,0,15
27249,13537,898,12639,9703,2166,45,121,0,53
27252,1584,73,1511,1148,277,5,3,0,3
27253,32010,4953,27057,19345,5699,117,449,8,141
27256,101,3,98,85,11,0,1,0,0
27258,7088,1170,5918,4476,980,47,113,1,21
27259,124,3,121,114,4,1,1,0,0
27260,24573,3879,20694,4114,13401,88,1998,8,159
27262,25253,3100,22153,13328,6528,106,1109,9,235
27263,21613,1979,19634,14007,2335,120,2445,3,64
27265,52530,4511,48019,28582,12455,169,4665,27,314
27268,1613,137,1476,1280,80,10,43,6,53
27278,28846,3256,25590,20089,3549,80,470,3,181
27281,3299,554,2745,2090,483,27,32,5,11
27282,15966,1038,14928,9957,2935,33,1277,5,65
27283,3056,76,2980,2773,72,14,14,2,11
27284,56859,5603,51256,40684,6804,180,1074,9,222
27288,23375,1582,21793,15574,5010,80,170,6,95
27291,1559,59,1500,1111,327,7,2,0,0
27292,39337,3750,35587,28165,5218,182,429,8,114
27295,39042,2308,36734,31967,2103,155,957,9,97
27298,10583,1044,9539,8199,840,61,38,3,45
27299,5057,496,4561,4145,149,20,19,3,11
27301,10752,880,9872,5353,3816,50,211,7,60
27302,33237,3256,29981,20547,6857,113,683,18,163
27305,1425,31,1394,629,710,2,2,0,0
27306,6399,165,6234,4307,1494,24,219,1,11
27310,8331,409,7922,6655,327,15,603,0,40
27311,3321,158,3163,2150,841,9,13,4,13
27312,21572,1383,20189,16582,2291,51,280,8,92
27313,6792,285,6507,5728,499,31,35,2,23
27314,1026,32,994,895,74,0,0,0,1
27315,1892,83,1809,1583,156,1,9,2,14
27316,6664,1023,5641,4585,711,32,44,1,21
27317,17563,2045,15518,13704,909,67,113,1,36
27320,37843,2630,35213,24345,9229,119,157,19,99
27325,5775,1271,4504,3903,390,19,24,0,14
27326,3679,136,3543,2753,619,7,12,1,20
27330,39489,8185,31304,21510,7593,123,456,31,144
27332,36020,6541,29479,21602,5467,171,401,46,172
27340,149,10,139,127,1,0,2,0,0
27341,5235,294,4941,4557,177,4,7,0,17
27342,39,1,38,15,15,0,3,0,0
27343,1656,52,1604,1027,504,10,4,0,4
27344,17834,5881,11953,8412,2745,27,118,3,94
27349,6308,510,5798,5142,340,16,37,1,24
27350,6550,346,6204,5784,114,55,36,0,21
27351,71,0,71,58,2,0,0,0,2
27355,2688,368,2320,1879,281,17,7,0,18
27356,2989,463,2526,2281,150,9,5,0,8
27357,9190,717,8473,7714,337,46,98,1,23
27358,15173,869,14304,12154,644,34,904,5,54
27360,47165,5582,41583,32998,5913,214,550,10,173
27370,15119,551,14568,13365,405,72,192,1,38
27371,7284,618,6666,5164,1166,23,113,1,10
27374,376,19,357,319,5,4,3,0,1
27376,9317,576,8741,7246,1041,39,89,5,33
27377,11341,713,10628,6279,3537,28,160,1,74
27379,4463,140,4323,2210,1901,18,26,5,14
27401,21854,1849,20005,4144,14451,58,521,6,97
27403,23679,2509,21170,12460,6562,72,1013,21,95
27405,51506,6421,45085,10256,29574,183,2835,8,224
27406,61597,6824,54773,16958,33576,311,1414,18,292
27407,49803,8255,41548,16887,18094,250,4005,45,277
27408,17896,720,17176,14444,1534,42,434,4,86
27409,17378,1661,15717,7253,6435,61,1108,13,106
27410,54968,3411,51557,37360,8462,115,3054,12,305
27411,1776,105,1671,24,1612,2,0,0,3
27412,3353,401,2952,1298,1341,15,122,1,18
27455,30913,1738,29175,20094,6326,85,1300,11,132
27501,20918,4071,16847,13483,2474,89,109,4,68
27502,45725,3768,41957,31785,2830,81,4810,16,247
27503,6012,412,5600,3543,1830,42,32,0,18
27504,16613,2419,14194,11479,1862,108,85,3,52
27505,7005,1391,5614,4367,800,41,34,10,21
27506,1153,48,1105,838,233,1,15,0,2
27507,1813,73,1740,1258,413,3,2,0,4
27508,2077,230,1847,911,853,19,7,0,9
27509,7650,1294,6356,2776,3352,49,20,0,9
27510,14801,2202,12599,8876,1777,34,1090,7,89
27511,32786,5048,27738,21650,2556,73,1834,19,233
27513,46526,4244,42282,27940,4302,88,7529,18,256
27514,33809,2924,30885,20274,3078,106,5543,12,193
27516,45841,3916,41925,31473,3702,85,4225,17,228
27517,28837,2882,25955,20252,2111,39,2092,6,128
27518,21807,1193,20614,16011,1392,31,2166,10,115
27519,65923,3481,62442,29445,4527,105,25589,29,318
27520,46478,7154,39324,27595,8782,148,465,5,258
27521,6345,1140,5205,4232,649,32,42,1,33
27522,13630,1934,11696,7379,3398,56,166,2,104
27523,17320,1072,16248,9976,1073,40,4409,2,75
27524,13258,2275,10983,9082,1332,58,37,1,43
27525,16684,1458,15226,10081,4186,51,113,8,61
27526,56089,5530,50559,40353,6507,183,872,31,278
27527,33827,3508,30319,23160,4888,112,491,19,168
27529,54250,7396,46854,29640,13489,261,898,37,305
27530,37470,2680,34790,18233,14402,122,437,18,141
27531,584,114,470,311,100,0,28,3,0
27533,361,11,350,148,182,8,0,0,0
27534,30844,3251,27593,15382,9768,75,839,26,148
27536,15998,1373,14625,3863,10095,45,166,1,50
27537,23635,2183,21452,11054,9603,45,104,5,57
27539,26326,2719,23607,18548,2236,42,1516,6,153
27540,44302,3378,40924,32519,3891,104,2045,16,239
27541,4026,232,3794,3142,441,7,12,0,14
27542,9607,1210,8397,6754,1170,45,26,0,23
27544,3824,247,3577,2093,1355,6,6,3,9
27545,32567,5784,26783,12038,12138,142,907,22,225
27546,20637,2040,18597,12838,4314,144,224,25,124
27549,24558,2578,21980,14227,6593,102,122,2,93
27551,2052,67,1985,1121,658,135,6,0,6
27553,1944,61,1883,603,1214,7,10,0,4
27555,458,48,410,317,49,3,1,0,8
27556,139,8,131,23,105,0,0,0,0
27557,8336,1632,6704,4854,1516,35,14,0,34
27559,2412,230,2182,1688,351,10,28,0,3
27560,38959,2325,36634,13387,4966,114,16576,14,244
27562,3800,254,3546,2861,225,10,213,0,17
27563,4970,199,4771,1710,2864,51,5,3,17
27565,24676,1936,22740,12102,9707,53,125,13,49
27568,1187,176,1011,816,134,1,1,0,2
27569,8854,1054,7800,6480,864,37,54,8,26
27570,24,2,22,9,13,0,0,0,0
27571,8627,792,7835,5282,1852,18,267,5,31
27572,6652,297,6355,5242,782,11,51,1,28
27573,11017,967,10050,4982,4499,66,38,2,20
27574,14320,585,13735,9703,3375,129,40,4,62
27576,17568,4960,12608,8400,3470,44,68,4,55
27577,24972,5352,19620,13548,4948,101,165,10,88
27581,3646,338,3308,2602,529,16,7,3,13
27582,313,7,306,147,155,0,1,0,0
27583,7204,324,6880,5600,939,20,21,1,7
27584,104,1,103,42,60,0,0,0,0
27587,76647,5809,70838,54371,10173,147,2407,35,348
27589,6927,356,6571,1926,3920,443,28,1,26
27591,24677,4532,20145,13192,5418,98,336,11,148
27592,18115,2808,15307,12856,1477,75,104,3,51
27593,31,15,16,8,6,0,0,0,2
27594,63,1,62,32,27,0,0,0,1
27596,19023,1715,17308,13795,2487,50,153,2,90
27597,27178,4160,23018,15995,5536,98,179,14,187
27599,16,0,16,9,0,3,0,1,1
27601,9965,784,9181,4405,4063,19,238,5,59
27603,54616,8709,45907,32538,9145,166,1604,15,271
27604,46076,9886,36190,18007,14002,107,2119,25,267
27605,6409,403,6006,5031,414,10,205,0,36
27606,48343,5013,43330,27531,7609,148,5333,37,470
27607,27182,1586,25596,20294,2566,53,1520,15,108
27608,12018,385,11633,10838,270,10,146,0,29
27609,36218,4072,32146,24535,5202,43,971,5,204
27610,75164,16364,58800,12879,41573,268,1357,23,469
27612,39576,3068,36508,28192,5062,71,1436,14,171
27613,46969,3509,43460,33576,5057,104,2390,13,211
27614,35415,2116,33299,25974,4016,43,1529,6,128
27615,43010,3032,39978,31471,5175,72,1463,15,184
27616,56941,11274,45667,18365,20759,196,3708,27,347
27617,20968,1680,19288,11325,4643,48,2113,9,137
27695,1045,58,987,812,47,0,86,0,1
27697,0,0,0,0,0,0,0,0,0
27701,25208,4712,20496,9823,8736,59,806,9,129
27703,61539,12642,48897,19113,24545,158,2639,7,372
27704,39532,9415,30117,9287,18465,98,606,23,261
27705,50472,7682,42790,26673,9461,77,4158,12,274
27707,49787,7940,41847,18578,18814,104,2277,7,236
27708,3419,170,3249,228,2916,0,63,0,0
27709,5,3,2,1,0,0,0,0,0
27712,21683,2029,19654,13704,4226,42,659,8,142
27713,54988,5558,49430,25041,17660,87,3843,9,296
27801,19043,672,18371,4199,13582,59,24,6,59
27803,20882,886,19996,9348,9742,89,169,2,77
27804,28707,1744,26963,11486,13671,212,614,18,139
27805,3164,78,3086,1393,1525,16,3,0,16
27806,1950,59,1891,1108,697,2,1,1,5
27807,6749,1674,5075,3600,1199,18,9,0,30
27808,2324,39,2285,2103,108,4,5,1,4
27809,4345,238,4107,1907,2008,31,19,0,20
27810,3439,211,3228,2343,800,7,9,0,7
27812,2358,140,2218,911,1212,10,2,2,6
27813,659,47,612,422,172,1,0,0,2
27814,1627,39,1588,1171,346,3,8,3,2
27815,15,0,15,9,4,0,0,0,0
27816,2636,171,2465,1632,710,24,2,0,11
27817,6824,360,6464,4892,1298,7,23,1,28
27818,1159,22,1137,482,596,4,4,0,4
27819,241,12,229,72,152,0,0,0,0
27820,2486,59,2427,1348,998,2,3,1,1
27821,216,5,211,56,147,3,0,1,0
27822,8351,626,7725,5673,1728,29,41,1,18
27823,6354,112,6242,840,5008,198,3,3,24
27824,1113,91,1022,583,383,0,0,0,8
27825,84,1,83,52,29,0,0,0,0
27826,1126,55,1071,551,467,7,8,2,2
27827,41,6,35,27,7,0,1,0,0
27828,8673,672,8001,4450,3197,30,25,0,25
27829,1786,145,1641,1132,448,9,4,1,5
27830,4377,433,3944,2715,1056,13,5,2,5
27831,3009,45,2964,419,2458,2,1,0,21
27832,2630,35,2595,997,1485,14,0,0,9
27834,55051,5150,49901,17234,29268,137,950,33,320
27837,5871,550,5321,3781,1232,15,36,1,13
27839,3509,109,3400,1148,2155,21,5,0,16
27840,457,18,439,149,274,1,0,0,4
27841,49,2,47,11,33,0,0,0,1
27842,1469,18,1451,1060,328,7,1,1,6
27843,931,55,876,457,389,0,0,0,5
27844,2932,56,2876,235,1024,1434,3,0,13
27845,1489,17,1472,675,711,6,9,0,23
27846,2731,108,2623,1858,678,6,5,0,1
27847,714,14,700,139,530,3,0,0,3
27849,1027,12,1015,124,855,1,0,0,2
27850,6462,135,6327,3790,2204,102,27,0,31
27851,5023,706,4317,3309,768,43,8,0,8
27852,2673,180,2493,1925,446,6,23,0,8
27853,394,22,372,148,209,1,0,0,0
27855,5908,404,5504,1840,3430,15,26,1,47
27856,17029,815,16214,10010,5498,133,62,6,59
27857,1075,47,1028,439,559,6,1,0,2
27858,52857,3413,49444,35141,10745,159,1156,26,191
27860,1749,187,1562,1132,394,7,1,0,2
27861,70,7,63,9,52,0,0,0,0
27862,820,20,800,479,297,0,2,1,2
27863,12520,976,11544,8923,1929,31,90,2,53
27864,4133,237,3896,2197,1602,14,2,0,7
27865,1926,103,1823,1649,113,4,6,0,3
27866,756,21,735,260,452,2,3,0,2
27869,1832,50,1782,444,1289,5,3,0,2
27870,25738,872,24866,13202,10484,134,250,5,48
27871,3951,248,3703,1659,1914,14,9,1,10
27872,222,8,214,83,125,0,1,0,1
27873,295,22,273,145,118,3,1,0,0
27874,4027,135,3892,1082,2709,6,6,1,14
27875,390,7,383,256,118,0,0,0,0
27876,1127,26,1101,416,645,1,1,0,6
27877,2,0,2,0,2,0,0,0,0
27878,1323,42,1281,368,859,4,0,0,5
27879,278,15,263,139,107,0,0,0,0
27880,3347,587,2760,2263,398,4,8,0,4
27881,32,0,32,11,21,0,0,0,0
27882,7648,892,6756,4181,2211,45,14,2,16
27883,3398,396,3002,1882,1006,4,6,0,14
27884,1156,119,1037,840,157,2,3,1,5
27885,802,69,733,527,184,0,0,0,2
27886,18776,1351,17425,7611,9166,41,66,3,56
27888,2100,581,1519,943,502,11,1,0,12
27889,26054,2702,23352,15600,6833,57,106,9,83
27890,2150,37,2113,375,1661,11,4,2,10
27891,4626,182,4444,1502,2703,63,10,0,27
27892,13864,502,13362,7604,5266,48,89,0,46
27893,37131,5129,32002,11160,19262,86,280,10,161
27896,20683,1487,19196,11863,5988,60,552,0,50
27897,1370,48,1322,561,701,7,4,0,3
27909,40606,2239,38367,21605,14320,150,459,28,178
27910,10662,215,10447,3153,6764,111,72,2,33
27915,832,33,799,761,7,0,6,1,0
27916,913,12,901,848,13,4,2,0,1
27917,658,30,628,396,166,1,4,0,4
27919,1120,13,1107,866,205,2,1,1,0
27920,1181,86,1095,1038,11,4,5,0,11
27921,4978,170,4808,3889,556,19,53,0,31
27922,788,14,774,228,521,7,0,0,2
27923,552,22,530,491,11,3,4,0,3
27924,2620,50,2570,1209,1301,3,3,0,4
27925,3017,256,2761,1743,872,5,37,0,13
27926,1606,49,1557,1123,331,13,5,0,7
27927,1457,70,1387,1301,26,0,19,1,0
27928,1670,126,1544,1043,448,4,7,1,5
27929,2471,41,2430,2265,21,10,17,1,13
27932,11930,469,11461,6886,4085,43,36,1,16
27935,1485,20,1465,1126,239,13,4,0,10
27936,994,40,954,924,2,5,4,1,2
27937,3524,58,3466,2086,1158,30,5,7,7
27938,1330,21,1309,772,498,7,0,0,0
27939,2722,148,2574,2266,95,14,27,1,12
27941,673,33,640,579,18,0,4,1,1
27942,623,10,613,288,293,7,0,0,0
27943,577,12,565,540,2,1,1,0,3
27944,11406,278,11128,8255,2266,29,34,6,38
27946,1154,9,1145,908,203,2,5,0,1
27947,1139,94,1045,866,77,2,11,2,14
27948,12095,888,11207,10415,112,38,130,2,62
27949,8151,285,7866,7472,33,11,58,4,15
27950,1918,54,1864,1724,4,0,11,2,2
27953,947,127,820,756,10,4,3,0,3
27954,6510,841,5669,4928,454,26,23,2,14
27956,251,16,235,202,13,1,4,0,1
27957,1251,13,1238,698,511,1,5,0,6
27958,12078,511,11567,9886,747,45,150,14,47
27959,3182,121,3061,2894,26,5,25,0,17
27960,797,85,712,694,2,0,0,0,0
27962,6788,173,6615,2715,3692,4,22,2,29
27964,447,29,418,407,4,0,4,0,0
27965,563,22,541,473,24,7,0,0,3
27966,1183,62,1121,938,109,1,1,0,3
27967,428,13,415,118,290,2,0,0,2
27968,213,8,205,195,0,0,0,0,0
27969,159,1,158,74,77,0,0,0,1
27970,2798,102,2696,1324,1298,7,12,0,2
27972,343,9,334,311,5,2,1,0,3
27973,1610,94,1516,1316,72,10,12,0,7
27974,886,28,858,693,80,2,36,0,2
27976,3918,120,3798,3137,386,19,23,1,18
27978,214,2,212,196,2,1,0,0,0
27979,1393,45,1348,772,528,1,2,3,3
27980,1915,67,1848,1391,401,2,3,0,2
27981,1544,102,1442,1359,14,2,4,0,10
27982,132,0,132,132,0,0,0,0,0
27983,8945,166,8779,2964,5445,44,50,0,19
27985,169,10,159,47,93,0,1,0,3
27986,2226,886,1340,453,802,31,12,1,10
28001,27185,1240,25945,19842,4062,87,711,1,72
28006,899,23,876,808,15,1,6,0,1
28007,631,17,614,241,351,3,6,0,2
28009,1210,21,1189,750,359,3,9,1,1
28012,26202,1447,24755,20669,2151,100,734,15,101
28016,13313,822,12491,10395,1403,52,74,3,50
28017,553,23,530,404,116,1,6,0,2
28018,5320,108,5212,4880,160,8,17,1,14
28019,40,2,38,29,8,0,0,0,0
28020,2430,25,2405,2331,5,4,10,0,3
28021,13669,710,12959,11174,1112,30,87,1,39
28023,15144,1373,13771,12333,660,53,116,17,45
28024,14,2,12,10,0,1,0,0,0
28025,58260,8688,49572,34543,11289,161,840,32,263
28027,76478,10000,66478,42181,14165,175,6444,50,381
28031,30836,2319,28517,24453,1918,36,771,5,166
28032,3279,135,3144,2659,263,14,51,0,10
28033,2862,217,2645,2457,59,2,8,0,6
28034,19258,1569,17689,13957,2594,67,183,7,66
28036,21244,1296,19948,17017,1267,39,727,3,91
28037,25596,1142,24454,22370,825,58,293,7,53
28039,62,15,47,11,33,0,0,0,0
28040,7472,221,7251,6630,301,18,19,0,6
28041,30,2,28,25,0,0,0,0,1
28042,111,0,111,109,0,1,0,0,0
28043,20183,1640,18543,14629,2696,43,150,11,66
28052,35332,4963,30369,16576,11945,120,191,7,129
28054,40548,5346,35202,21575,11029,99,674,10,187
28056,34332,2793,31539,25015,4117,113,823,6,97
28071,3147,84,3063,2888,16,15,15,0,4
28072,864,63,801,645,86,1,12,1,4
28073,5356,189,5167,4024,836,17,52,1,28
28074,15,6,9,8,0,0,0,0,0
28075,21366,1192,20174,12861,3762,53,2513,9,96
28076,358,46,312,238,53,2,0,0,1
28077,362,15,347,287,27,3,1,0,0
28078,67863,6387,61476,47008,8137,134,3091,15,308
28079,39051,4386,34665,27303,4192,109,1077,16,281
28080,7964,405,7559,6724,412,42,33,0,12
28081,28583,4447,24136,17839,4526,93,449,7,127
28083,25821,4045,21776,14117,6099,62,256,11,106
28086,27641,979,26662,20474,4485,63,374,11,96
28088,3343,325,3018,2497,316,16,37,0,18
28089,153,3,150,130,6,0,1,0,3
28090,7870,230,7640,6551,804,21,21,3,11
28091,1766,31,1735,977,621,18,16,0,1
28092,38719,4007,34712,30024,2664,96,283,7,114
28097,6876,417,6459,5855,261,20,65,4,23
28098,3868,350,3518,2762,420,16,82,0,29
28101,736,35,701,637,34,0,12,0,0
28102,94,12,82,77,0,1,0,0,0
28103,10164,785,9379,7264,1692,43,41,0,25
28104,34521,2400,32121,25815,2384,71,2274,3,160
28105,44085,4737,39348,28504,5777,99,2818,18,317
28107,9353,774,8579,7066,922,40,101,5,63
28108,50,9,41,35,2,0,1,1,0
28109,541,47,494,331,135,4,4,0,0
28110,53316,11028,42288,32705,6712,144,648,35,215
28112,27126,5320,21806,16099,4397,90,185,1,109
28114,7351,405,6946,6172,403,17,14,0,24
28115,43413,3252,40161,32310,4592,124,849,18,180
28117,46917,3011,43906,37373,2083,94,2444,25,152
28119,2044,63,1981,586,1332,4,9,2,6
28120,24017,1518,22499,17155,3556,80,536,11,102
28124,6922,171,6751,6243,195,30,56,0,15
28125,2687,131,2556,2364,69,6,13,0,15
28127,7571,229,7342,5931,981,34,147,1,19
28128,7119,282,6837,5638,872,33,99,1,7
28129,5817,426,5391,4849,275,21,52,0,7
28133,2550,166,2384,1912,353,6,22,0,5
28134,12411,2599,9812,6080,2391,25,764,6,55
28135,4779,195,4584,2754,1616,21,43,1,5
28136,42,1,41,31,5,0,2,0,0
28137,2804,46,2758,2563,60,2,54,0,2
28138,10855,479,10376,9654,236,33,49,4,32
28139,18665,740,17925,15789,1273,45,107,4,73
28144,26254,2644,23610,12095,9984,82,334,22,138
28146,29572,1966,27606,23440,2568,85,348,3,88
28147,26618,4709,21909,15727,4675,72,356,8,78
28150,28517,1340,27177,17693,8042,54,187,6,94
28152,25643,1167,24476,17215,5890,73,187,1,80
28159,3067,317,2750,1539,1017,8,23,7,26
28160,3869,143,3726,2519,936,17,20,6,20
28163,5334,430,4904,4643,52,15,17,3,4
28164,14903,488,14415,12515,1062,55,126,0,42
28166,10357,648,9709,8122,1035,17,102,3,46
28167,2417,43,2374,2116,158,8,21,0,3
28168,10120,449,9671,8998,226,27,100,6,12
28169,169,6,163,121,25,0,3,0,0
28170,10337,180,10157,4163,5578,38,127,1,19
28173,64144,4427,59717,46889,4621,144,5072,27,292
28174,9269,1724,7545,4613,2466,37,69,7,120
28202,16447,1098,15349,9906,3507,33,1220,5,70
28203,18572,969,17603,13750,2421,15,656,2,77
28204,9411,611,8800,6050,1857,13,450,6,55
28205,49600,9598,40002,23755,11954,144,1975,23,290
28206,14053,1674,12379,2717,8759,59,339,3,43
28207,9184,271,8913,8258,187,15,169,3,12
28208,38614,5350,33264,5909,24048,158,1719,16,154
28209,24836,2268,22568,18666,2059,44,812,10,105
28210,46843,8644,38199,28414,6248,101,1788,15,175
28211,31917,1884,30033,23673,3735,46,1284,6,166
28212,41009,12505,28504,7544,15204,93,3871,18,540
28213,47215,11665,35550,8653,22926,131,2051,34,313
28214,42925,7801,35124,13018,17923,124,2118,12,254
28215,61842,15745,46097,13296,27583,124,2524,58,424
28216,57196,7678,49518,10775,34407,124,1863,36,314
28217,28955,10844,18111,4222,10415,104,2431,8,237
28223,5197,416,4781,2955,1206,67,521,17,3
28226,40513,3774,36739,29791,3455,77,1670,14,199
28227,57126,11251,45875,24956,15325,197,2784,33,438
28244,0,0,0,0,0,0,0,0,0
28262,46048,5135,40913,10321,21347,214,7083,24,312
28269,82422,10884,71538,23560,39226,216,4892,49,574
28270,34613,2520,32093,23966,3355,68,2950,13,318
28273,41404,10375,31029,11440,14298,73,3374,36,286
28274,822,123,699,532,137,4,19,0,3
28277,74957,6274,68683,44388,6739,116,13793,35,474
28278,33426,4392,29034,14812,9784,67,2627,19,237
28280,22,10,12,6,2,0,3,0,0
28282,0,0,0,0,0,0,0,0,0
28301,17670,1099,16571,2603,12722,155,124,28,92
28303,30842,3491,27351,12055,11551,228,1249,156,247
28304,37120,4516,32604,13913,14261,467,1149,139,279
28305,5844,418,5426,3547,1361,74,105,7,27
28306,44615,5274,39341,19101,14302,950,1380,109,321
28307,14426,3225,11201,7560,1707,88,445,210,112
28308,337,145,192,107,36,5,16,4,1
28310,8503,1940,6563,4469,1443,66,395,22,12
28311,36302,3705,32597,13151,15662,281,949,120,252
28312,19723,1288,18435,10467,6065,544,180,49,99
28314,54271,7600,46671,14194,26153,414,1869,339,368
28315,13500,1130,12370,8302,2716,293,205,11,62
28318,4275,479,3796,3198,339,70,1,0,8
28320,7810,471,7339,5523,1449,114,15,1,14
28323,4613,561,4052,2360,1307,26,32,16,15
28325,328,85,243,180,57,1,0,0,0
28326,26061,4161,21900,14424,4938,209,393,91,138
28327,18118,1201,16917,14414,1302,125,164,7,77
28328,25300,5767,19533,10928,7069,587,139,8,61
28330,384,21,363,287,23,11,5,0,4
28331,150,18,132,90,28,1,3,0,0
28332,444,38,406,280,104,4,3,0,1
28333,10560,3068,7492,3327,3652,20,45,6,51
28334,23697,2772,20925,14707,4988,273,108,4,74
28337,9285,937,8348,4575,3410,86,16,2,15
28338,3811,454,3357,2281,810,80,20,0,5
28339,6444,782,5662,3735,1580,57,13,7,21
28340,8481,264,8217,2425,3093,2338,27,1,30
28341,3495,1291,2204,1356,748,16,4,1,6
28342,178,21,157,109,29,4,2,0,0
28343,1368,40,1328,614,443,167,3,1,0
28344,2982,766,2216,1591,430,52,10,2,14
28345,11546,684,10862,5854,3876,379,57,2,41
28347,1555,223,1332,483,753,40,7,0,3
28348,37476,4021,33455,17630,11414,873,623,84,243
28349,3070,330,2740,1579,1029,4,10,0,8
28350,339,28,311,273,17,3,2,0,1
28351,4278,114,4164,2355,952,552,42,0,9
28352,24940,879,24061,9800,10530,2344,256,11,90
28355,17,5,12,11,0,0,0,0,0
28356,5562,412,5150,3501,1103,85,49,18,54
28357,2746,452,2294,1076,623,430,33,2,6
28358,32865,2865,30000,12946,9490,5651,440,29,147
28359,1073,130,943,303,470,151,4,0,0
28360,12043,1315,10728,2061,1252,6855,51,2,31
28362,44,0,44,9,28,6,0,0,0
28363,1257,31,1226,613,419,117,3,1,2
28364,12402,285,12117,1050,2192,8326,50,1,22
28365,14653,3321,11332,7725,3093,52,39,4,51
28366,4948,1360,3588,2713,674,59,12,3,8
28367,100,30,70,45,13,3,0,0,0
28368,86,21,65,52,7,0,2,0,0
28369,2123,94,2029,1168,483,298,1,1,0
28371,7278,892,6386,3262,2100,360,67,19,52
28372,13765,451,13314,1465,1695,9290,256,6,73
28373,2331,195,2136,1491,449,24,37,6,5
28374,18818,734,18084,16286,605,77,393,5,68
28375,181,5,176,113,39,17,0,0,0
28376,43160,6677,36483,16679,14622,1394,622,163,271
28377,11081,1970,9111,1691,2674,4186,23,14,61
28378,81,22,59,31,8,14,0,0,0
28379,24603,1587,23016,14093,7038,467,260,5,110
28382,6511,756,5755,3846,1538,95,18,0,19
28383,7098,153,6945,774,1582,4291,10,1,18
28384,11160,2834,8326,4004,2510,1346,22,8,26
28385,2857,401,2456,1694,643,31,8,4,9
28386,5768,1474,4294,651,732,2624,12,11,21
28387,16413,870,15543,11763,2754,81,226,17,41
28390,23799,3266,20533,9604,8321,212,568,94,168
28391,5476,306,5170,4006,605,156,36,10,12
28392,1333,103,1230,674,460,27,2,0,9
28393,1713,403,1310,745,483,18,5,0,11
28394,5559,582,4977,4088,485,47,46,6,22
28395,2596,121,2475,1831,427,42,25,0,36
28396,2284,49,2235,967,785,360,34,2,6
28398,6602,1496,5106,1933,2978,10,24,0,18
28399,1675,232,1443,833,514,30,0,2,1
28401,22204,1767,20437,10673,8389,85,128,25,108
28403,38134,3377,34757,27687,4503,102,770,57,186
28405,31775,2914,28861,21505,5380,105,405,10,170
28409,34681,2119,32562,29264,1186,87,675,16,108
28411,37834,2412,35422,30591,2495,71,657,12,172
28412,42758,3647,39111,33061,3134,141,709,23,190
28420,3466,404,3062,2551,357,25,4,3,5
28421,1518,136,1382,912,402,6,2,1,10
28422,8249,337,7912,6325,1161,35,39,5,28
28423,2009,61,1948,565,636,643,4,0,10
28424,59,1,58,16,36,1,1,0,0
28425,10280,1019,9261,6238,2515,41,36,0,45
28428,6848,191,6657,6242,56,17,50,1,18
28429,8802,868,7934,5609,1833,69,51,1,21
28430,1522,57,1465,1219,187,24,2,0,4
28431,6255,268,5987,3765,1907,98,14,0,12
28432,1806,71,1735,1554,121,15,5,0,0
28433,4282,207,4075,1936,1824,166,6,2,9
28434,957,24,933,275,473,138,1,0,2
28435,2241,218,2023,1214,690,18,8,2,4
28436,1829,87,1742,1414,228,39,0,1,10
28438,1541,33,1508,1071,364,25,1,0,6
28439,1165,34,1131,569,507,15,1,1,2
28441,2965,622,2343,1386,830,31,11,1,5
28442,1487,128,1359,813,428,44,4,0,0
28443,25074,1190,23884,21419,856,74,201,16,123
28444,1955,228,1727,1062,575,16,1,2,0
28445,10243,692,9551,8403,289,50,121,19,40
28447,992,170,822,421,381,5,2,0,0
28448,977,97,880,465,356,16,4,0,2
28449,1926,33,1893,1776,8,6,18,2,6
28450,2073,33,2040,1399,196,369,14,0,6
28451,39025,3052,35973,28459,5092,250,335,29,134
28452,577,25,552,276,255,0,1,2,1
28453,3251,1267,1984,953,949,11,7,0,14
28454,3175,238,2937,1876,854,14,15,8,9
28455,1681,166,1515,1362,99,13,1,3,5
28456,3502,246,3256,1201,1792,93,3,2,18
28457,11008,1776,9232,7370,1322,27,28,4,39
28458,5587,1260,4327,2149,2026,19,11,0,9
28460,12591,868,11723,10466,320,51,155,9,59
28461,22141,584,21557,19605,786,77,161,10,73
28462,12674,584,12090,10372,1036,103,32,4,22
28463,8494,464,8030,4859,2825,68,25,0,45
28464,2086,470,1616,760,786,4,19,0,3
28465,8020,137,7883,7460,58,26,38,3,24
28466,8773,1650,7123,4980,1879,30,31,0,15
28467,11770,410,11360,10503,422,45,74,3,24
28468,5047,188,4859,4530,176,11,33,5,4
28469,8171,429,7742,7323,124,43,44,2,13
28470,11141,978,10163,8331,1148,97,72,6,21
28472,17308,945,16363,9931,5498,290,81,4,42
28478,4274,373,3901,2677,1069,22,3,0,10
28479,6087,257,5830,4796,700,22,57,2,14
28480,2476,35,2441,2323,11,0,15,1,17
28501,17964,778,17186,5076,11387,36,160,5,39
28504,20180,1385,18795,11462,6508,54,114,9,60
28508,1922,783,1139,994,100,4,6,0,4
28509,7,0,7,6,0,1,0,0,0
28510,1451,60,1391,1111,185,13,10,0,9
28511,561,20,541,529,0,0,0,0,0
28512,3011,61,2950,2859,9,2,10,0,5
28513,10006,739,9267,5732,3061,52,21,8,37
28515,2729,110,2619,1443,1065,8,5,3,2
28516,11204,282,10922,9280,1103,42,57,9,31
28518,7852,793,7059,5557,1126,35,26,3,11
28519,389,20,369,268,73,2,0,0,0
28520,254,0,254,246,0,5,0,0,1
28521,1952,107,1845,1558,236,9,12,1,4
28523,2376,106,2270,1689,499,1,11,0,4
28524,314,0,314,303,0,1,0,0,4
28525,3261,614,2647,2277,277,10,3,0,5
28526,2208,168,2040,1301,645,5,5,0,6
28527,1220,50,1170,1005,95,4,8,0,2
28528,588,4,584,560,0,2,0,0,3
28529,2050,145,1905,1636,148,14,7,1,7
28530,6771,638,6133,3530,2335,16,25,5,16
28531,1127,9,1118,1090,5,0,0,0,2
28532,20340,2270,18070,11616,4100,86,537,91,139
28533,1792,463,1329,1041,181,2,58,5,2
28537,106,2,104,92,4,2,0,0,0
28538,2155,334,1821,1015,733,7,8,0,8
28539,17039,1527,15512,12780,1082,93,232,48,77
28540,49739,5929,43810,30511,8336,284,879,148,234
28542,3536,985,2551,1610,398,9,270,117,0
28543,5016,1098,3918,2891,502,14,155,54,18
28544,4283,794,3489,2063,894,26,74,30,39
28546,48547,7303,41244,24421,10786,230,1691,154,303
28547,22703,5567,17136,13764,1504,135,635,138,233
28551,13215,1557,11658,7120,4013,31,69,12,34
28552,141,0,141,133,5,0,0,0,0
28553,382,8,374,352,1,0,4,1,0
28554,158,11,147,109,35,0,0,0,0
28555,5260,322,4938,3577,959,23,36,7,15
28556,864,26,838,727,68,6,11,0,4
28557,14910,946,13964,12264,829,55,173,9,53
28560,28005,1747,26258,18548,5392,95,761,23,105
28562,39375,2107,37268,26794,7038,77,1673,32,183
28570,21647,1299,20348,17778,1096,115,233,37,106
28571,2502,70,2432,2085,250,5,7,0,12
28572,6549,1009,5540,4787,558,23,12,0,14
28573,2013,71,1942,1249,582,17,14,0,8
28574,18689,1875,16814,13410,1799,76,168,33,94
28575,164,2,162,153,1,0,2,0,0
28577,302,6,296,278,8,3,0,0,0
28578,5339,2387,2952,2462,315,13,26,5,21
28579,643,13,630,597,7,0,0,1,2
28580,12672,1505,11167,5877,4888,66,30,0,45
28581,187,0,187,171,8,2,0,0,0
28582,1891,106,1785,1605,72,5,6,0,9
28584,13584,654,12930,11728,280,38,178,13,51
28585,3617,168,3449,2283,1023,12,9,0,17
28586,7865,379,7486,5013,2138,49,7,0,22
28587,277,1,276,122,132,1,3,0,1
28589,28,0,28,27,0,0,0,0,0
28590,28326,1471,26855,15632,9053,70,842,20,138
28594,3849,123,3726,3545,13,4,26,2,17
28601,53973,6348,47625,39215,3838,119,2021,18,169
28602,29184,2965,26219,19732,3631,94,1443,35,115
28604,7050,360,6690,6306,77,15,40,1,29
28605,3873,113,3760,3581,18,2,29,0,4
28606,2059,85,1974,1736,146,4,2,0,0
28607,35495,2760,32735,28108,2004,50,842,11,399
28609,6137,280,5857,5154,339,21,99,1,25
28610,10100,635,9465,7972,559,12,521,1,58
28611,648,45,603,569,6,1,1,1,3
28612,11835,384,11451,10196,158,31,603,1,25
28613,22970,3365,19605,15362,1390,55,1737,5,74
28615,1915,29,1886,1816,6,4,7,0,4
28616,162,29,133,113,0,0,1,0,3
28617,2343,292,2051,1953,14,2,10,1,8
28618,2226,126,2100,1987,13,1,11,0,1
28619,510,33,477,396,42,2,14,0,0
28621,9952,1255,8697,8078,282,8,45,1,33
28622,2395,106,2289,2219,7,7,3,0,1
28623,1618,245,1373,1317,11,7,2,0,0
28624,1395,26,1369,1282,46,0,3,0,0
28625,38396,3540,34856,27868,4597,88,863,5,122
28626,2499,100,2399,2295,9,3,11,6,7
28627,1334,129,1205,1156,10,5,0,1,0
28628,117,12,105,88,3,1,3,0,1
28629,59,0,59,59,0,0,0,0,0
28630,19772,915,18857,17522,334,54,132,2,51
28631,647,58,589,562,1,2,2,1,0
28634,5164,613,4551,3928,376,21,9,0,19
28635,3464,100,3364,3254,21,2,0,0,6
28636,4998,455,4543,4193,171,3,24,0,11
28637,1471,67,1404,1258,21,3,67,1,5
28638,11880,751,11129,10458,181,29,41,0,33
28640,4622,284,4338,4133,44,14,20,4,4
28641,47,0,47,43,3,0,0,0,0
28642,5336,529,4807,4222,316,8,32,0,21
28643,3233,76,3157,2984,9,5,8,0,2
28644,1598,94,1504,1460,4,6,0,1,3
28645,46004,3146,42858,37247,3282,118,301,11,143
28646,553,34,519,490,2,5,2,0,0
28649,936,22,914,873,2,0,1,0,0
28650,12982,913,12069,10687,612,22,179,2,32
28651,6305,371,5934,5692,33,10,33,0,9
28652,73,7,66,64,2,0,0,0,0
28653,36,8,28,26,0,0,1,0,0
28654,3354,281,3073,2761,163,3,22,0,4
28655,55328,5872,49456,41046,4154,178,1653,45,171
28657,9086,501,8585,8233,37,19,25,0,12
28658,26453,3195,23258,18619,2080,58,1335,6,82
28659,20588,2039,18549,16568,1239,29,58,4,46
28660,2289,253,2036,1829,107,4,9,2,5
28662,127,6,121,118,0,0,0,0,0
28663,701,52,649,630,0,0,0,0,1
28664,91,0,91,87,0,0,0,0,0
28665,2549,107,2442,2355,13,1,11,0,7
28666,118,33,85,79,0,0,4,0,0
28667,376,31,345,298,9,1,8,0,0
28668,272,15,257,250,1,3,0,0,0
28669,2861,122,2739,2490,150,2,10,1,4
28670,2747,100,2647,2516,39,10,6,0,9
28671,503,11,492,467,13,1,7,0,1
28672,34,2,32,29,0,0,0,0,0
28673,6761,218,6543,6021,194,17,49,3,7
28675,6138,784,5354,5103,80,15,13,3,2
28676,3471,117,3354,3223,20,0,12,1,4
28677,35926,4075,31851,21565,8278,72,358,4,125
28678,4999,362,4637,4047,297,12,70,0,14
28679,1911,72,1839,1713,8,2,9,0,12
28681,25181,1053,24128,21321,1540,95,267,1,64
28682,1126,26,1100,1031,29,0,7,2,1
28683,1740,47,1693,1608,20,3,4,1,12
28684,2065,60,2005,1907,7,3,8,1,3
28685,1831,46,1785,1715,14,2,7,0,4
28689,1846,117,1729,1641,15,7,7,0,1
28690,9124,330,8794,7825,254,8,380,18,20
28692,4161,202,3959,3756,16,10,21,0,15
28693,1425,77,1348,1303,8,0,3,0,0
28694,7769,527,7242,6993,30,16,38,0,10
28697,12674,1133,11541,10302,651,16,166,0,22
28698,2141,81,2060,1952,11,3,5,0,6
28701,4311,201,4110,3796,48,13,27,1,18
28702,409,10,399,356,0,21,0,0,2
28704,23734,2905,20829,17213,1751,59,590,47,114
28705,6220,136,6084,5810,15,15,17,0,14
28707,302,6,296,273,1,7,0,0,0
28708,662,21,641,603,3,2,0,0,0
28709,2214,52,2162,2038,13,5,8,0,15
28710,85,3,82,75,0,0,0,0,1
28711,14047,577,13470,12151,509,50,92,5,80
28712,18928,870,18058,16260,782,54,123,18,78
28713,8551,287,8264,7300,75,405,41,8,31
28714,16397,961,15436,14696,94,55,36,1,36
28715,27810,2494,25316,23135,557,86,190,30,117
28716,17710,734,16976,16010,227,71,58,0,46
28717,1639,202,1437,1368,8,1,22,0,6
28718,597,13,584,541,9,0,7,0,4
28719,7980,482,7498,860,42,6044,46,2,10
28720,125,4,121,108,0,0,0,0,0
28721,10370,485,9885,9256,121,55,47,1,28
28722,6223,378,5845,5402,153,11,28,3,7
28723,12297,1106,11191,9995,438,95,148,4,15
28725,102,7,95,77,0,3,2,0,2
28726,3787,1521,2266,1942,134,10,32,20,7
28729,2923,143,2780,2590,33,7,39,1,4
28730,9707,407,9300,8582,136,34,57,8,41
28731,8806,1061,7745,7212,140,34,62,32,28
28732,19158,1454,17704,15521,849,58,474,4,67
28733,66,1,65,61,0,2,0,0,0
28734,29284,2885,26399,24788,228,143,207,6,81
28735,322,9,313,296,5,1,1,0,1
28736,1026,147,879,836,4,7,2,0,3
28739,21251,1453,19798,18259,496,42,130,37,104
28740,2273,38,2235,2174,8,2,3,0,4
28741,3736,277,3459,3284,18,7,26,0,16
28742,2981,153,2828,2615,55,7,23,2,8
28743,1980,42,1938,1816,5,1,8,0,3
28745,697,10,687,653,5,7,8,0,0
28746,2726,94,2632,2355,154,1,13,0,13
28747,2114,130,1984,1889,7,10,2,0,2
28748,13030,890,12140,11182,191,47,97,23,48
28749,157,10,147,128,2,0,0,0,0
28751,3965,149,3816,3514,27,31,49,0,9
28752,29669,2377,27292,24562,1341,76,221,0,103
28753,11321,341,10980,10481,21,33,32,1,21
28754,8074,379,7695,7075,174,27,41,1,51
28755,21,4,17,13,0,0,0,0,0
28756,4156,264,3892,3593,92,15,1,1,18
28757,901,67,834,740,75,3,6,0,0
28758,17,3,14,10,0,0,0,4,0
28759,7728,440,7288,6761,112,16,63,25,30
28761,8317,366,7951,7298,186,33,126,0,13
28762,6661,202,6459,6005,194,25,29,0,15
28763,2842,233,2609,2482,3,6,14,0,3
28766,1440,40,1400,1328,10,0,4,0,5
28768,6820,478,6342,5831,165,22,37,3,17
28770,35,0,35,26,0,0,1,0,2
28771,7581,208,7373,6487,46,550,20,4,5
28772,1365,66,1299,1206,14,7,0,0,3
28773,3204,134,3070,2860,30,9,8,1,7
28774,1571,87,1484,1408,4,5,11,1,8
28775,573,73,500,481,1,2,1,0,2
28777,10635,666,9969,8948,590,32,37,1,23
28778,10328,993,9335,8178,413,46,81,9,51
28779,16586,1104,15482,13900,225,408,227,5,56
28781,760,30,730,687,0,9,1,0,1
28782,5889,248,5641,5045,323,17,26,3,13
28783,1473,232,1241,1174,7,12,0,0,4
28785,8238,374,7864,7537,31,36,40,0,26
28786,21204,1086,20118,18766,245,116,162,0,47
28787,21948,1477,20471,19139,238,64,126,8,88
28788,168,7,161,157,0,0,3,0,0
28789,5804,247,5557,4243,37,885,46,1,18
28790,3128,160,2968,2837,12,7,9,3,6
28791,14899,1410,13489,12454,307,22,139,26,46
28792,35962,7377,28585,25304,1354,86,389,86,107
28801,15148,662,14486,10505,2984,42,148,65,106
28803,34108,2909,31199,25664,2965,82,681,29,236
28804,23964,1589,22375,20032,800,56,366,22,140
28805,18554,950,17604,15140,1226,29,244,25,120
28806,44621,5566,39055,32979,2947,98,497,195,190
28901,5212,248,4964,4505,64,80,26,0,10
28902,1398,43,1355,1282,3,8,2,0,3
28904,9004,383,8621,8120,49,35,36,6,21
28905,3277,102,3175,2855,23,82,17,0,8
28906,19896,539,19357,17644,288,254,115,0,46
28909,1060,22,1038,988,6,2,2,1,1
29001,1935,110,1825,949,808,5,3,1,8
29003,5859,60,5799,2313,3266,12,25,0,19
29006,9608,884,8724,6300,2076,19,33,3,12
29009,2474,88,2386,1706,569,11,6,0,8
29010,11564,189,11375,4087,6981,29,17,0,10
29014,1702,22,1680,1107,496,17,9,7,2
29015,1329,16,1313,269,1010,3,0,0,2
29016,26245,1220,25025,12366,10762,53,602,38,152
29018,3256,83,3173,1088,1991,5,2,0,12
29020,23264,1123,22141,13909,7232,31,117,1,97
29030,1827,51,1776,1021,688,16,5,0,2
29031,1158,9,1149,314,772,4,3,0,4
29032,4379,346,4033,2749,1135,7,7,1,13
29033,12575,841,11734,7916,2772,30,451,1,40
29036,27047,991,26056,23369,1179,38,482,3,73
29037,852,30,822,614,179,0,1,0,1
29038,2318,72,2246,1666,492,10,2,0,6
29039,3672,240,3432,1645,1580,23,7,1,8
29040,8596,321,8275,4018,3628,52,111,10,42
29042,4603,29,4574,719,3744,8,27,0,13
29044,4993,237,4756,1711,2824,13,29,2,11
29045,27723,2251,25472,15259,7770,75,722,50,123
29046,71,3,68,4,64,0,0,0,0
29047,3303,56,3247,1611,1519,9,9,0,6
29048,4317,68,4249,1830,2269,28,13,0,5
29051,781,35,746,295,429,2,1,0,2
29052,1634,28,1606,129,1432,3,1,0,15
29053,19239,2637,16602,11630,3935,63,52,13,79
29054,10774,787,9987,9089,377,45,48,0,31
29055,4117,43,4074,2573,1325,12,9,2,23
29056,2162,30,2132,510,1561,5,5,0,3
29058,4671,92,4579,3364,1046,12,7,0,25
29059,5662,106,5556,1882,3416,88,27,0,4
29061,13684,631,13053,3473,9010,34,56,8,64
29062,64,1,63,9,50,0,0,0,0
29063,36341,1632,34709,22730,8952,90,1161,41,170
29065,640,7,633,128,488,1,0,0,0
29067,10137,243,9894,7321,2144,39,25,1,23
29069,4496,77,4419,2350,1926,11,9,0,2
29070,15757,1011,14746,12494,1540,60,36,4,45
29072,65060,3475,61585,51253,4785,124,2747,47,229
29073,48653,3468,45185,35148,6375,190,774,17,231
29074,343,4,339,286,31,0,2,0,3
29075,3189,83,3106,2491,460,3,19,2,4
29078,16430,800,15630,11823,2853,34,117,6,59
29079,80,3,77,13,58,0,0,0,0
29080,2592,50,2542,634,1836,4,14,0,3
29081,1219,27,1192,809,342,0,9,0,1
29082,517,40,477,404,65,1,0,0,0
29101,2852,272,2580,1731,727,12,8,0,9
29102,16319,425,15894,7668,7566,66,169,0,34
29104,1370,29,1341,426,866,8,3,0,3
29105,1433,167,1266,730,487,3,1,2,0
29107,2822,55,2767,1887,720,36,2,0,5
29108,20159,2826,17333,9074,7501,58,90,3,32
29111,1432,48,1384,832,526,2,0,0,1
29112,4437,91,4346,2275,1836,53,17,1,8
29113,1384,20,1364,567,755,3,3,1,1
29114,1937,32,1905,919,917,4,11,0,2
29115,28207,688,27519,5684,20835,92,210,21,81
29117,273,14,259,11,243,0,0,0,0
29118,15446,378,15068,4369,9789,48,505,13,44
29122,54,0,54,34,18,0,0,0,0
29123,7261,641,6620,5832,354,46,28,5,27
29125,2698,46,2652,960,1559,15,17,0,3
29126,2342,78,2264,1788,375,9,4,0,14
29127,8909,252,8657,7063,1286,23,23,0,19
29128,4853,166,4687,1323,3228,5,12,4,8
29129,2948,413,2535,1485,918,8,7,2,5
29130,6387,139,6248,3524,2432,22,31,1,14
29133,926,27,899,461,397,3,4,0,0
29135,8074,305,7769,3747,3747,40,17,1,19
29137,2607,50,2557,1452,958,21,13,1,13
29138,10070,2511,7559,4875,2409,18,21,0,23
29142,4432,50,4382,1467,2717,18,61,0,15
29145,706,33,673,450,198,0,3,0,1
29146,1453,23,1430,659,712,18,9,0,2
29148,5856,129,5727,2904,2589,24,36,7,26
29150,39460,1691,37769,15761,19816,114,612,26,97
29152,2078,276,1802,1200,309,4,76,15,15
29153,15013,605,14408,6019,7627,73,124,10,44
29154,29706,1097,28609,15892,10801,65,438,21,89
29160,7921,349,7572,5728,1396,42,42,7,20
29161,10728,314,10414,5650,4373,36,23,4,23
29162,3537,143,3394,2036,1287,17,5,0,2
29163,1840,32,1808,442,1296,22,4,0,2
29164,4253,97,4156,2855,1094,21,10,6,9
29166,904,76,828,621,181,6,1,0,3
29168,3072,83,2989,1329,1472,12,15,1,16
29169,22768,3242,19526,13771,4118,66,602,5,87
29170,22422,1754,20668,15657,3417,83,384,7,75
29172,8955,824,8131,4867,2676,30,114,3,39
29175,359,5,354,253,86,0,3,0,0
29177,213,7,206,179,25,0,0,0,0
29178,3153,61,3092,2129,832,16,6,1,5
29180,12445,298,12147,4673,6979,38,73,2,41
29201,25259,1193,24066,17405,4317,33,1330,7,108
29203,39449,1918,37531,5026,30874,78,342,24,87
29204,18059,580,17479,7355,9239,36,218,24,54
29205,23586,1117,22469,16787,4287,35,488,10,61
29206,19304,976,18328,13897,3382,25,334,36,51
29207,7035,1895,5140,3331,1308,62,300,14,3
29208,2330,128,2202,1764,232,1,99,3,4
29209,35738,2158,33580,14265,17009,88,851,33,158
29210,39299,1813,37486,12802,21943,85,1028,36,178
29212,29739,1389,28350,18376,7520,83,904,53,160
29223,52477,5864,46613,14132,28069,132,2107,72,310
29225,527,23,504,415,17,0,37,2,0
29229,51548,3415,48133,13515,30341,88,1720,72,331
29301,34531,4580,29951,15191,11500,106,1527,17,162
29302,17356,664,16692,12252,3258,33,583,13,66
29303,26793,4518,22275,12443,7976,65,784,7,89
29306,16822,972,15850,5629,9168,26,312,7,67
29307,19034,998,18036,13757,3231,35,270,44,44
29316,29459,2084,27375,20529,4470,51,1209,8,87
29320,907,299,608,456,81,2,20,1,8
29321,2613,68,2545,2137,314,1,13,0,0
29322,9777,368,9409,8518,340,28,126,4,17
29323,16488,890,15598,13265,1401,55,281,4,32
29324,165,6,159,138,8,2,6,0,0
29325,14300,405,13895,8782,4486,24,129,2,56
29329,283,16,267,234,12,0,2,0,0
29330,8302,536,7766,6617,796,23,55,4,22
29331,108,5,103,82,15,0,0,0,1
29332,2409,68,2341,1749,501,10,3,0,7
29333,517,37,480,391,55,1,12,3,1
29334,16472,1350,15122,10482,3348,24,511,22,75
29335,5316,255,5061,3844,1001,14,10,4,4
29338,121,17,104,86,10,0,0,0,0
29340,20695,953,19742,14103,4662,51,52,9,79
29341,19959,1292,18667,12251,5498,55,205,2,82
29346,244,6,238,214,16,0,0,0,1
29349,36458,1865,34593,29211,3161,67,770,9,64
29351,1562,130,1432,1100,258,3,9,0,8
29353,3890,70,3820,2723,933,6,8,0,6
29355,781,19,762,654,94,0,0,0,0
29356,8893,329,8564,7932,299,9,32,2,18
29360,21242,1717,19525,12356,6325,41,89,7,71
29364,462,6,456,396,14,6,0,0,0
29365,13882,1265,12617,10230,1518,32,215,6,49
29368,158,6,152,135,6,1,2,0,0
29369,16007,1070,14937,10599,3319,18,426,12,60
29370,1069,34,1035,672,313,5,1,0,6
29372,4401,121,4280,3409,635,20,30,0,13
29373,262,3,259,222,22,3,0,0,0
29374,3615,128,3487,3196,154,11,13,0,11
29375,100,6,94,67,7,0,10,0,0
29376,7888,392,7496,5564,1440,22,162,5,33
29377,826,95,731,595,82,2,0,1,7
29378,286,129,157,66,81,3,1,1,0
29379,18068,269,17799,10905,6190,37,51,3,38
29384,3968,59,3909,3278,463,9,8,1,2
29385,9005,834,8171,5528,1974,16,204,1,51
29388,16017,1050,14967,12157,1956,33,144,1,59
29401,9145,286,8859,7813,729,9,86,2,23
29403,21363,688,20675,11864,7732,41,266,14,61
29404,2161,331,1830,1271,312,5,71,20,14
29405,25620,1388,24232,8382,14714,68,272,7,76
29406,32730,7812,24918,10650,11997,99,745,24,203
29407,35373,1715,33658,22201,9389,57,724,81,95
29409,1957,78,1879,1627,160,20,48,5,1
29410,20238,2669,17569,13063,2387,52,862,19,161
29412,39687,1205,38482,31827,4543,78,487,15,135
29414,45150,2345,42805,33153,5911,85,1470,51,221
29418,24154,3736,20418,7978,10756,72,552,38,129
29420,23619,3258,20361,9225,8832,61,903,54,166
29424,768,73,695,625,46,0,7,1,1
29425,0,0,0,0,0,0,0,0,0
29426,1654,70,1584,651,850,5,4,0,13
29429,3899,101,3798,2485,1126,6,59,1,12
29431,6040,125,5915,5140,494,20,26,0,16
29432,2685,21,2664,1683,901,15,11,0,5
29434,658,42,616,465,93,3,7,0,5
29435,3819,109,3710,2743,604,148,12,3,9
29436,4198,77,4121,1794,2157,24,18,2,11
29437,2389,60,2329,1416,802,22,2,1,0
29438,3137,80,3057,2333,625,7,5,2,5
29439,1891,19,1872,1793,7,4,8,0,6
29440,27451,1322,26129,13258,12118,42,113,14,50
29445,60558,7383,53175,32542,13539,278,2317,66,834
29446,1115,22,1093,314,745,0,1,0,5
29448,2337,71,2266,1399,749,22,6,1,8
29449,8018,337,7681,3931,3473,11,35,4,19
29450,3400,141,3259,1309,1850,5,3,2,10
29451,4417,101,4316,4143,15,2,35,2,16
29452,343,1,342,87,246,1,0,2,0
29453,1156,13,1143,661,447,1,0,0,4
29455,28344,2327,26017,20518,4235,54,202,13,105
29456,37577,4783,32794,18747,10362,192,1227,35,240
29458,2489,20,2469,1118,1291,3,5,0,10
29461,42402,2355,40047,25251,11797,237,488,36,182
29464,51287,1737,49550,44308,2715,71,944,13,146
29466,42316,1640,40676,35649,2406,55,1042,15,114
29468,1722,7,1715,320,1344,3,3,0,4
29469,833,8,825,753,22,4,3,1,0
29470,4598,474,4124,2725,1231,18,11,0,16
29471,1510,38,1472,761,657,1,12,1,7
29472,10279,362,9917,5574,3669,257,14,3,35
29474,2412,78,2334,1630,557,26,0,3,4
29475,2601,126,2475,1661,734,4,2,0,10
29477,6344,108,6236,3244,2688,43,37,7,11
29479,6598,113,6485,2424,3750,36,17,6,31
29481,1705,33,1672,817,779,13,1,0,3
29482,1891,47,1844,1770,7,0,16,0,1
29483,56778,3671,53107,37357,11456,256,695,42,274
29485,57181,3666,53515,38185,10474,236,1256,79,293
29486,41148,4025,37123,25755,7792,203,714,21,260
29487,2848,82,2766,1419,1234,12,10,0,10
29488,21790,849,20941,11557,8252,97,162,5,65
29492,19619,840,18779,16499,1097,43,396,9,63
29493,115,10,105,70,30,0,0,1,0
29501,46528,1688,44840,26021,15534,89,1661,27,136
29505,25269,770,24499,13622,9662,50,412,3,38
29506,19967,496,19471,5551,13129,51,58,10,104
29510,10392,272,10120,5259,4625,17,21,1,16
29511,5550,184,5366,4684,455,23,9,1,8
29512,17941,471,17470,6204,10339,297,83,5,23
29516,746,11,735,465,205,37,0,0,0
29518,1115,34,1081,643,395,5,4,0,5
29519,160,2,158,53,101,3,0,0,0
29520,13046,281,12765,6265,5680,57,167,4,46
29525,1780,28,1752,503,1076,116,0,0,0
29526,51403,3737,47666,36938,7568,218,555,30,196
29527,26343,1800,24543,16641,6571,74,122,11,89
29530,3014,228,2786,2233,465,5,3,0,3
29532,19572,396,19176,8536,9993,45,71,3,34
29536,15260,536,14724,6065,7740,300,47,0,33
29540,4710,56,4654,1932,2581,9,4,0,27
29541,9357,276,9081,4960,3784,29,32,3,16
29543,617,8,609,442,136,16,1,0,0
29544,6788,261,6527,5873,380,42,15,3,11
29545,1615,45,1570,1090,411,4,0,1,2
29546,2315,173,2142,838,1225,3,4,0,0
29547,2601,109,2492,1097,1222,67,6,0,18
29550,30013,930,29083,19144,8692,69,203,1,61
29554,8346,115,8231,3746,4271,6,15,1,17
29555,5878,85,5793,3823,1780,23,27,1,11
29556,11530,134,11396,2915,8138,23,105,0,15
29560,12668,278,12390,4699,7228,45,66,1,28
29563,2288,47,2241,1275,864,30,2,0,2
29564,868,10,858,89,743,1,0,0,9
29565,6477,146,6331,3324,2636,102,6,1,11
29566,21792,1087,20705,17297,2259,106,197,29,60
29567,563,20,543,196,236,66,0,0,7
29568,15287,597,14690,10552,3336,61,136,5,37
29569,17048,737,16311,10995,4520,69,76,8,29
29570,3676,35,3641,1895,912,601,9,1,8
29571,14423,253,14170,5268,8366,50,82,0,26
29572,10711,625,10086,9073,449,29,178,0,33
29574,10232,232,10000,4142,5504,46,37,0,15
29575,18135,659,17476,15892,448,36,274,64,39
29576,32476,831,31645,29493,880,56,227,12,88
29577,34109,4639,29470,21961,4682,110,783,37,226
29579,50378,3661,46717,38808,3778,130,1143,30,381
29580,1174,7,1167,167,985,0,0,0,0
29581,3882,197,3685,2692,835,26,8,1,3
29582,18897,822,18075,16649,635,71,145,11,68
29583,4858,148,4710,2997,1537,10,16,0,14
29584,2429,59,2370,1900,334,11,4,0,5
29585,16574,420,16154,14277,1295,34,71,11,41
29588,48113,4679,43434,36957,3089,145,772,60,178
29589,85,0,85,9,74,0,0,0,0
29590,3415,239,3176,616,2472,33,15,0,1
29591,4516,146,4370,3113,1109,12,12,0,9
29592,1128,12,1116,550,523,16,1,0,2
29593,1637,25,1612,802,749,13,2,0,0
29594,112,4,108,44,43,10,0,1,1
29596,2345,27,2318,1396,709,75,7,0,7
29601,13261,716,12545,8682,3272,17,180,5,22
29605,36970,4916,32054,17150,13257,52,240,26,161
29607,44216,3346,40870,25950,11252,59,1647,66,249
29609,31547,4100,27447,21242,4249,52,465,65,132
29611,32413,8788,23625,12736,9340,67,227,13,135
29613,2186,74,2112,1831,151,0,88,0,3
29614,1707,127,1580,1343,64,0,122,6,5
29615,38684,3627,35057,26885,4646,58,1831,38,211
29617,28394,7205,21189,15581,4066,60,351,21,87
29620,12376,155,12221,8090,3693,13,37,5,24
29621,44601,1994,42607,32188,7716,70,897,2,151
29624,14819,1169,13650,6783,6003,38,46,7,62
29625,28521,1277,27244,20348,5208,32,355,13,94
29626,13023,693,12330,9295,2380,23,41,6,37
29627,18871,591,18280,15195,2208,45,59,1,51
29628,2454,45,2409,1124,1166,11,6,0,13
29630,15651,915,14736,11728,1528,29,677,9,68
29631,17291,755,16536,13233,1204,41,1362,4,88
29634,6207,326,5881,4842,557,12,172,2,8
29635,1305,22,1283,1227,11,0,3,1,5
29638,2977,57,2920,2339,480,4,9,0,8
29639,1703,71,1632,1216,336,6,10,2,12
29640,32191,2093,30098,25813,2453,92,118,15,92
29642,35675,1966,33709,29391,2311,61,441,7,132
29643,2892,58,2834,2644,51,6,15,0,5
29644,22357,1903,20454,15274,4045,30,122,31,71
29645,10584,760,9824,7658,1590,27,21,1,49
29646,26783,3139,23644,12135,10462,29,142,6,83
29649,27485,1178,26307,17470,7339,53,486,29,61
29650,38721,3658,35063,27195,3539,50,2595,7,174
29651,50778,5885,44893,36872,4790,93,902,31,205
29653,4548,121,4427,3218,1037,4,19,3,13
29654,10226,234,9992,8620,962,14,23,0,35
29655,7323,135,7188,6221,640,24,21,0,21
29657,15614,607,15007,13558,537,63,48,0,36
29658,283,8,275,261,1,0,0,0,1
29659,98,2,96,73,16,1,0,0,0
29661,5963,315,5648,5164,156,13,20,0,12
29662,14812,1506,13306,8166,4108,25,287,20,61
29664,1727,40,1687,1597,6,0,6,1,4
29665,199,4,195,175,0,0,1,0,6
29666,6685,169,6516,5272,1005,9,22,3,17
29667,243,3,240,221,15,0,0,0,0
29669,13839,769,13070,10875,1454,33,43,3,58
29670,9459,391,9068,6912,1487,17,133,3,43
29671,18615,481,18134,16477,652,51,40,3,44
29672,12703,503,12200,10996,551,27,170,1,20
29673,29898,2173,27725,20123,5532,61,538,9,151
29676,5641,81,5560,5343,12,9,20,0,6
29678,23700,1203,22497,17182,3661,49,300,9,78
29680,34784,3418,31366,22474,6520,67,554,35,177
29681,63257,4878,58379,46229,6653,104,2461,21,367
29682,4051,59,3992,3791,14,2,14,0,18
29683,324,24,300,287,1,0,2,0,0
29684,4722,82,4640,4023,399,4,15,1,10
29685,1806,44,1762,1686,8,2,2,0,6
29686,1116,32,1084,1011,10,1,4,0,3
29687,44124,4915,39209,31363,4756,78,1181,17,190
29689,4335,94,4241,3951,128,7,16,3,17
29690,22912,968,21944,19158,1434,64,137,14,84
29691,11142,1556,9586,8697,264,28,34,4,20
29692,4602,100,4502,3615,642,14,12,0,13
29693,14614,554,14060,12864,492,45,34,0,37
29696,4759,344,4415,4074,79,15,12,0,4
29697,13344,1071,12273,10677,1021,52,68,4,16
29702,9804,235,9569,8361,758,35,43,3,24
29704,3648,139,3509,2763,443,69,25,0,13
29706,19346,496,18850,9926,8025,68,80,3,87
29707,32759,2586,30173,24640,2622,60,1447,9,134
29708,40227,2620,37607,29354,2878,101,3460,6,142
29709,5911,73,5838,4159,1452,27,17,0,10
29710,39272,2105,37167,30685,3693,128,577,10,191
29712,2327,84,2243,1762,335,24,4,0,12
29714,2945,91,2854,1957,733,15,10,2,0
29715,41491,3803,37688,28098,4904,129,2338,19,179
29717,1364,31,1333,1101,174,9,4,0,3
29718,3827,177,3650,2460,980,17,23,0,19
29720,51198,3448,47750,31950,13509,122,296,4,160
29724,49,6,43,27,1,1,3,0,0
29726,1817,82,1735,1376,261,22,9,0,2
29727,1473,74,1399,915,406,5,6,0,2
29728,9849,915,8934,5231,3235,37,41,0,19
29729,2178,67,2111,1415,547,11,24,0,16
29730,57325,3482,53843,28168,21289,1030,768,38,247
29732,59417,4717,54700,38725,12025,236,1207,29,244
29733,1710,106,1604,815,733,7,19,0,2
29741,1882,49,1833,1417,341,6,1,0,7
29742,2388,71,2317,1868,341,21,2,0,2
29743,1384,28,1356,1282,36,4,4,0,0
29745,32602,1751,30851,24118,4737,136,340,9,112
29801,27613,1369,26244,13777,10977,70,205,14,145
29803,40056,2022,38034,29360,6094,84,757,16,156
29805,5910,405,5505,4356,878,23,15,5,15
29809,2262,99,2163,1336,706,1,10,1,8
29810,3896,80,3816,613,3098,12,4,0,10
29812,11107,300,10807,5900,4357,18,132,13,34
29816,703,102,601,481,82,2,2,0,1
29817,4154,75,4079,1580,2354,20,12,0,10
29819,1449,78,1371,856,464,3,3,0,3
29821,1368,46,1322,918,297,10,9,0,15
29824,7552,366,7186,3912,3008,31,34,0,8
29826,136,9,127,21,99,0,0,0,1
29827,3547,101,3446,1164,2188,29,13,1,3
29828,738,41,697,512,139,7,2,0,3
29829,12567,1118,11449,7373,3308,44,131,10,51
29831,3698,103,3595,2486,902,18,19,3,14
29832,4672,277,4395,1980,2263,5,21,4,5
29834,500,31,469,353,71,1,3,0,0
29835,6231,67,6164,3468,2478,17,27,2,21
29836,412,5,407,132,268,0,0,0,1
29838,544,9,535,507,4,1,2,0,0
29840,186,2,184,32,151,0,0,0,0
29841,32919,2882,30037,20570,7426,88,374,27,134
29842,8066,761,7305,4292,2530,48,25,6,32
29843,1155,25,1130,882,215,5,7,0,1
29844,102,0,102,86,10,3,1,0,0
29845,1110,11,1099,527,528,4,3,0,1
29847,5302,475,4827,2711,1892,15,16,0,21
29848,768,34,734,519,189,0,0,0,0
29849,279,6,273,146,117,2,0,0,0
29851,8534,667,7867,6149,1238,49,38,3,17
29853,6161,222,5939,3239,2417,28,17,1,17
29856,2698,446,2252,1788,301,17,11,0,12
29860,17178,818,16360,12886,2544,26,193,2,100
29899,899,19,880,297,582,0,0,0,0
29902,16692,1338,15354,11170,3046,36,317,25,78
29904,1975,574,1401,1054,220,6,73,8,2
29905,2502,492,2010,1560,319,6,48,0,0
29906,22608,3298,19310,10877,6830,63,342,45,123
29907,14052,1000,13052,10364,1913,31,173,10,56
29909,23621,1042,22579,20549,1125,23,286,7,61
29910,49140,9695,39445,33101,3625,97,735,14,154
29911,1320,25,1295,896,361,2,0,1,0
29912,20,5,15,6,5,0,0,0,0
29915,557,19,538,496,14,0,5,0,2
29916,1362,20,1342,809,493,2,0,0,4
29918,4832,406,4426,1419,2929,11,20,1,1
29920,9214,391,8823,4580,3946,18,25,3,37
29921,204,4,200,56,140,2,0,0,0
29922,999,59,940,171,728,3,4,0,6
29923,354,8,346,39,297,0,2,1,1
29924,4038,58,3980,2218,1582,5,67,1,11
29926,24832,4214,20618,17977,1835,28,160,2,77
29927,9095,2554,6541,3481,2679,35,79,5,41
29928,15538,937,14601,13680,350,21,144,3,60
29929,1048,46,1002,706,267,6,0,0,1
29932,219,25,194,61,115,3,2,0,0
29934,1002,95,907,173,689,0,1,3,9
29935,3859,302,3557,2166,1142,6,74,3,19
29936,14196,2292,11904,6030,5351,27,81,13,46
29939,202,2,200,50,148,0,0,0,1
29940,3789,127,3662,1207,2335,12,17,0,12
29941,304,0,304,288,9,0,1,0,1
29943,396,27,369,102,245,0,0,1,0
29944,4556,85,4471,2188,2148,10,8,11,4
29945,4207,87,4120,1021,2955,10,4,2,18
30002,6103,241,5862,3580,1751,7,215,2,36
30004,68607,6761,61846,40014,6391,122,12020,22,399
30005,39308,2991,36317,19210,3983,59,11002,16,320
30008,32435,11005,21430,6875,12294,56,759,20,326
30009,19256,2013,17243,12327,1730,28,2143,10,133
30011,18827,2464,16363,11484,2949,25,830,7,120
30012,30307,5471,24836,8162,15142,61,294,5,160
30013,29181,1931,27250,5173,20079,55,657,72,189
30014,39247,2480,36767,20826,13682,69,503,30,247
30016,58428,3981,54447,17233,33956,103,418,59,403
30017,24642,2420,22222,9522,9624,66,1731,9,227
30018,77,0,77,77,0,0,0,0,0
30019,50761,7132,43629,26083,12032,69,3103,9,345
30021,25442,1014,24428,2747,14197,37,6288,8,167
30022,66667,6324,60343,36202,7777,78,12860,23,509
30024,87115,7147,79968,38188,9500,136,28297,32,506
30025,10430,304,10126,7611,2016,14,74,0,47
30028,30318,2982,27336,23968,1119,36,823,14,124
30030,32364,1716,30648,21190,5551,45,1865,14,186
30032,44697,2339,42358,7249,32571,87,738,14,282
30033,33189,2228,30961,19439,4624,57,5133,10,210
30034,47450,1170,46280,1281,43188,83,242,7,255
30035,22671,952,21719,895,19687,53,327,6,116
30038,43683,1075,42608,1166,39911,52,140,7,224
30039,48933,6100,42833,8773,29659,94,2002,29,368
30040,81191,10134,71057,53042,3772,148,10295,26,487
30041,72489,6170,66319,45412,1958,152,16070,28,304
30043,88453,18110,70343,31996,20760,143,13488,40,620
30044,94774,33506,61268,20268,23510,153,14073,34,593
30045,42230,7824,34406,10488,19265,75,2696,28,311
30046,40227,12074,28153,9968,13207,74,3391,5,236
30047,69172,16891,52281,23754,13219,120,12275,22,455
30052,74442,7814,66628,36474,24736,141,1703,35,575
30054,12659,644,12015,8371,2985,5,130,8,52
30055,3647,117,3530,3167,162,2,6,2,8
30056,2685,131,2554,2225,222,3,5,1,6
30058,59445,2235,57210,1595,53183,63,305,9,349
30060,39890,15953,23937,10881,10647,86,902,26,243
30062,66889,6988,59901,42094,7114,90,6771,22,686
30064,50568,5134,45434,30844,10375,66,1682,11,385
30066,62417,6234,56183,37820,9627,108,4649,18,744
30067,47653,6582,41071,19691,12920,106,3930,19,1381
30068,34870,2233,32637,24313,2271,25,4078,16,266
30070,80,1,79,59,8,0,1,0,0
30071,25629,12551,13078,4234,4662,34,3310,19,165
30072,625,54,571,402,105,5,6,0,8
30075,56161,4553,51608,42281,4198,50,2329,14,337
30076,43786,9145,34641,24326,5741,48,2329,16,388
30078,38350,4633,33717,13854,13577,51,4226,15,319
30079,3696,255,3441,818,2162,20,241,0,26
30080,52125,8386,43739,21220,15457,97,4385,16,392
30082,28323,3900,24423,13002,8221,40,1623,6,212
30083,58064,3506,54558,5069,42386,124,4696,7,383
30084,41654,10481,31173,13771,9505,75,6111,13,294
30087,38743,3237,35506,8651,23154,92,2013,18,268
30088,27945,1398,26547,1062,23871,59,452,9,205
30090,0,0,0,0,0,0,0,0,0
30092,35988,6135,29853,15775,9101,61,3220,15,244
30093,55364,30444,24920,5006,12851,60,5575,25,343
30094,33745,2311,31434,10059,19124,54,594,13,293
30096,69953,17387,52566,19452,17129,115,12894,31,492
30097,50308,3569,46739,16741,6783,56,21204,22,287
30101,61989,6109,55880,39880,10776,104,1941,23,430
30102,43463,6722,36741,27153,5457,85,1483,12,361
30103,15606,846,14760,13014,871,37,143,1,64
30104,4910,162,4748,4131,389,8,14,2,14
30105,2283,63,2220,2079,44,0,9,0,9
30106,24020,4132,19888,5157,13178,62,521,13,131
30107,16528,765,15763,14754,159,27,86,3,60
30108,8018,207,7811,6485,878,16,29,3,46
30110,14327,292,14035,12525,775,26,125,9,36
30111,8,2,6,1,2,0,0,0,0
30113,6169,96,6073,5687,147,8,13,3,16
30114,59139,9844,49295,41857,3894,121,728,28,259
30115,49804,4588,45216,39892,2154,93,684,19,242
30116,24497,2112,22385,17308,3715,50,229,3,128
30117,37644,4562,33082,22270,8749,90,373,5,122
30118,1324,139,1185,358,781,4,12,0,2
30120,42702,4943,37759,29444,5732,113,403,21,189
30121,25089,2833,22256,16922,3613,43,498,10,109
30122,24044,3543,20501,6169,13012,27,326,17,138
30124,3035,72,2963,2683,161,4,13,1,6
30125,24607,4935,19672,16002,2669,62,131,8,73
30126,40305,7782,32523,11661,18065,52,976,7,265
30127,68574,7434,61140,28100,28240,111,1217,38,519
30132,46580,3462,43118,30683,9378,94,622,34,299
30134,46874,5207,41667,17409,21414,138,407,49,317
30135,67508,6563,60945,24045,32027,156,1252,37,528
30137,1532,229,1303,1088,106,10,14,1,8
30139,4423,126,4297,4056,50,6,19,1,2
30141,23616,2017,21599,12802,7138,62,295,20,186
30143,24476,924,23552,22154,198,71,145,1,56
30144,53984,6662,47322,29035,11450,132,3087,24,558
30145,8568,398,8170,7194,502,23,33,1,17
30147,4265,168,4097,3719,150,11,22,0,24
30148,1655,35,1620,1569,3,1,14,0,1
30149,1655,117,1538,1309,125,3,36,1,60
30152,44340,4436,39904,27340,7926,58,2118,16,390
30153,19445,756,18689,14961,2647,52,108,8,88
30157,50727,3685,47042,34252,9563,112,500,38,282
30161,35382,2335,33047,23723,7399,79,361,6,111
30165,41943,8409,33534,25235,5722,70,794,12,157
30168,26544,6317,20227,2803,16303,42,206,8,182
30170,3075,74,3001,2708,141,2,30,0,2
30171,3617,138,3479,3280,47,1,8,0,8
30173,6287,201,6086,5503,320,20,29,3,5
30175,6571,234,6337,5917,47,16,30,0,10
30176,7195,95,7100,6589,227,10,36,0,27
30177,497,38,459,398,23,3,7,1,5
30178,4074,199,3875,3571,83,4,18,2,9
30179,18577,798,17779,14464,2180,61,149,7,60
30180,39398,2630,36768,24206,9560,86,627,9,274
30182,2694,63,2631,2466,32,8,35,0,4
30183,6406,257,6149,5655,193,18,41,3,16
30184,7501,313,7188,6557,187,23,46,4,35
30185,3998,105,3893,3461,199,8,12,0,15
30187,9114,625,8489,6570,1418,36,88,3,50
30188,67972,8015,59957,49214,4927,95,2085,22,554
30189,39327,4196,35131,29322,2837,84,757,15,235
30204,12816,331,12485,7614,4328,10,83,2,35
30205,3638,128,3510,3169,112,12,33,0,14
30206,3086,46,3040,2543,385,7,6,0,7
30213,42518,2799,39719,3398,34617,51,347,9,254
30214,32135,3314,28821,11456,14633,75,1139,12,241
30215,37330,2198,35132,20847,10960,61,1411,10,298
30216,2102,53,2049,1172,766,3,6,1,22
30217,9058,191,8867,7477,877,27,36,4,27
30218,1892,54,1838,1191,563,10,6,0,0
30220,5436,187,5249,3661,1326,15,30,1,29
30222,4143,104,4039,2132,1747,19,5,2,12
30223,38111,2303,35808,19190,14740,95,332,13,130
30224,26696,1011,25685,16743,7667,52,263,9,96
30228,51000,4182,46818,12015,31465,99,1134,16,332
30229,21,0,21,15,0,2,0,0,0
30230,9145,344,8801,6410,1872,29,67,4,24
30233,26248,888,25360,18543,5636,39,112,8,140
30234,2035,81,1954,1113,735,6,7,0,17
30236,50446,7118,43328,7834,31091,123,2330,14,340
30238,41617,5151,36466,3455,30593,77,826,22,309
30240,30119,1380,28739,18023,9002,50,557,16,112
30241,25509,1154,24355,11259,11257,46,948,11,92
30248,29502,1997,27505,15631,10045,41,459,13,152
30250,800,80,720,333,387,0,0,0,0
30251,2244,58,2186,1509,593,9,10,0,11
30252,49702,2784,46918,26753,16765,95,936,30,313
30253,62025,5125,56900,14836,36356,107,2616,36,521
30256,2830,41,2789,2577,100,5,18,0,4
30257,4608,100,4508,3816,484,3,12,1,17
30258,2625,41,2584,2264,197,10,8,0,18
30259,3517,143,3374,2978,253,4,12,0,3
30260,27864,4462,23402,2816,15074,62,4512,9,130
30263,60467,5061,55406,36630,15169,119,896,31,268
30265,36697,3089,33608,24027,6013,69,1745,16,201
30268,10560,1171,9389,4445,4372,24,105,2,42
30269,39481,3382,36099,27357,3271,43,3486,17,271
30272,25,1,24,0,18,0,0,0,0
30273,18597,2426,16171,1886,13031,22,597,13,114
30274,34537,4370,30167,1898,25643,63,1495,15,185
30275,41,3,38,33,2,0,0,0,0
30276,18375,930,17445,14871,1570,35,216,5,91
30277,21256,1374,19882,17087,1339,45,415,9,78
30281,69540,6808,62732,19242,37386,132,2893,35,464
30284,25,6,19,10,6,0,1,0,0
30285,701,24,677,599,42,0,2,0,2
30286,24115,561,23554,15280,7222,50,136,1,88
30288,8610,1173,7437,531,6445,22,146,1,35
30289,44,3,41,29,9,0,0,0,0
30290,9256,582,8674,5221,2658,26,318,5,60
30291,25339,1898,23441,1157,21379,51,140,13,135
30292,6363,129,6234,5305,588,7,34,1,31
30293,2650,66,2584,1611,886,4,4,1,10
30294,43552,2868,40684,2308,36127,51,826,12,260
30295,4623,140,4483,3915,394,4,16,1,11
30296,27869,2740,25129,1102,22437,45,709,11,175
30297,29669,9730,19939,3232,14243,77,1610,11,146
30303,9352,1019,8333,1963,5408,18,578,12,52
30305,29173,1896,27277,21596,3164,54,1249,6,168
30306,25053,1765,23288,19252,1410,21,1295,2,152
30307,20807,1101,19706,14863,2831,13,903,4,126
30308,22121,1502,20619,10997,6366,41,2026,9,138
30309,31856,2368,29488,20318,4599,35,2943,13,189
30310,27365,884,26481,3265,21942,33,245,0,144
30311,33568,1131,32437,781,30596,64,70,4,157
30312,25435,1471,23964,10734,11001,39,933,9,147
30313,9788,580,9208,4716,3437,8,522,17,48
30314,20598,578,20020,756,18527,33,93,9,80
30315,34327,2533,31794,4437,25877,69,282,5,148
30316,33625,1949,31676,13277,16168,37,596,11,197
30317,13774,704,13070,7170,4773,26,339,8,65
30318,60392,4203,56189,19888,30337,123,3387,46,218
30319,44026,4862,39164,30074,4099,36,3063,15,242
30322,2943,156,2787,793,1575,0,337,0,0
30324,30942,3857,27085,14996,7063,58,3382,6,188
30326,8729,616,8113,5074,1705,19,933,0,44
30327,24789,1121,23668,19315,2032,34,1293,4,129
30328,40322,3454,36868,23117,5838,56,5983,25,252
30329,29506,9099,20407,12009,4528,32,2645,7,250
30331,60770,1741,59029,774,56352,102,184,9,257
30332,2531,191,2340,1875,148,5,196,0,7
30334,33,2,31,1,15,0,0,0,6
30336,1338,35,1303,27,1225,6,6,5,4
30337,11810,673,11137,1519,9086,31,104,1,72
30338,37650,2491,35159,22792,3588,21,7023,8,282
30339,31490,2156,29334,15492,9250,61,3031,8,238
30340,30529,14219,16310,6434,5112,63,3708,12,194
30341,35959,12055,23904,13543,5640,61,3340,9,231
30342,32494,6740,25754,19508,3273,20,1670,12,182
30344,35365,3932,31433,3491,26465,70,240,12,191
30345,25893,6572,19321,12208,4264,22,1709,5,134
30346,5643,500,5143,1801,1543,8,1529,6,57
30349,81320,2810,78510,1916,73227,118,717,24,546
30350,35882,4496,31386,16540,10529,52,2154,19,380
30354,16151,2469,13682,1741,11087,40,276,3,99
30360,16612,7238,9374,5450,1869,21,1391,6,90
30363,3721,282,3439,1290,1162,17,788,1,37
30401,13649,641,13008,7238,5302,14,126,2,28
30410,1611,87,1524,1111,365,1,2,0,1
30411,4582,136,4446,2202,2184,4,13,0,0
30412,123,4,119,99,17,0,0,0,0
30413,1351,42,1309,764,507,7,2,0,1
30414,23,0,23,18,2,0,0,0,0
30415,7580,285,7295,6194,609,25,46,8,29
30417,10908,1286,9622,6245,2987,14,68,11,21
30420,1921,209,1712,1379,248,7,4,0,1
30421,3303,206,3097,2367,629,7,8,0,2
30423,85,3,82,65,11,0,0,0,0
30425,1432,22,1410,1057,303,4,0,1,3
30426,924,6,918,521,368,1,3,0,4
30427,10798,1556,9242,6572,2235,20,70,4,40
30428,2741,91,2650,1906,634,5,4,0,9
30429,271,15,256,88,146,1,11,0,1
30434,5444,143,5301,1905,3244,3,39,0,5
30436,11691,1869,9822,7537,1883,12,40,3,32
30439,10161,1329,8832,5957,2562,19,61,3,26
30441,1916,46,1870,1070,763,1,1,0,1
30442,8515,296,8219,4456,3549,28,12,5,27
30445,3226,197,3029,1678,1254,6,25,0,4
30446,1491,34,1457,972,453,0,1,0,2
30448,47,20,27,16,6,0,0,0,0
30449,84,0,84,26,54,0,0,0,0
30450,2474,117,2357,1589,652,2,4,1,11
30451,44,0,44,30,11,0,0,0,0
30452,1540,58,1482,1035,384,3,5,0,5
30453,8946,1120,7826,4419,3146,7,51,2,16
30454,702,17,685,630,22,0,5,0,0
30455,674,26,648,449,171,9,1,1,6
30456,2014,41,1973,1052,809,5,4,0,8
30457,5899,147,5752,3617,1976,17,7,0,6
30458,48526,2915,45611,25853,17094,100,857,42,162
30460,24,1,23,13,6,0,0,0,0
30461,16534,670,15864,11244,3737,14,347,8,38
30464,69,12,57,27,27,0,0,0,0
30467,11973,230,11743,6703,4619,30,60,2,24
30470,848,25,823,777,34,1,0,0,1
30471,4594,179,4415,2987,1300,8,13,0,6
30473,2597,247,2350,1992,284,4,0,0,4
30474,16828,1278,15550,9542,5352,22,174,3,52
30477,2627,97,2530,770,1715,1,8,0,0
30501,29779,12270,17509,12209,3896,43,487,18,118
30504,27403,13000,14403,10529,2070,38,980,23,114
30506,45215,5031,40184,37330,606,68,421,11,133
30507,30573,14473,16100,11330,3305,57,640,4,98
30510,8612,1374,7238,6031,777,17,154,4,16
30511,3246,708,2538,2339,61,5,49,1,2
30512,22608,745,21863,20802,118,63,90,0,59
30513,11885,466,11419,10878,51,34,64,0,33
30516,1933,97,1836,1556,187,0,17,0,9
30517,17033,2040,14993,12172,1478,20,574,3,72
30518,56149,11536,44613,29152,7208,85,5497,21,293
30519,54608,8032,46576,26971,9851,61,7177,25,372
30520,4345,217,4128,3670,277,9,51,1,18
30521,5176,170,5006,4466,231,13,97,1,11
30522,1154,35,1119,1035,13,6,2,0,6
30523,13512,659,12853,11979,220,23,102,4,27
30525,7937,764,7173,6742,57,11,38,2,27
30527,4619,171,4448,4200,40,9,16,2,6
30528,23885,824,23061,21248,404,96,116,1,103
30529,12033,1011,11022,9126,1223,17,196,7,41
30530,6707,284,6423,5737,277,20,111,0,26
30531,11512,3388,8124,6810,455,22,461,5,41
30533,26589,1395,25194,23254,330,131,192,23,88
30534,30903,1923,28980,27013,239,75,278,16,104
30535,8309,624,7685,6995,173,18,100,22,32
30536,8764,617,8147,7780,29,19,52,0,15
30537,1476,158,1318,1261,6,3,6,0,0
30538,3020,109,2911,2620,109,8,9,0,4
30539,112,29,83,79,0,0,0,0,2
30540,19397,2801,16596,15775,85,36,74,0,55
30541,1707,65,1642,1584,3,3,1,0,3
30542,37575,6113,31462,26700,2275,77,965,12,128
30543,5001,1587,3414,2996,226,9,36,0,14
30545,895,24,871,802,13,1,19,0,2
30546,7625,228,7397,7104,11,19,44,0,8
30547,3312,114,3198,2945,84,12,38,0,8
30548,22960,1708,21252,18127,1314,32,994,5,69
30549,28696,1891,26805,22831,2074,37,612,8,117
30552,1717,80,1637,1584,5,4,4,0,3
30553,7788,472,7316,6210,770,7,39,0,20
30554,8394,713,7681,6955,297,19,70,2,21
30555,2100,63,2037,1929,2,6,6,0,2
30557,5094,150,4944,4448,257,6,53,0,4
30558,5578,339,5239,4910,86,14,31,5,12
30559,4699,78,4621,4379,9,23,5,2,14
30560,5110,109,5001,4755,15,15,39,1,6
30562,550,92,458,432,3,5,0,0,0
30563,5713,698,5015,4559,75,9,171,3,6
30564,4642,250,4392,4064,32,13,26,4,13
30565,4708,483,4225,3778,207,9,39,0,12
30566,8660,2686,5974,4670,815,8,242,5,28
30567,4610,493,4117,3372,279,19,200,4,24
30568,2147,161,1986,1874,20,0,10,0,3
30571,3244,67,3177,2925,51,9,22,0,6
30572,1198,30,1168,1099,2,5,5,0,1
30573,146,11,135,121,1,2,0,0,0
30575,1516,445,1071,959,27,5,15,0,2
30576,2642,178,2464,2364,15,2,2,0,2
30577,22726,723,22003,17816,2737,60,219,9,77
30581,80,9,71,68,0,0,0,0,0
30582,5620,213,5407,5037,118,16,42,2,27
30597,1681,185,1496,1310,61,0,38,0,22
30598,44,4,40,30,0,1,7,0,0
30601,25036,3845,21191,11080,8435,39,541,7,269
30602,1294,96,1198,1083,53,13,21,2,4
30605,43205,3455,39750,26223,8962,97,2502,13,297
30606,46798,4285,42513,28070,10464,99,1890,27,261
30607,11383,2733,8650,5234,2869,7,133,14,88
30609,3040,207,2833,2594,100,43,33,1,19
30619,1610,116,1494,1212,171,8,3,2,9
30620,15792,2065,13727,10114,2421,25,501,5,97
30621,6352,326,6026,5422,263,12,129,0,13
30622,11044,777,10267,8451,690,9,620,1,90
30623,96,11,85,83,1,0,0,0,0
30624,2895,104,2791,2309,358,1,50,3,5
30625,2515,93,2422,2173,171,5,4,0,10
30627,2295,74,2221,1724,313,0,100,0,9
30628,7303,616,6687,5371,962,15,41,4,5
30629,4950,163,4787,3916,396,6,274,0,14
30630,2411,141,2270,1551,606,6,12,2,4
30631,1554,72,1482,602,815,3,6,0,2
30633,8711,266,8445,7744,251,11,72,0,29
30634,2307,129,2178,1719,338,3,41,0,13
30635,15365,818,14547,9244,4717,24,104,0,38
30639,8,0,8,3,3,1,0,0,0
30641,2005,64,1941,1803,54,3,2,0,4
30642,14121,970,13151,8881,3732,17,150,2,52
30643,16655,521,16134,11890,3384,24,210,1,54
30646,7664,854,6810,5262,1053,20,80,1,40
30648,2741,84,2657,2028,500,4,9,0,8
30650,13631,521,13110,9000,3548,23,106,1,58
30655,27541,1061,26480,18602,6438,57,221,16,134
30656,17490,859,16631,12724,2718,35,438,7,99
30660,1029,91,938,657,230,1,17,0,1
30662,9149,445,8704,7220,1003,15,127,3,40
30663,3244,82,3162,2621,417,6,10,0,1
30664,17,0,17,6,11,0,0,0,0
30665,108,11,97,14,82,0,1,0,0
30666,10726,951,9775,7626,1348,12,383,2,47
30667,776,61,715,561,132,0,0,0,3
30668,1706,49,1657,1132,454,2,9,0,1
30669,3328,232,3096,1443,1503,11,28,0,4
30673,7255,265,6990,3522,3193,20,37,0,16
30677,20579,907,19672,17063,826,14,1020,0,81
30678,1219,61,1158,648,468,2,1,0,1
30680,46629,5912,40717,30663,6019,79,1791,7,262
30683,7252,728,6524,4728,1397,18,46,2,56
30701,41694,8168,33526,29239,1897,77,632,15,106
30705,33549,5499,28050,26470,228,66,117,1,50
30707,15839,280,15559,14340,490,39,64,3,49
30708,367,5,362,342,2,3,0,0,0
30710,6949,530,6419,5945,133,13,56,0,30
30711,3282,133,3149,3027,9,7,8,1,2
30720,27547,9404,18143,15106,1248,47,850,10,109
30721,53432,25470,27962,24343,1880,93,340,7,132
30724,29,6,23,21,0,0,0,0,0
30725,4750,139,4611,4177,135,4,21,2,33
30726,97,12,85,55,10,0,3,0,0
30728,18763,399,18364,16461,898,43,110,7,43
30730,1818,31,1787,1622,75,7,11,0,7
30731,2309,38,2271,2140,33,5,10,2,7
30733,2060,128,1932,1803,24,16,11,0,2
30734,3739,101,3638,3390,25,18,19,1,3
30735,6207,533,5674,5325,41,13,33,1,13
30736,43344,1333,42011,38551,859,101,551,22,89
30738,3962,58,3904,3708,19,5,15,1,6
30739,6335,152,6183,5723,197,2,32,2,23
30740,8394,766,7628,7102,152,9,72,1,26
30741,30309,1310,28999,25514,1573,101,260,29,66
30742,7698,215,7483,6360,429,31,251,41,15
30746,1335,61,1274,1213,5,1,10,0,0
30747,15001,458,14543,12351,1416,20,56,0,50
30750,4052,106,3946,3726,41,10,17,2,13
30751,86,5,81,77,1,0,0,0,0
30752,9602,201,9401,8780,40,52,67,0,27
30753,7619,783,6836,5642,875,15,28,0,19
30755,9930,875,9055,8389,179,20,75,0,14
30756,50,7,43,38,1,0,1,0,0
30757,1591,49,1542,1344,46,5,38,3,1
30802,6849,200,6649,5369,888,22,27,6,30
30803,770,14,756,605,107,9,4,0,4
30805,2748,206,2542,1793,534,18,34,6,8
30807,123,3,120,55,58,2,3,0,0
30808,4489,353,4136,3096,839,12,14,8,14
30809,51813,3228,48585,35417,7090,83,2896,69,305
30810,1976,28,1948,1783,114,0,7,2,0
30812,122,0,122,90,30,0,2,0,0
30813,49376,5365,44011,25159,13776,138,1384,101,286
30814,9509,562,8947,6643,1651,32,54,15,55
30815,40131,1792,38339,11838,24076,137,441,110,183
30816,2061,81,1980,1065,813,6,9,1,3
30817,7364,89,7275,4925,2079,17,18,3,10
30818,495,19,476,374,89,0,2,0,3
30820,1171,26,1145,892,236,0,0,0,2
30821,769,6,763,325,419,1,1,0,0
30822,37,3,34,30,4,0,0,0,0
30823,1712,37,1675,1057,572,1,7,0,4
30824,16832,413,16419,8094,7780,27,58,5,23
30828,3952,42,3910,1383,2422,15,11,1,8
30830,14885,386,14499,6543,7475,23,63,4,38
30833,3848,137,3711,1627,1955,5,10,0,8
30901,15978,322,15656,2284,12633,20,246,11,50
30904,24145,969,23176,10566,11090,56,349,24,117
30905,8301,2103,6198,4309,794,8,502,31,29
30906,58458,2711,55747,15240,37540,151,471,76,226
30907,50964,3196,47768,32849,8619,105,3193,98,272
30909,48181,2890,45291,18636,22682,110,1431,119,249
30912,5,0,5,0,0,0,0,1,4
31001,4333,111,4222,2272,1879,1,11,0,2
31002,2819,73,2746,2422,239,12,2,0,6
31003,127,2,125,96,16,0,0,0,1
31004,2,2,0,0,0,0,0,0,0
31005,20531,1240,19291,12593,4904,44,548,14,100
31006,4301,71,4230,2332,1761,8,14,2,8
31007,770,62,708,340,337,0,11,0,1
31008,20431,1250,19181,12980,5035,52,224,9,108
31009,1332,33,1299,1104,160,0,5,0,4
31011,875,26,849,609,211,0,6,0,5
31012,2505,71,2434,1455,938,1,9,1,1
31014,12915,476,12439,8942,3039,11,153,8,27
31015,18900,606,18294,8869,8687,17,174,4,62
31016,1631,33,1598,876,643,0,11,0,2
31017,1813,15,1798,1379,352,3,2,2,5
31018,2584,87,2497,954,1510,7,1,0,0
31019,2430,29,2401,1956,356,5,9,0,2
31020,1957,37,1920,959,874,3,9,0,5
31021,29051,762,28289,14165,12839,52,462,9,83
31022,1574,25,1549,1191,303,5,3,1,5
31023,14319,488,13831,9169,4189,18,70,7,39
31024,20802,1510,19292,13313,5220,32,106,1,39
31025,1651,45,1606,1155,374,6,14,0,3
31027,9969,410,9559,5592,3605,7,18,3,28
31028,6233,342,5891,3566,1603,32,380,1,44
31029,17440,448,16992,11461,4769,20,123,0,58
31030,17768,2007,15761,5644,9501,58,79,2,34
31031,5770,83,5687,3747,1708,20,19,2,17
31032,14261,237,14024,10937,2591,18,68,3,25
31033,2260,24,2236,1431,717,5,5,2,9
31034,44,2,42,4,35,0,0,0,0
31035,1162,20,1142,700,401,10,1,0,0
31036,10985,354,10631,6907,3335,13,88,7,48
31037,3645,194,3451,1778,1618,3,12,0,5
31038,822,22,800,591,172,0,1,2,0
31039,44,3,41,33,5,0,2,0,0
31041,681,4,677,299,339,0,15,0,2
31042,1507,65,1442,542,843,9,3,0,1
31044,2600,39,2561,1031,1451,1,14,0,5
31045,60,1,59,21,36,0,0,0,0
31046,3406,69,3337,2781,419,1,27,0,16
31047,16884,1083,15801,10512,3817,33,458,19,63
31049,1742,38,1704,1612,48,3,1,2,2
31050,855,17,838,706,77,5,3,1,3
31051,82,9,73,20,51,0,0,0,0
31052,8774,224,8550,5891,2254,14,108,1,50
31054,1568,73,1495,860,590,1,3,0,2
31055,6237,1688,4549,2537,1876,18,16,0,9
31057,1595,50,1545,582,925,1,4,2,3
31058,1759,74,1685,1429,170,4,14,3,2
31060,1543,41,1502,1238,218,2,9,0,0
31061,42450,1135,41315,21758,17683,68,599,23,185
31062,0,0,0,0,0,0,0,0,0
31063,4781,269,4512,1515,2802,7,107,3,9
31064,9880,398,9482,7041,2020,26,17,0,53
31065,1081,22,1059,602,414,0,0,0,2
31066,1095,15,1080,731,293,2,5,0,3
31067,159,2,157,87,59,0,1,0,4
31068,4377,138,4239,1317,2834,5,25,2,5
31069,22915,980,21935,13958,6766,23,307,8,84
31070,724,28,696,439,234,0,3,0,2
31071,1071,36,1035,581,412,0,11,1,1
31072,1275,71,1204,1016,125,1,18,1,2
31075,2647,101,2546,1943,490,11,5,0,11
31076,2814,70,2744,1654,1011,18,6,0,9
31077,1010,44,966,774,172,0,1,0,0
31078,3367,89,3278,1734,1378,2,7,1,16
31079,2580,64,2516,1678,769,1,17,1,5
31081,229,10,219,187,24,0,6,0,0
31082,10178,165,10013,4141,5572,6,58,0,19
31083,160,1,159,125,28,0,0,0,0
31084,42,7,35,30,2,0,2,0,0
31085,973,115,858,596,188,3,2,0,4
31087,8920,67,8853,2538,6078,21,39,2,12
31088,57034,4812,52222,29127,17369,106,2596,48,259
31089,4562,38,4524,1810,2598,7,9,0,7
31090,973,21,952,657,257,5,1,0,0
31091,4184,261,3923,1576,2276,6,11,1,5
31092,5602,433,5169,2439,2594,12,24,1,8
31093,28614,2525,26089,10244,13926,67,469,25,103
31094,1035,15,1020,589,401,2,3,0,0
31096,6964,75,6889,3798,2899,15,27,14,12
31097,1316,16,1300,1031,216,5,5,0,7
31098,2750,288,2462,1146,1050,13,38,0,16
31201,8882,244,8638,3025,5138,15,122,2,47
31204,30512,1039,29473,8469,19649,41,304,7,105
31206,26519,1470,25049,3442,20605,53,133,4,123
31207,1512,566,946,257,635,0,42,0,2
31210,35345,1435,33910,19582,11547,50,1557,6,99
31211,15867,379,15488,5975,8879,33,102,11,61
31213,0,0,0,0,0,0,0,0,0
31216,16379,995,15384,9866,4731,35,298,7,46
31217,17808,309,17499,6159,10640,28,49,5,53
31220,14984,440,14544,7662,5740,42,631,2,67
31301,4073,351,3722,1360,2038,5,30,16,20
31302,7542,519,7023,6021,514,30,44,3,36
31303,2365,51,2314,1664,558,3,4,0,9
31305,4401,88,4313,2910,1163,18,21,0,20
31307,1148,64,1084,936,65,9,1,0,5
31308,8146,226,7920,6706,762,29,39,5,9
31309,951,52,899,718,127,1,3,0,3
31312,24401,1149,23252,19200,2505,61,218,6,91
31313,41474,5178,36296,12522,19424,119,983,356,237
31314,2789,542,2247,1255,791,17,91,13,7
31315,6664,1308,5356,3051,1531,45,157,54,39
31316,12306,1021,11285,7210,3014,56,142,77,58
31318,572,58,514,406,48,2,8,1,3
31320,9790,467,9323,5611,3109,38,73,7,26
31321,6974,243,6731,4959,1373,12,52,13,19
31322,27931,2595,25336,14013,8155,71,1559,39,205
31323,1548,33,1515,360,1099,4,3,0,6
31324,33733,2928,30805,23164,4474,72,965,37,160
31326,22449,1489,20960,15561,3601,49,406,16,111
31327,128,4,124,56,46,1,0,0,5
31328,3430,68,3362,3156,27,15,39,3,7
31329,9760,452,9308,7071,1739,42,24,4,41
31331,6219,131,6088,4005,1848,11,22,0,9
31333,133,11,122,39,56,2,2,2,3
31401,22927,1460,21467,11403,7854,63,1363,27,115
31404,31530,1827,29703,10022,17657,61,848,47,115
31405,38069,2854,35215,16107,16245,78,1423,38,154
31406,34579,2598,31981,17711,11656,54,978,90,161
31407,20990,2229,18761,8152,8641,53,724,22,152
31408,11790,2552,9238,3262,5514,17,131,10,39
31409,670,81,589,505,34,9,8,6,0
31410,23782,849,22933,20041,826,39,935,10,104
31411,9378,210,9168,8668,97,0,184,0,24
31415,11034,272,10762,347,10104,21,16,4,17
31419,55413,5890,49523,23180,20870,122,2372,109,326
31421,62,10,52,27,8,1,11,1,0
31501,14036,514,13522,6417,6313,33,180,1,58
31503,22356,1049,21307,16082,4374,39,147,16,51
31510,9893,811,9082,7019,1716,5,39,4,32
31512,2052,273,1779,1464,245,3,4,0,2
31513,16156,1683,14473,10858,3080,27,114,1,30
31516,15539,722,14817,12945,1297,35,64,0,35
31518,699,49,650,579,52,0,6,0,0
31519,3550,256,3294,2500,621,6,19,1,3
31520,22726,2439,20287,8318,10887,35,163,13,92
31522,16892,499,16393,15506,303,21,120,4,62
31523,14803,963,13840,11045,1889,53,242,5,74
31524,6,1,5,5,0,0,0,0,0
31525,28766,2398,26368,16911,7379,63,641,70,121
31527,866,16,850,823,0,1,3,0,1
31532,688,39,649,593,35,0,0,0,0
31533,16714,2252,14462,7808,5914,41,165,9,44
31535,12506,1905,10601,7406,2765,3,84,3,13
31537,10500,1987,8513,5664,2370,35,109,2,28
31539,14372,2068,12304,9533,2295,28,51,6,34
31542,2604,19,2585,2422,72,5,9,0,2
31543,5192,132,5060,4737,69,8,5,3,19
31544,699,21,678,496,167,4,0,0,1
31545,16089,938,15151,11292,3230,19,79,1,63
31546,6771,413,6358,4511,1525,16,76,1,40
31547,2118,390,1728,1398,174,2,65,5,0
31548,22359,1485,20874,14296,4502,79,456,27,173
31549,1591,32,1559,863,656,2,2,0,4
31550,798,59,739,691,17,1,10,0,2
31551,927,82,845,773,33,1,3,0,1
31552,1176,52,1124,1048,11,6,10,1,4
31553,5140,71,5069,4597,262,17,10,0,3
31554,7510,493,7017,4658,2144,5,22,0,4
31555,2926,77,2849,2542,164,9,11,0,11
31556,42,3,39,38,0,0,0,0,0
31557,3242,165,3077,2727,228,4,15,0,8
31558,21348,1536,19812,14897,3281,76,287,22,117
31560,2800,113,2687,2280,297,6,3,0,15
31561,190,2,188,184,1,0,3,0,0
31562,2237,59,2178,2047,41,5,0,0,2
31563,1235,60,1175,934,206,4,5,0,0
31564,13,3,10,7,2,0,0,0,0
31565,2039,36,2003,1600,315,3,4,0,4
31566,3417,70,3347,2971,164,15,8,0,12
31567,743,29,714,674,21,0,2,1,0
31568,1162,21,1141,893,189,2,1,0,4
31569,5461,174,5287,3891,1006,23,32,12,27
31599,1094,163,931,267,656,8,0,0,0
31601,32331,2458,29873,10525,18087,57,188,20,85
31602,35999,2110,33889,17486,14200,96,646,16,154
31605,23682,1826,21856,12622,7011,72,747,39,145
31606,3894,251,3643,2992,502,16,14,0,11
31620,10822,728,10094,6600,3018,22,90,3,31
31622,1863,27,1836,1449,299,0,2,2,10
31623,146,14,132,56,66,1,0,0,0
31624,1596,317,1279,1207,35,11,4,0,0
31625,1123,76,1047,816,203,2,0,0,2
31626,3378,144,3234,1844,1267,23,6,0,9
31627,216,7,209,133,69,1,2,0,2
31629,902,52,850,432,372,4,2,0,6
31630,537,32,505,355,116,4,0,1,2
31631,531,51,480,392,47,16,0,0,1
31632,14053,724,13329,10414,2102,42,168,15,38
31634,5678,204,5474,3520,1723,21,20,6,28
31635,6653,320,6333,4471,1486,18,55,11,27
31636,10136,1074,9062,7327,1310,38,94,0,13
31637,3086,361,2725,2312,298,2,9,2,10
31638,941,58,883,516,328,2,2,0,3
31639,10305,417,9888,8321,1165,14,44,1,29
31641,2057,100,1957,1416,453,3,7,1,7
31642,4734,1347,3387,2524,714,14,10,2,15
31643,9252,471,8781,4372,4086,7,54,5,17
31645,4990,496,4494,3478,697,14,42,5,8
31647,3507,245,3262,1936,1216,2,3,1,14
31648,931,302,629,497,90,14,4,0,0
31649,732,19,713,607,72,2,9,2,1
31650,3154,619,2535,1820,627,10,4,2,3
31698,1642,109,1533,537,930,0,21,0,8
31699,729,123,606,366,169,6,29,8,5
31701,18133,298,17835,3106,14139,24,99,3,31
31704,98,25,73,36,28,0,4,0,0
31705,29858,1152,28706,6960,20902,54,89,6,76
31707,24623,623,24000,7614,15302,32,332,8,71
31709,15487,1259,14228,5925,7521,19,434,3,32
31711,895,33,862,581,245,5,3,0,1
31712,1155,20,1135,955,141,0,7,0,0
31714,6630,287,6343,2792,3349,4,41,0,16
31716,2685,143,2542,1552,876,9,11,0,9
31719,9335,302,9033,2901,5807,11,52,1,15
31720,416,24,392,170,211,1,2,0,0
31721,19652,459,19193,8116,10206,28,278,6,77
31722,532,100,432,336,72,1,2,0,3
31727,12,0,12,12,0,0,0,0,0
31730,9160,429,8731,3364,5106,16,67,1,15
31733,1577,64,1513,1388,84,1,3,1,1
31735,695,15,680,591,68,0,0,0,0
31738,2293,115,2178,1751,344,19,6,0,5
31743,454,23,431,112,299,1,1,0,3
31744,3135,111,3024,2421,494,12,20,3,8
31747,183,76,107,61,38,0,0,0,3
31749,2521,332,2189,1920,168,5,9,2,11
31750,18283,1095,17188,10161,6289,60,121,0,49
31753,17,5,12,7,5,0,0,0,0
31756,949,33,916,840,18,3,13,0,0
31757,11234,393,10841,7686,2607,30,128,2,34
31763,27963,812,27151,19270,6119,48,691,6,82
31764,1116,39,1077,565,455,1,11,0,5
31765,2477,144,2333,1588,678,5,10,0,1
31768,23050,3880,19170,11230,7165,44,149,8,49
31771,5809,1214,4595,3650,765,14,39,1,7
31772,439,7,432,337,75,3,0,0,0
31773,4005,137,3868,3246,461,31,18,0,13
31774,6735,532,6203,3880,2045,8,113,0,21
31775,2862,1091,1771,1481,217,2,13,0,5
31778,2592,162,2430,1999,329,5,10,1,9
31779,8883,331,8552,4342,3975,13,30,1,15
31780,1821,84,1737,959,722,6,6,1,2
31781,1510,26,1484,1190,214,1,9,0,7
31783,1062,25,1037,938,51,0,6,0,1
31784,652,59,593,486,87,0,1,0,0
31787,1511,55,1456,791,623,2,7,0,0
31788,11283,2682,8601,6653,1502,11,161,3,36
31789,1499,46,1453,1185,200,5,1,0,1
31790,1950,79,1871,1507,290,3,3,0,10
31791,11756,243,11513,6949,4145,26,67,8,29
31792,24374,808,23566,11530,10972,54,248,7,64
31793,8932,985,7947,6254,1272,8,186,0,15
31794,28012,3335,24677,13232,10108,41,441,2,72
31795,1978,144,1834,1381,387,8,9,0,5
31796,1597,18,1579,1221,332,0,1,0,2
31798,1139,117,1022,862,130,3,0,1,2
31801,2771,111,2660,2083,426,3,21,3,2
31803,4889,431,4458,2303,1977,7,31,10,8
31804,5946,266,5680,4649,636,11,76,1,27
31805,2633,94,2539,1524,826,6,30,0,19
31806,4337,170,4167,3174,856,4,18,2,7
31807,2855,127,2728,2258,284,14,28,4,8
31808,8737,560,8177,6463,945,26,273,18,36
31810,160,9,151,49,98,0,0,0,0
31811,6274,276,5998,4468,1109,21,52,3,22
31812,463,14,449,239,195,0,2,0,0
31814,88,2,86,40,41,0,0,1,0
31815,3136,1178,1958,584,1159,8,158,1,6
31816,5056,95,4961,2693,2076,6,35,2,9
31820,12697,1042,11655,7220,3113,20,602,18,64
31821,257,11,246,123,112,0,0,0,2
31822,5244,108,5136,3842,1058,11,27,1,25
31823,715,8,707,646,31,4,2,0,0
31824,1487,40,1447,607,793,0,4,5,4
31825,2269,38,2231,831,1304,2,13,3,0
31826,2007,33,1974,1119,795,6,5,0,5
31827,1734,36,1698,467,1196,1,7,0,1
31829,1531,68,1463,990,400,2,6,2,1
31830,2101,31,2070,1461,530,3,9,0,3
31831,3829,119,3710,2762,741,13,29,5,13
31832,173,0,173,114,49,0,1,0,0
31833,6913,132,6781,3715,2723,15,90,5,25
31836,938,11,927,465,437,1,3,0,1
31901,7126,491,6635,3073,3062,25,77,18,51
31903,20703,2331,18372,2238,14976,51,229,34,74
31904,36947,3061,33886,20712,9813,96,1239,64,259
31905,14094,2873,11221,8107,1285,68,467,214,66
31906,21835,977,20858,6087,13655,40,166,32,101
31907,60557,3719,56838,13486,39878,127,720,137,292
31909,38760,3401,35359,21697,9198,84,2165,91,198
32003,29142,2542,26600,22226,1569,77,1193,41,133
32008,5397,393,5004,4709,73,8,13,0,8
32009,3213,70,3143,2937,55,6,19,0,9
32011,15678,557,15121,13537,653,55,129,8,62
32013,5,2,3,3,0,0,0,0,0
32024,20106,1461,18645,15958,1477,81,272,7,46
32025,21886,1900,19986,14147,4554,67,282,12,120
32026,1863,140,1723,974,733,9,0,0,5
32033,4789,379,4410,3873,284,28,43,2,11
32034,38167,2062,36105,32181,2004,64,405,31,99
32038,10141,673,9468,8196,687,36,46,2,30
32040,7958,141,7817,7146,379,18,29,3,17
32043,30369,2691,27678,22850,2578,100,407,58,135
32044,1629,63,1566,1447,49,0,6,0,6
32046,9626,212,9414,8500,421,23,39,3,24
32052,8462,591,7871,4411,3171,28,27,0,22
32053,3815,824,2991,2214,640,7,14,0,4
32054,12789,583,12206,9550,2142,34,35,0,44
32055,16624,1012,15612,10066,4600,46,242,5,92
32058,4386,190,4196,3141,873,8,19,2,23
32059,2594,217,2377,2033,191,13,7,0,23
32060,22111,2409,19702,16399,2349,88,110,8,64
32061,364,24,340,298,11,0,3,0,3
32062,2547,223,2324,2063,144,11,11,2,12
32063,14360,700,13660,11157,1781,55,112,5,53
32064,7495,1225,6270,3751,2085,26,101,5,34
32065,40164,5645,34519,20679,8992,105,2057,73,250
32066,6844,845,5999,4829,1022,13,9,1,17
32068,57458,5534,51924,42410,4646,199,1114,94,257
32071,3854,335,3519,3199,95,13,14,0,13
32072,176,15,161,142,9,0,0,2,0
32073,43527,5941,37586,25350,7555,122,1771,89,241
32079,517,10,507,491,9,0,0,0,2
32080,21889,1151,20738,19419,180,30,293,11,105
32081,24672,2013,22659,19498,682,22,1209,26,110
32082,31861,1735,30126,27842,312,31,744,15,100
32083,2626,172,2454,1549,833,0,3,0,12
32084,34526,2789,31737,24954,4705,112,465,8,160
32086,31452,2381,29071,26324,839,65,492,20,133
32087,5507,116,5391,3500,1650,33,15,3,14
32091,17806,887,16919,12351,3757,45,97,10,58
32092,43691,4697,38994,32955,1900,78,1672,32,196
32094,2862,203,2659,2362,139,17,22,1,11
32095,16607,1544,15063,12679,778,55,704,0,75
32096,2791,89,2702,1893,693,15,7,1,5
32097,23564,1544,22020,18570,1812,74,271,10,99
32102,2768,314,2454,2359,6,12,4,1,2
32110,8776,620,8156,6665,1026,35,53,0,27
32112,7460,2517,4943,3685,888,13,91,4,27
32113,6396,546,5850,4727,786,22,19,0,26
32114,34943,3542,31401,13701,15134,92,724,21,226
32117,28223,2897,25326,15294,7993,86,533,14,196
32118,17906,1330,16576,14648,697,39,395,7,80
32119,22498,1679,20819,16542,2606,48,516,17,89
32124,8793,686,8107,5726,1787,19,293,1,43
32127,29999,1900,28099,25652,575,67,540,20,94
32128,20968,1497,19471,16933,695,44,880,4,102
32129,21594,1540,20054,17184,1199,58,695,17,97
32130,5485,1716,3769,3356,161,16,44,3,23
32131,4806,337,4469,3515,770,11,25,7,7
32132,8189,364,7825,7171,279,27,50,0,31
32133,310,33,277,258,10,0,2,0,0
32134,7938,356,7582,6988,52,64,28,3,22
32136,8432,374,8058,7511,101,22,86,3,37
32137,46258,4949,41309,34688,3317,107,1102,29,282
32139,1399,343,1056,948,33,1,11,0,3
32140,1822,109,1713,1590,49,13,5,0,7
32141,17955,738,17217,15892,375,50,135,8,41
32145,5608,406,5202,4185,757,24,12,0,12
32147,1219,66,1153,1067,29,5,5,0,2
32148,10979,1278,9701,8547,484,50,38,10,44
32157,506,153,353,321,8,3,9,1,1
32159,30455,1969,28486,26093,1075,50,438,8,98
32162,51905,908,50997,49436,430,30,381,7,93
32163,29064,642,28422,27424,269,18,262,5,54
32164,49412,6296,43116,33157,6014,120,1182,27,354
32168,30058,1500,28558,25398,1399,88,366,14,116
32169,10621,378,10243,9854,22,13,72,3,30
32174,53097,3318,49779,44047,2018,93,1407,17,190
32176,14410,727,13683,12758,130,43,229,5,69
32177,25380,1499,23881,15424,7230,97,200,7,91
32179,9075,584,8491,7756,204,42,41,4,34
32180,3834,1364,2470,2234,69,8,27,2,23
32181,2259,388,1871,1615,115,12,10,0,14
32182,20,2,18,16,0,0,2,0,0
32187,1667,78,1589,1332,185,1,3,0,3
32189,5887,571,5316,4736,306,27,23,8,13
32190,1115,408,707,546,122,7,3,0,3
32192,94,21,73,58,10,0,0,0,3
32193,983,64,919,731,134,2,2,0,3
32195,3462,276,3186,2813,196,3,34,1,14
32202,6544,339,6205,2538,3337,11,126,5,35
32203,4,1,3,0,3,0,0,0,0
32204,8673,613,8060,4745,2579,23,236,17,54
32205,29605,2385,27220,17950,6885,74,659,32,168
32206,18283,905,17378,3561,12845,37,94,10,96
32207,36207,5898,30309,20112,5969,65,2545,19,178
32208,33286,1039,32247,4661,26234,79,127,11,135
32209,36656,1088,35568,1400,32803,72,53,10,236
32210,66415,7537,58878,28221,24630,190,2279,45,441
32211,34168,6100,28068,13703,11232,111,1103,34,310
32212,1393,248,1145,743,246,9,68,8,3
32214,0,0,0,0,0,0,0,0,0
32216,42847,7958,34889,20932,7960,90,3718,34,285
32217,20543,3566,16977,12121,3144,25,761,13,145
32218,67040,4974,62066,23993,33438,173,1343,63,466
32219,14474,678,13796,5182,7816,47,120,6,106
32220,13037,789,12248,9647,1810,27,108,11,72
32221,30961,2983,27978,15584,9514,84,1346,16,243
32222,13564,1743,11821,5656,4631,42,720,6,96
32223,25600,2357,23243,19810,1345,39,703,11,158
32224,42395,4552,37843,28950,3735,68,2643,34,274
32225,57441,6322,51119,34562,8921,96,3961,117,324
32226,20306,1765,18541,12635,3898,58,686,15,134
32227,3799,722,3077,1932,750,10,163,22,18
32228,219,37,182,96,46,8,6,1,0
32233,23980,2152,21828,17167,2353,77,671,61,123
32234,7514,417,7097,5674,896,35,34,6,41
32244,63292,9525,53767,24413,22289,148,3318,85,427
32246,58105,10029,48076,29693,7745,153,6929,88,444
32250,30080,3031,27049,24113,873,64,591,8,149
32254,14545,821,13724,3956,8785,41,149,11,111
32256,53611,7088,46523,28668,8356,135,6174,74,479
32257,41439,5489,35950,26337,4578,81,2044,30,524
32258,37859,4171,33688,23427,4210,39,3666,19,290
32259,62169,5945,56224,45243,2795,104,4451,43,334
32266,7217,382,6835,6302,73,19,85,7,29
32277,33174,4624,28550,13280,12163,91,1113,27,236
32301,29686,2188,27498,11789,13501,76,773,13,138
32303,48644,3662,44982,24473,17129,87,1057,28,214
32304,50007,6275,43732,21817,17641,136,1782,17,250
32305,19199,1119,18080,6594,10439,51,140,15,61
32306,1711,266,1445,1179,91,4,82,0,3
32307,1207,49,1158,29,1103,10,11,0,0
32308,23355,1523,21832,15108,4757,37,828,23,136
32309,31189,1845,29344,23393,3596,52,888,6,106
32310,17209,1560,15649,6884,7981,55,75,6,64
32311,21218,1621,19597,11377,5350,47,1797,15,104
32312,34304,1943,32361,25019,3789,56,1997,21,120
32313,10,4,6,5,1,0,0,0,0
32317,14459,859,13600,9791,2125,20,1035,11,65
32320,3726,256,3470,2651,631,11,15,1,8
32321,6254,523,5731,4124,1340,47,18,1,25
32322,4213,253,3960,3060,725,8,7,0,25
32323,262,3,259,240,8,2,0,0,1
32324,4554,299,4255,1896,2172,13,24,4,16
32327,30048,1508,28540,22748,3993,141,183,19,115
32328,3721,153,3568,3351,37,18,8,1,7
32330,541,275,266,135,123,1,3,0,0
32331,4192,144,4048,2770,1063,14,14,0,12
32332,1411,170,1241,74,1153,1,0,0,1
32333,11499,701,10798,6140,4200,26,39,0,30
32334,1616,36,1580,1507,13,5,0,0,1
32336,1408,56,1352,815,463,6,9,0,5
32337,30,2,28,11,17,0,0,0,0
32340,10744,519,10225,5072,4855,20,19,0,27
32343,3621,203,3418,183,3125,1,19,0,33
32344,12705,565,12140,7587,4115,30,24,3,46
32346,1750,16,1734,1642,14,3,6,0,4
32347,7805,220,7585,6166,1013,52,69,0,16
32348,11782,586,11196,7422,3171,44,145,0,26
32350,1365,54,1311,1100,167,5,6,0,4
32351,16526,2808,13718,4412,8908,18,51,0,37
32352,5674,637,5037,1253,3645,11,11,0,3
32355,284,7,277,250,4,0,3,0,1
32356,117,3,114,113,0,1,0,0,0
32358,2185,51,2134,1830,191,12,6,0,6
32359,1837,44,1793,1697,9,5,10,0,5
32360,106,5,101,98,0,0,0,0,0
32361,237,5,232,206,14,2,0,0,0
32399,0,0,0,0,0,0,0,0,0
32401,20487,1649,18838,11606,5513,106,368,14,95
32403,141,42,99,66,14,0,9,2,0
32404,38186,2964,35222,26553,4772,160,1173,55,221
32405,28158,3366,24792,18941,3273,114,767,28,122
32407,14366,1254,13112,10721,1073,42,430,19,60
32408,17479,1107,16372,14262,638,90,338,22,58
32409,10394,424,9970,9140,152,46,73,19,13
32410,439,17,422,390,7,1,4,0,0
32413,15217,1171,14046,12558,309,79,291,9,72
32420,2289,84,2205,2005,52,15,14,0,7
32421,4214,128,4086,3785,61,17,6,0,0
32423,1213,81,1132,793,306,6,0,0,2
32424,7145,440,6705,4701,1533,47,36,0,6
32425,14419,557,13862,11941,1200,70,62,11,24
32426,778,23,755,170,545,2,3,0,9
32427,1293,25,1268,977,209,7,8,2,9
32428,17946,714,17232,13727,2392,110,101,19,47
32430,1095,18,1077,1019,4,10,0,0,3
32431,4981,178,4803,3558,881,31,11,1,12
32432,98,6,92,71,17,0,3,0,0
32433,18036,1471,16565,13493,1788,97,107,8,76
32435,6935,667,6268,5138,614,44,69,5,17
32437,612,23,589,442,95,13,2,0,4
32438,4363,231,4132,3687,32,59,24,0,12
32439,12943,1297,11646,10528,247,100,139,9,51
32440,7581,292,7289,5231,1748,29,15,9,18
32442,3569,97,3472,2921,361,20,9,1,2
32443,2975,97,2878,1384,1329,16,7,0,14
32444,19913,1387,18526,15020,1703,71,575,24,56
32445,2468,286,2182,1094,1022,7,0,0,7
32446,9970,477,9493,6749,2095,39,174,7,38
32448,8084,274,7810,5120,2290,40,42,4,18
32449,567,10,557,509,0,10,2,0,0
32455,4425,156,4269,3830,163,63,20,1,4
32456,7439,296,7143,5891,847,25,39,0,16
32459,20567,1988,18579,16913,257,77,359,14,96
32460,5409,368,5041,3312,1516,11,19,1,20
32461,2878,105,2773,2610,19,4,28,0,14
32462,3473,111,3362,2590,464,80,15,4,25
32463,166,10,156,137,4,0,1,0,1
32464,3858,77,3781,3596,13,31,14,0,1
32465,7251,280,6971,5781,849,41,20,0,18
32466,6195,244,5951,5476,72,33,16,1,11
32501,10960,410,10550,4591,5447,18,66,8,44
32502,4277,192,4085,2889,880,17,75,4,20
32503,33693,2071,31622,20827,7778,128,1143,50,297
32504,21791,1314,20477,15458,2812,99,823,21,99
32505,28671,1987,26684,9785,14165,174,907,30,153
32506,36017,2617,33400,21701,6702,227,1739,61,250
32507,31215,2043,29172,21594,4555,168,763,56,143
32508,5528,1161,4367,3348,556,18,168,1,60
32509,561,179,382,173,201,0,8,0,0
32511,1380,297,1083,746,148,7,66,7,12
32512,23,2,21,16,4,0,0,0,0
32514,40844,3096,37748,26638,7048,175,1321,34,248
32526,43029,2639,40390,27820,7413,322,1836,67,175
32530,142,15,127,103,9,4,0,0,0
32531,6532,271,6261,5564,189,61,30,11,29
32533,30517,1164,29353,22908,3779,223,566,29,141
32534,16006,1081,14925,9334,4189,150,298,17,58
32535,6043,252,5791,3526,1915,88,13,12,24
32536,25807,2761,23046,16219,3827,143,636,51,170
32539,31749,2714,29035,22195,3605,105,656,90,157
32541,18419,1557,16862,14514,494,52,480,13,147
32542,3834,785,3049,2097,441,12,126,19,22
32544,1509,264,1245,856,157,5,59,9,8
32547,35466,6045,29421,20853,4069,118,1530,71,229
32548,22399,2736,19663,14286,2761,68,902,40,137
32550,7828,418,7410,6844,100,18,154,0,37
32561,9241,368,8873,8255,32,31,126,3,28
32563,27329,1757,25572,22572,547,107,672,29,97
32564,3159,92,3067,2776,34,40,13,1,9
32565,6105,97,6008,5533,33,87,30,6,7
32566,44434,4101,40333,32460,2688,224,1381,126,291
32567,4210,219,3991,3380,256,39,30,0,19
32568,3093,50,3043,2542,186,102,7,3,12
32569,12378,1346,11032,8109,1121,63,584,41,67
32570,33144,1549,31595,26047,2348,238,532,94,152
32571,38885,2150,36735,31893,1202,231,811,67,174
32577,5316,137,5179,4382,357,69,39,10,25
32578,35075,2652,32423,27469,1214,88,1060,61,165
32579,10444,978,9466,7674,673,35,394,32,39
32580,4120,304,3816,3111,173,13,115,12,22
32583,31047,1937,29110,22814,3841,186,293,36,107
32601,22039,3166,18873,12765,3610,65,1230,7,146
32603,7367,1066,6301,4843,267,0,795,0,38
32605,24326,2768,21558,16376,2502,34,1259,8,146
32606,24380,2662,21718,15909,2396,34,2082,19,164
32607,35420,5904,29516,17361,7648,69,2597,30,185
32608,55540,8149,47391,29097,7855,95,7233,14,381
32609,18322,1871,16451,8073,6970,37,383,2,126
32610,19,4,15,5,4,0,6,0,0
32612,6498,925,5573,4927,282,0,274,1,2
32615,16524,1596,14928,11070,2588,56,320,8,85
32616,178,37,141,69,48,5,5,0,2
32617,4295,427,3868,3290,368,9,22,0,19
32618,7183,640,6543,4825,1181,20,83,5,33
32619,5007,401,4606,4300,57,15,18,2,5
32621,5396,702,4694,3874,480,19,23,6,27
32622,1456,48,1408,1190,159,1,2,0,4
32625,1620,52,1568,1488,19,7,8,0,5
32626,8620,436,8184,6930,732,30,86,0,28
32628,5343,321,5022,3395,1436,24,17,0,3
32631,311,20,291,275,6,0,3,0,3
32634,29,1,28,26,1,0,0,0,0
32639,325,9,316,292,8,0,0,0,2
32640,10281,498,9783,7371,1818,42,60,0,65
32641,13872,656,13216,3179,9431,21,56,2,66
32643,12549,989,11560,9942,935,41,82,1,48
32648,443,19,424,395,3,4,2,0,4
32653,14397,1421,12976,9051,2125,22,926,0,96
32656,14686,670,14016,12876,248,62,75,6,45
32658,299,44,255,159,59,0,7,0,5
32664,504,25,479,412,38,0,1,1,0
32666,5961,240,5721,5022,422,20,28,1,16
32667,4117,223,3894,3075,575,7,37,0,15
32668,5548,746,4802,4370,183,7,25,3,23
32669,15890,1752,14138,10866,1846,49,498,5,95
32680,10008,330,9678,9049,107,31,38,0,21
32681,133,15,118,79,25,1,1,0,0
32683,133,8,125,114,4,3,0,0,2
32686,4339,414,3925,2466,1264,6,13,1,16
32692,197,2,195,190,1,1,0,0,3
32693,12815,1019,11796,10305,788,48,55,0,44
32694,1962,111,1851,1406,279,18,22,0,12
32696,12784,1611,11173,8440,2037,26,103,3,57
32697,278,6,272,212,37,3,0,0,2
32701,23265,6098,17167,11544,3742,47,714,13,149
32702,3186,167,3019,2818,48,7,3,4,5
32703,54805,17755,37050,19901,12974,94,1508,26,425
32707,37704,10222,27482,21422,2854,71,1354,21,220
32708,47045,10139,36906,29894,2888,66,1686,27,263
32709,2691,440,2251,2024,55,5,18,4,17
32712,50085,13099,36986,24304,8692,84,1474,20,359
32713,22438,3283,19155,16517,1081,52,497,11,124
32714,38049,12548,25501,16458,5584,74,1400,9,249
32720,33568,5095,28473,22153,4157,68,607,10,178
32723,7,1,6,3,2,0,0,0,0
32724,40559,7353,33206,27759,2853,69,680,20,234
32725,50435,19171,31264,23198,4853,95,820,25,330
32726,23012,3784,19228,14364,3509,46,283,11,82
32730,5743,1581,4162,2911,873,6,119,1,23
32732,5596,356,5240,4771,138,14,62,0,25
32735,5812,666,5146,4348,469,18,81,6,26
32736,11412,1259,10153,9054,435,43,95,6,41
32738,47284,16775,30509,22483,5248,110,564,36,267
32744,3789,262,3527,3138,199,3,13,2,10
32746,45828,8039,37789,27257,3219,55,5010,26,326
32750,25261,5190,20071,16344,1421,44,967,16,147
32751,23230,3413,19817,15373,2450,33,699,7,240
32754,11996,467,11529,9933,843,58,71,6,46
32757,30315,5312,25003,19414,3655,74,659,24,100
32759,2951,79,2872,2540,207,5,22,2,7
32763,23391,5011,18380,15497,1453,65,375,7,76
32764,3238,277,2961,2623,110,11,20,1,20
32765,65228,13904,51324,38673,4853,83,4176,38,436
32766,16541,2687,13854,11367,646,20,936,10,92
32767,2939,201,2738,2548,21,9,6,0,13
32768,15,0,15,10,5,0,0,0,0
32771,57178,10870,46308,24636,14239,107,4402,38,377
32773,33990,10793,23197,14268,5729,99,1361,15,216
32775,36,4,32,29,0,2,0,0,0
32776,12456,2006,10450,9068,535,25,168,5,89
32778,23993,2664,21329,17016,2486,79,778,7,120
32779,29321,4037,25284,21392,1089,34,1320,9,159
32780,39525,3818,35707,28059,4695,100,783,28,192
32784,11212,1139,10073,9141,376,31,54,2,24
32789,26399,3050,23349,19254,1973,36,932,4,138
32792,51376,14537,36839,26973,4494,74,2530,33,388
32796,20818,1517,19301,15785,2041,89,253,18,89
32798,2501,361,2140,1980,59,7,28,0,7
32801,17728,3863,13865,9768,2238,30,926,13,128
32803,21003,3451,17552,14593,795,28,989,10,122
32804,19084,2385,16699,14313,782,29,600,11,118
32805,23331,3461,19870,2613,16110,44,222,7,135
32806,26582,4829,21753,18624,1224,55,611,16,126
32807,34384,20306,14078,8823,2563,37,1434,31,230
32808,52551,8104,44447,5801,35372,116,1022,13,509
32809,29478,16996,12482,6564,4087,27,896,37,206
32810,35925,8886,27039,11119,12617,65,1399,14,316
32811,42274,11613,30661,5253,21053,65,950,32,828
32812,34586,13176,21410,16206,2568,49,1036,20,238
32814,9218,1433,7785,6280,205,10,696,9,78
32816,8246,1577,6669,4807,842,8,552,6,67
32817,40376,12744,27632,18680,3473,58,3289,33,367
32818,48052,7883,40169,5808,29978,84,1914,30,655
32819,30857,6290,24567,15640,3363,48,2790,48,516
32820,10150,2900,7250,4973,1088,18,663,10,86
32821,25999,10855,15144,10922,1379,51,1418,82,229
32822,64120,42213,21907,12601,5735,77,1471,28,493
32824,57412,36297,21115,8707,6233,63,3556,74,721
32825,61755,30964,30791,18302,5685,105,4149,37,533
32826,33065,9811,23254,16207,3192,72,1975,14,317
32827,19042,7230,11812,7987,1047,26,1596,6,167
32828,68428,25005,43423,27536,6982,70,4949,57,673
32829,20629,10462,10167,5402,2066,36,1726,21,183
32830,55,16,39,28,0,0,0,0,3
32831,2619,389,2230,1118,1095,0,2,0,12
32832,34882,15303,19579,12353,2447,30,2617,32,356
32833,10542,3017,7525,5660,830,19,447,13,72
32835,45380,11925,33455,15023,8665,63,3357,49,1677
32836,23205,4808,18397,11679,929,41,3852,12,267
32837,56813,28226,28587,14927,4407,87,5288,92,871
32839,58641,21219,37422,9379,23353,97,1849,72,555
32899,0,0,0,0,0,0,0,0,0
32901,26286,3169,23117,15995,4674,72,1031,7,176
32903,13880,962,12918,11787,95,21,328,5,82
32904,35399,4057,31342,25371,1597,95,2231,22,230
32905,26064,4343,21721,15754,3777,70,574,6,187
32907,44432,7964,36468,25445,7265,82,964,31,287
32908,14420,2728,11692,7372,2917,37,239,6,172
32909,36789,6691,30098,20370,6740,101,619,41,271
32920,9984,624,9360,8494,217,43,157,6,51
32922,15923,3258,12665,6609,4984,48,128,14,74
32925,1308,218,1090,806,143,5,37,5,9
32926,22693,1864,20829,16405,2866,57,274,16,95
32927,27996,2381,25615,21667,1753,85,377,47,162
32931,13643,788,12855,11910,111,27,234,8,58
32934,18355,2059,16296,13907,700,34,649,7,96
32935,41837,5343,36494,30158,2512,115,1131,29,249
32937,27306,1955,25351,22818,335,65,600,29,124
32940,44869,4631,40238,33864,1643,68,2165,27,237
32948,6609,4271,2338,1877,326,5,9,4,20
32949,2538,184,2354,2080,108,9,39,3,17
32950,4545,280,4265,3776,149,8,67,3,21
32951,11525,519,11006,10446,44,10,120,2,29
32952,20670,1569,19101,17007,314,94,609,24,79
32953,24430,2073,22357,18739,1433,58,698,54,111
32955,40275,4203,36072,27925,4478,93,1180,36,219
32958,28619,2375,26244,23586,1199,45,362,6,78
32959,32,4,28,24,0,2,0,0,0
32960,21522,3067,18455,15172,1812,49,512,9,155
32962,26011,3774,22237,17356,3187,66,406,20,177
32963,16291,568,15723,15172,38,12,134,3,52
32966,19724,1794,17930,16289,559,26,363,1,80
32967,25785,3328,22457,15955,5281,47,278,5,116
32968,15006,1630,13376,12004,513,22,272,4,52
32970,253,25,228,32,172,1,7,0,0
32976,9618,257,9361,8940,61,22,32,2,26
33001,411,103,308,302,2,0,0,0,0
33004,16162,3997,12165,6576,4676,37,250,18,121
33009,43301,16824,26477,17378,6816,35,770,12,344
33010,43902,41446,2456,1714,468,13,61,1,73
33012,70260,66622,3638,2924,203,19,152,0,148
33013,31068,29330,1738,1349,173,8,45,4,68
33014,40261,35866,4395,3210,563,10,259,3,116
33015,65645,56213,9432,4230,3467,23,890,3,290
33016,45714,42372,3342,2392,288,13,318,2,130
33018,54273,49364,4909,3067,601,14,680,8,226
33019,15497,3645,11852,10606,379,13,261,2,95
33020,45044,16939,28105,14065,11340,71,793,20,443
33021,50091,18602,31489,21769,6466,62,1300,17,437
33022,18,11,7,0,4,2,1,0,0
33023,66749,22407,44342,5706,35086,113,1183,18,616
33024,74843,38288,36555,17899,11663,477,3844,19,676
33025,75455,29817,45638,6704,32651,73,3239,20,829
33026,30510,13328,17182,10722,3745,18,1363,13,253
33027,63726,33674,30052,9025,13852,49,4641,16,619
33028,28140,13732,14408,5790,4538,59,2740,6,242
33029,46202,24175,22027,8987,7585,38,3434,15,451
33030,36776,27000,9776,4248,4602,32,272,17,141
33031,6560,3924,2636,2182,195,16,112,1,26
33032,58727,40184,18543,4252,12125,35,878,5,330
33033,66871,48312,18559,6292,9939,39,819,27,371
33034,22850,12406,10444,2570,7415,18,99,3,84
33035,18065,10117,7948,2783,4358,19,230,6,153
33036,3541,540,3001,2873,13,9,17,0,6
33037,13875,3803,10072,9277,217,23,127,8,42
33039,0,0,0,0,0,0,0,0,0
33040,35958,9041,26917,21028,3666,73,725,38,226
33042,6841,803,6038,5592,95,14,64,6,44
33043,4661,636,4025,3731,52,9,47,2,30
33050,10479,3004,7475,6697,392,16,88,6,28
33051,790,102,688,645,19,0,7,1,5
33054,30352,12974,17378,723,15995,35,94,8,187
33055,42950,29938,13012,1551,10545,23,362,2,199
33056,36556,10345,26211,708,24580,26,145,1,168
33060,35793,7582,28211,12562,13877,38,307,4,257
33062,25293,2945,22348,20342,608,14,377,16,159
33063,56296,15432,40864,19297,15350,68,2373,20,919
33064,62429,16656,45773,21793,16230,99,910,11,1969
33065,59668,19499,40169,17045,17104,58,2587,8,929
33066,16845,3738,13107,9270,2196,14,406,5,270
33067,27564,5849,21715,14176,3668,26,1907,12,367
33068,53137,12427,40710,5912,30664,107,1654,9,614
33069,28817,7566,21251,9126,9963,27,812,4,286
33070,6220,1363,4857,4563,53,16,49,0,26
33071,40026,11799,28227,16289,7731,57,2006,19,466
33073,32853,8602,24251,13613,4815,32,1521,21,962
33076,41826,8745,33081,22763,3761,39,4011,16,457
33101,7,4,3,0,2,0,0,0,0
33109,684,92,592,516,8,1,23,0,9
33122,2126,1622,504,288,63,3,99,0,9
33125,53507,48332,5175,2724,1592,19,290,2,227
33126,48751,45517,3234,2174,278,13,407,1,137
33127,27692,14460,13232,1293,11209,28,114,7,108
33128,8213,7239,974,385,436,4,55,0,31
33129,15218,10831,4387,3347,191,4,230,1,105
33130,35609,25365,10244,6988,1029,21,849,2,333
33131,26213,13264,12949,9590,719,13,937,3,248
33132,18159,8828,9331,6088,1561,11,685,1,228
33133,34141,18468,15673,11328,2546,25,495,4,213
33134,38739,28831,9908,8117,322,17,616,7,149
33135,36232,33661,2571,1726,388,16,139,0,114
33136,15439,7762,7677,1157,5843,12,250,0,107
33137,25763,12864,12899,7409,3501,18,623,5,245
33138,27601,10877,16724,7658,7466,20,500,4,192
33139,36286,15975,20311,16506,1059,35,867,10,428
33140,19315,7951,11364,9913,269,12,309,4,187
33141,35995,23069,12926,9478,1278,33,655,8,331
33142,55425,36976,18449,1367,16270,32,89,7,221
33143,34853,20859,13994,9215,2082,16,1548,0,261
33144,25814,24035,1779,1378,95,1,143,1,61
33145,29737,24779,4958,3671,294,14,443,4,132
33146,16468,8341,8127,5015,1821,9,615,33,206
33147,48823,24631,24192,1082,22211,42,64,6,222
33149,14847,9900,4947,4001,27,3,106,0,88
33150,28703,9388,19315,1311,17203,34,140,4,128
33154,14792,6100,8692,7549,202,3,197,3,153
33155,43695,36793,6902,5598,328,19,396,10,108
33156,34036,19068,14968,11359,698,23,1631,5,197
33157,68069,38300,29769,12970,12939,48,1677,7,469
33158,6674,2929,3745,3069,105,4,310,0,36
33160,44085,18392,25693,20649,1754,30,784,6,441
33161,53015,15941,37074,5393,29002,62,987,11,362
33162,45277,14613,30664,6414,21258,56,1608,8,350
33165,54070,49123,4947,3962,169,7,429,4,93
33166,26106,20848,5258,3701,678,20,415,2,103
33167,19142,6406,12736,382,11909,12,70,2,103
33168,24715,6957,17758,1165,15694,21,255,2,146
33169,42308,7104,35204,1182,32394,31,561,4,259
33170,14908,8489,6419,1199,4709,19,143,1,75
33172,43911,39415,4496,2459,350,26,1015,5,203
33173,33648,26952,6696,5185,396,8,568,7,115
33174,32962,28413,4549,2167,1278,21,684,7,136
33175,52950,48800,4150,3227,189,10,369,7,103
33176,52370,33832,18538,10246,5943,22,1090,11,246
33177,56331,45270,11061,4027,5175,49,802,5,363
33178,65487,53186,12301,6881,1629,37,1726,8,426
33179,48088,19080,29008,8771,17182,40,1017,13,481
33180,35062,13919,21143,17441,1108,15,740,6,281
33181,20955,9817,11138,4958,4767,37,344,0,297
33182,13310,12181,1129,819,72,6,125,0,51
33183,35891,31242,4649,3215,454,7,482,3,150
33184,20913,19433,1480,1134,65,7,119,2,48
33185,28819,25585,3234,2037,275,16,547,2,102
33186,69866,53723,16143,9311,2910,33,1978,19,457
33187,19233,15333,3900,2310,792,2,385,0,87
33189,25598,17435,8163,3928,3022,18,506,7,151
33190,15092,10743,4349,1748,1934,10,242,4,110
33193,47619,42228,5391,2968,715,7,1064,6,199
33194,8817,6284,2533,1067,1213,13,151,0,45
33196,52786,42675,10111,5118,2172,51,1549,3,291
33301,19109,3476,15633,13393,992,27,509,4,159
33304,19978,3709,16269,12234,2484,41,522,14,135
33305,12044,1818,10226,8824,604,18,306,1,77
33306,3526,487,3039,2659,91,3,106,1,43
33308,29519,4347,25172,22357,821,37,684,14,203
33309,37642,9028,28614,10077,16015,49,752,16,306
33311,69413,5830,63583,5718,55340,157,420,9,291
33312,51570,15202,36368,18595,14646,74,959,20,414
33313,63284,6477,56807,4710,48773,86,934,34,444
33314,30248,12918,17330,10431,3606,79,1774,39,284
33315,13555,3524,10031,8010,964,11,351,8,107
33316,12669,2399,10270,8649,711,26,323,5,108
33317,37590,12940,24650,13294,8025,69,1340,20,390
33319,51891,8854,43037,8157,31196,61,1353,15,510
33321,51011,16684,34327,17316,13272,51,1540,21,494
33322,41050,13855,27195,15056,8609,53,1557,19,425
33323,23149,8485,14664,8506,3624,27,1363,12,239
33324,46766,15043,31723,20992,6051,52,2344,12,482
33325,31556,14085,17471,12480,1986,45,1597,5,283
33326,33978,19353,14625,10592,1164,26,1441,8,233
33327,22174,11929,10245,6772,728,30,1508,1,116
33328,28997,8629,20368,15590,1536,45,1927,15,194
33330,14738,4919,9819,7202,877,28,1054,6,101
33331,23016,10182,12834,8515,1163,24,2038,2,185
33332,10915,5149,5766,3604,602,15,951,3,76
33334,30138,9754,20384,14302,3970,46,695,27,208
33351,36913,12324,24589,8024,12902,38,1733,13,423
33388,0,0,0,0,0,0,0,0,0
33401,31302,5403,25899,13816,10139,50,712,4,182
33403,13779,1938,11841,4826,5988,6,416,1,117
33404,31869,2752,29117,8119,19463,39,488,7,123
33405,19369,9961,9408,7676,942,17,248,5,111
33406,27663,15352,12311,8421,2731,24,388,14,131
33407,34558,7397,27161,6811,18556,50,621,4,158
33408,18965,1643,17322,16058,337,16,312,12,50
33409,33061,11398,21663,8378,10883,46,1045,20,267
33410,35946,5628,30318,25172,2215,31,1578,1,152
33411,74206,18097,56109,33629,15973,100,3032,27,611
33412,15872,2483,13389,10226,1642,27,670,6,159
33413,17503,6268,11235,4348,5341,19,794,6,185
33414,59802,15191,44611,31715,7134,50,3126,11,414
33415,51251,29102,22149,10475,9199,41,1085,82,247
33417,34153,10066,24087,12248,9887,30,847,7,248
33418,43383,4832,38551,33174,1830,19,1922,10,200
33426,25155,4294,20861,13695,5095,31,786,3,257
33428,42828,9608,33220,22616,3079,44,1904,2,1291
33430,20327,7359,12968,1408,11129,8,84,3,38
33431,22047,3282,18765,14712,2096,30,737,12,165
33432,22061,3190,18871,15911,1219,27,556,5,224
33433,46302,8228,38074,31166,1809,28,1653,7,705
33434,21003,3224,17779,15586,631,10,557,5,176
33435,37318,5041,32277,16421,14155,33,375,14,195
33436,45230,8336,36894,24363,9132,53,1576,15,315
33437,36889,3824,33065,27002,4085,30,894,5,189
33438,527,256,271,168,89,0,1,0,1
33440,19402,10128,9274,5031,3530,113,250,1,48
33441,29311,4771,24540,12492,8881,37,383,16,737
33442,32340,6253,26087,18264,3217,36,886,15,941
33444,22671,2772,19899,9249,9556,37,269,1,124
33445,32265,4049,28216,19455,6559,29,772,9,239
33446,30051,2966,27085,24388,960,14,612,5,150
33449,9920,1539,8381,6448,976,9,542,4,65
33455,20799,1840,18959,17192,823,27,232,10,56
33458,55083,10972,44111,38641,1462,54,1838,29,205
33460,36409,16682,19727,11454,6707,73,327,21,229
33461,47161,26595,20566,10919,7624,68,797,17,272
33462,33982,9371,24611,15833,6766,33,691,10,250
33463,64608,25464,39144,18197,16202,64,2439,16,406
33467,55813,11698,44115,34805,4971,48,2121,21,361
33469,15101,1031,14070,13280,108,15,156,2,41
33470,30308,6770,23538,17632,3406,80,756,19,270
33471,6410,1511,4899,3443,1318,27,17,0,11
33472,18893,2414,16479,13783,1333,28,596,7,153
33473,11057,1142,9915,8370,625,14,532,0,58
33476,7608,1971,5637,634,4879,4,24,1,12
33477,12683,506,12177,11823,43,7,89,0,27
33478,14740,1653,13087,11989,181,27,257,6,65
33480,10716,550,10166,9733,60,1,161,2,32
33483,13103,941,12162,10879,725,12,149,8,51
33484,26340,3332,23008,19885,1577,15,628,1,148
33486,22947,4109,18838,15788,902,17,756,5,222
33487,20644,2699,17945,15642,735,14,652,10,148
33493,5129,1164,3965,665,3210,3,2,1,7
33496,23805,2993,20812,17902,734,13,1025,6,191
33498,15002,2653,12349,9941,646,8,801,6,142
33503,131,53,78,52,11,0,2,0,2
33510,30049,8809,21240,13654,4867,64,1180,40,166
33511,56627,14756,41871,26626,9022,144,3058,39,412
33513,12204,1286,10918,8985,1333,50,79,7,45
33514,1783,413,1370,1151,116,2,3,2,15
33521,578,35,543,287,213,2,8,0,2
33523,18540,5174,13366,10782,1718,53,75,0,80
33525,18620,3250,15370,13426,1051,47,191,11,36
33527,16259,6181,10078,8485,609,34,400,2,57
33530,56,10,46,33,2,0,2,0,1
33534,17952,6628,11324,6367,3674,48,352,14,108
33538,5096,306,4790,4305,207,24,23,2,20
33540,9603,1211,8392,7524,405,28,97,1,31
33541,22692,3072,19620,16892,1365,61,416,18,117
33542,22649,3273,19376,16868,1205,70,234,12,74
33543,34953,8068,26885,18647,3552,59,2569,31,259
33544,27309,5915,21394,15366,2515,39,1868,21,247
33545,21209,5813,15396,10070,3165,41,918,18,170
33547,30935,5177,25758,21328,1121,41,1565,17,153
33548,7708,1246,6462,5409,256,11,438,2,51
33549,17816,3846,13970,11581,970,38,451,8,98
33550,14,2,12,10,0,0,1,0,0
33556,30547,4467,26080,21684,1100,35,1794,28,129
33558,27324,5136,22188,17149,1253,38,2365,7,140
33559,16675,4007,12668,9083,1643,36,950,9,177
33563,27344,10756,16588,11315,4003,50,276,17,84
33565,17584,3828,13756,12632,261,49,191,2,42
33566,22759,7084,15675,12773,1554,52,484,6,72
33567,12345,4575,7770,6019,1200,19,101,8,46
33569,28065,6681,21384,14955,3679,78,1108,20,230
33570,33348,12359,20989,13656,5466,83,501,35,193
33572,22395,3423,18972,15646,1483,43,695,16,118
33573,30913,3659,27254,22524,3148,56,554,15,141
33574,2261,378,1883,840,933,0,67,0,13
33576,4879,516,4363,3948,135,16,74,0,13
33578,58854,17019,41835,23629,12326,140,2462,50,482
33579,44617,12012,32605,17857,10014,120,1900,42,349
33584,27503,6773,20730,14169,4261,62,961,8,147
33585,1218,138,1080,966,31,4,13,5,4
33592,11885,1980,9905,7186,1659,65,352,5,105
33594,35299,8458,26841,19562,3755,95,1823,12,172
33596,28140,4569,23571,18881,2023,82,1052,13,164
33597,8028,1044,6984,6004,472,50,43,3,24
33598,24572,10383,14189,9502,3358,31,497,18,142
33602,19936,3830,16106,11233,3046,25,918,10,121
33603,19070,6445,12625,7608,3926,37,207,9,131
33604,39071,15237,23834,12203,9049,69,889,8,245
33605,18243,4734,13509,3291,9359,53,116,14,135
33606,22271,2803,19468,16369,1329,22,762,8,153
33607,24767,11158,13609,7055,4836,46,879,7,111
33609,17902,4060,13842,11359,767,27,921,6,69
33610,45218,10559,34659,8328,23102,94,1376,18,266
33611,34101,5339,28762,23314,1963,53,1462,45,221
33612,49452,18528,30924,13786,13478,120,1518,53,339
33613,38801,12263,26538,14189,8070,62,2453,49,262
33614,47695,31600,16095,9024,3753,65,1955,12,253
33615,47434,25695,21739,14642,3107,57,1908,37,413
33616,14802,3060,11742,7995,1821,52,751,36,102
33617,48267,10323,37944,17343,16122,97,2021,53,340
33618,26474,7510,18964,15273,1617,35,925,9,184
33619,39881,14502,25379,10108,12537,77,984,18,254
33620,5535,984,4551,3111,683,8,459,8,279
33621,1878,293,1585,1153,217,7,46,6,7
33624,38929,14694,24235,17782,2837,32,1789,13,272
33625,28704,11601,17103,11764,1988,27,1989,14,244
33626,31875,5390,26485,19372,1435,32,3937,11,274
33629,26394,3406,22988,20395,365,31,907,7,153
33634,21465,12448,9017,5438,1647,31,1063,9,196
33635,18780,6628,12152,8261,1160,30,1718,8,172
33637,18070,4175,13895,6795,4796,39,1341,15,115
33647,69457,12500,56957,29677,10376,138,12973,26,579
33701,19137,1595,17542,13761,2404,45,450,12,115
33702,29996,3160,26836,21775,2075,72,1281,15,185
33703,23948,2147,21801,19098,690,38,773,10,115
33704,16031,1211,14820,13396,340,32,364,3,60
33705,27915,1939,25976,11138,12997,41,388,15,191
33706,15309,762,14547,13715,106,20,183,12,53
33707,24646,1451,23195,20190,1568,54,302,25,134
33708,16034,891,15143,14027,221,39,271,2,66
33709,27026,3366,23660,18907,1754,55,1576,16,156
33710,33172,3438,29734,25324,1488,73,1184,25,168
33711,20121,1286,18835,8092,9671,28,219,9,75
33712,26395,1341,25054,6593,17048,52,301,12,181
33713,31321,3875,27446,19887,3318,69,2535,13,169
33714,19905,2782,17123,12078,2228,43,1680,22,104
33715,7876,346,7530,7079,79,17,139,1,22
33716,18023,2514,15509,11183,2210,52,1107,6,126
33744,55,7,48,34,2,1,0,0,1
33755,28360,5876,22484,14602,5651,54,657,120,129
33756,31807,5526,26281,20701,3279,80,717,19,139
33759,18316,3138,15178,12250,1380,30,627,6,80
33760,19565,3929,15636,10775,2910,61,970,27,100
33761,18761,1884,16877,15140,416,45,487,19,91
33762,5572,505,5067,4077,181,17,534,1,45
33763,18981,2356,16625,14654,671,40,547,8,70
33764,27547,3189,24358,20666,1232,61,973,33,198
33765,13844,3569,10275,8130,940,24,393,2,88
33767,8462,418,8044,7501,68,9,257,0,29
33770,25475,3087,22388,19060,1422,59,507,60,165
33771,29766,3814,25952,22119,1517,45,808,16,182
33772,24121,1754,22367,20234,447,62,600,8,98
33773,17494,1806,15688,12967,725,42,1024,15,110
33774,18145,1534,16611,13962,1411,18,286,32,81
33776,12922,766,12156,11179,128,13,261,5,39
33777,17793,1639,16154,13672,636,55,907,47,66
33778,15068,1347,13721,11146,1449,53,325,6,72
33781,27349,4308,23041,16574,1948,45,2805,43,183
33782,22198,2553,19645,15150,1191,62,2151,12,138
33785,4863,290,4573,4311,33,6,66,2,24
33786,1706,89,1617,1482,10,4,52,0,4
33801,36798,8820,27978,20441,5401,140,368,27,200
33803,29082,5072,24010,19659,2321,52,577,23,138
33805,26954,6094,20860,9599,9723,34,369,11,120
33809,30629,5447,25182,20781,2497,70,577,7,127
33810,52037,10695,41342,31305,6307,118,1434,9,213
33811,24249,4401,19848,16321,2065,41,336,5,113
33812,14907,2398,12509,9614,1234,31,960,6,83
33813,36448,5355,31093,25813,2168,62,1337,6,146
33815,15681,5446,10235,6124,3351,63,82,7,84
33823,33733,6430,27303,22163,3022,135,404,12,114
33825,24943,6062,18881,13304,4349,65,448,7,75
33827,3093,373,2720,2370,206,1,22,2,20
33830,29926,5946,23980,16811,5594,77,339,7,152
33834,6584,2565,4019,2780,1103,16,27,2,11
33835,69,9,60,12,46,0,0,0,0
33837,36302,14991,21311,15689,3226,73,786,14,259
33838,5243,1863,3380,1922,1117,13,93,3,65
33839,3827,1015,2812,2136,435,10,44,1,36
33840,242,127,115,66,31,3,1,0,0
33841,7439,2055,5384,4230,908,7,31,4,17
33843,11864,2902,8962,7235,1319,38,39,1,30
33844,43329,19297,24032,15219,6917,90,477,29,225
33847,299,60,239,221,5,0,1,0,0
33848,1085,443,642,515,44,6,8,1,3
33849,711,64,647,587,18,8,9,1,0
33850,9119,2216,6903,5097,1282,23,144,9,46
33851,991,311,680,491,98,2,17,0,33
33852,21635,4813,16822,14517,1518,60,161,3,71
33853,12404,3088,9316,5064,3677,21,99,3,43
33854,520,379,141,123,3,0,5,0,3
33855,92,13,79,77,1,0,0,0,0
33856,488,18,470,435,26,1,4,0,1
33857,1378,172,1206,1146,18,5,5,0,0
33858,95,22,73,23,47,1,1,0,0
33859,10866,2397,8469,7272,643,32,98,11,48
33860,24932,7497,17435,13881,2411,33,259,14,67
33865,801,154,647,567,46,1,2,0,0
33867,126,9,117,108,6,0,0,0,0
33868,12906,2198,10708,9075,1026,27,98,3,62
33870,24238,5477,18761,14610,2886,77,274,20,89
33872,13167,2295,10872,9125,757,33,539,5,42
33873,13455,5961,7494,6196,899,27,88,2,20
33875,11004,1347,9657,8534,392,32,135,12,22
33876,5239,791,4448,4010,223,19,37,1,9
33877,590,136,454,206,230,2,2,0,0
33880,42005,11659,30346,21123,6870,78,723,12,225
33881,38369,8710,29659,17399,10359,90,522,9,167
33884,34772,5283,29489,23264,3595,79,1237,20,145
33890,4718,2010,2708,2466,65,11,50,0,4
33896,19444,6782,12662,9380,1709,35,577,7,159
33897,25352,9844,15508,11502,2288,49,506,10,200
33898,17971,2818,15153,12769,1537,37,158,7,58
33901,22629,4208,18421,11281,5636,63,320,6,187
33903,23294,3098,20196,18701,505,43,193,6,105
33904,32029,5055,26974,24688,610,57,435,26,108
33905,37692,13361,24331,19260,3309,52,640,4,180
33907,24980,7384,17596,13726,2100,52,537,9,218
33908,43110,4110,39000,35828,990,42,933,9,170
33909,33063,10425,22638,18711,1957,54,534,15,161
33912,19146,1324,17822,16344,344,28,517,2,84
33913,28216,3793,24423,21257,1267,56,802,5,126
33914,42222,7876,34346,30715,1267,71,717,6,214
33916,25940,8319,17621,6569,9255,24,372,3,248
33917,30702,2753,27949,26459,258,70,208,2,84
33919,30587,2914,27673,24780,973,28,773,5,164
33920,6797,717,6080,5492,287,19,38,1,29
33921,1283,13,1270,1251,7,0,5,0,1
33922,4326,607,3719,3546,10,7,28,0,15
33924,403,14,389,381,2,0,2,1,0
33928,28955,2554,26401,24689,301,28,567,8,104
33930,799,398,401,380,5,2,2,0,1
33931,9389,284,9105,8832,21,22,25,8,25
33935,22718,12968,9750,8426,725,49,94,3,92
33936,24051,10466,13585,9841,2671,42,215,15,137
33944,208,12,196,184,1,0,0,0,4
33946,2485,49,2436,2343,10,0,9,0,3
33947,10462,384,10078,9620,60,11,88,2,41
33948,17190,1545,15645,13401,1195,31,277,7,69
33950,24984,1392,23592,21921,616,56,273,4,93
33952,32084,4126,27958,23300,2362,61,615,25,170
33953,6882,376,6506,5948,212,18,82,3,27
33954,11040,1208,9832,8182,877,29,206,8,79
33955,10071,461,9610,8895,297,18,114,0,29
33956,3861,143,3718,3570,10,5,17,0,16
33957,6382,155,6227,6030,27,8,44,2,16
33960,839,196,643,599,15,0,2,0,4
33965,3659,563,3096,2631,243,8,51,0,22
33966,11245,1633,9612,8078,484,11,516,3,91
33967,28174,7097,21077,18559,819,39,654,10,102
33971,26333,11388,14945,7625,5563,43,606,3,262
33972,14727,5417,9310,6210,2209,45,189,7,110
33973,12728,6120,6608,2260,3798,25,83,2,71
33974,17233,8106,9127,5332,2970,27,182,6,109
33976,17017,8524,8493,3902,3770,40,183,8,117
33980,11762,966,10796,9079,892,35,239,2,71
33981,13574,729,12845,11945,192,24,144,1,35
33982,12404,800,11604,10314,737,35,106,0,47
33983,16124,1343,14781,12468,1341,29,281,6,66
33990,32717,8580,24137,20500,1468,71,697,21,212
33991,26381,6103,20278,17809,936,51,436,10,139
33993,29848,8290,21558,18544,1373,46,407,9,135
34101,13,5,8,5,0,0,1,0,1
34102,10496,923,9573,8746,468,12,113,2,57
34103,11822,1332,10490,9910,145,5,144,0,27
34104,25485,7414,18071,15536,1482,31,388,4,79
34105,16491,2105,14386,13207,320,15,439,5,72
34108,16142,1366,14776,14042,109,15,222,4,58
34109,26102,4421,21681,19754,582,31,571,5,139
34110,24093,1891,22202,20738,336,4,467,5,87
34112,26625,6018,20607,17902,1740,50,272,8,91
34113,23740,6456,17284,14091,2466,28,229,3,58
34114,21343,4159,17184,15047,1482,38,195,2,55
34116,31538,18581,12957,8041,3978,26,255,5,123
34117,16408,6337,10071,8646,699,31,156,3,84
34119,34933,4898,30035,26983,1012,40,841,3,185
34120,41026,14368,26658,22310,2182,82,748,8,219
34134,15906,749,15157,14481,93,10,203,5,39
34135,45518,11106,34412,32225,428,48,654,27,173
34137,255,25,230,199,19,2,0,0,0
34138,346,19,327,324,0,0,0,0,1
34139,471,61,410,387,0,10,0,0,2
34140,355,19,336,323,1,1,5,0,0
34141,131,42,89,46,3,23,12,0,0
34142,31327,20637,10690,4376,5481,90,197,3,130
34145,15717,1152,14565,13965,52,19,172,1,32
34201,4156,220,3936,3586,112,1,109,0,14
34202,26797,2029,24768,22196,585,34,861,18,124
34203,39853,10488,29365,23582,3020,105,1200,27,152
34205,33789,8161,25628,19792,3925,74,391,35,143
34207,35281,10143,25138,20338,2972,88,389,26,154
34208,38522,12432,26090,17051,6987,72,561,36,172
34209,32940,2166,30774,28254,816,63,478,31,62
34210,16447,1982,14465,11960,1372,26,431,19,97
34211,16845,1583,15262,13467,422,17,707,0,65
34212,24266,2371,21895,19215,837,43,809,7,74
34215,793,26,767,738,0,0,6,0,0
34216,1061,31,1030,994,3,0,7,0,1
34217,3825,134,3691,3512,14,4,36,0,6
34219,27212,2817,24395,21251,1325,44,635,12,108
34221,48082,10458,37624,28733,6399,112,646,24,227
34222,14097,1801,12296,10485,1047,32,256,3,51
34223,19118,648,18470,17741,57,31,159,1,47
34224,16379,655,15724,14997,74,31,118,5,47
34228,7505,177,7328,7052,31,15,88,2,22
34229,7780,344,7436,6902,37,6,241,4,19
34231,31492,3330,28162,25913,450,62,468,12,174
34232,34671,5408,29263,26270,729,57,684,14,202
34233,18723,1818,16905,15238,269,25,596,3,97
34234,20858,3946,16912,8875,6471,57,626,21,116
34235,14536,2718,11818,10467,570,16,210,7,71
34236,14083,1360,12723,11590,516,26,239,4,51
34237,16740,5183,11557,9339,1196,23,310,7,128
34238,22050,1362,20688,18943,283,11,717,12,67
34239,15049,2041,13008,11825,258,23,296,4,71
34240,14428,1000,13428,12205,218,24,450,1,66
34241,14589,1135,13454,12354,215,16,349,3,51
34242,7417,203,7214,6870,20,9,115,2,37
34243,30107,3761,26346,22350,1475,42,1220,9,130
34250,481,29,452,404,4,4,23,0,0
34251,7061,829,6232,5787,40,13,64,1,33
34266,28827,9629,19198,14230,3986,61,165,7,72
34267,44,2,42,36,3,0,0,0,0
34268,223,82,141,56,76,0,3,0,0
34269,4917,300,4617,4329,139,19,24,1,9
34275,20570,808,19762,18462,256,42,346,15,57
34285,18971,687,18284,17547,106,25,132,8,52
34286,22000,2784,19216,16497,1229,45,349,18,123
34287,26277,2289,23988,21349,1138,49,379,12,136
34288,14010,1614,12396,10523,909,26,278,1,57
34289,3359,355,3004,2713,96,1,68,1,8
34291,8332,842,7490,6540,472,25,91,4,34
34292,17141,627,16514,15786,129,21,180,2,36
34293,44935,2082,42853,40572,284,69,647,8,157
34420,17969,2519,15450,13361,916,47,173,15,59
34428,9583,438,9145,8334,211,37,80,3,30
34429,8837,364,8473,7688,280,31,121,2,45
34431,8589,864,7725,7044,266,21,45,1,31
34432,13159,1505,11654,10455,523,52,95,6,46
34433,7719,550,7169,6421,232,21,89,4,52
34434,9582,1055,8527,7528,466,30,95,0,28
34436,7901,381,7520,7052,71,23,38,6,13
34442,16759,820,15939,14435,338,37,549,1,51
34445,55,3,52,45,3,0,0,0,0
34446,18431,887,17544,16272,254,64,227,5,43
34448,10889,439,10450,9847,73,38,60,2,24
34449,3421,139,3282,3099,34,10,14,0,7
34450,10788,520,10268,9495,200,33,82,1,44
34452,12405,905,11500,10488,253,29,236,3,37
34453,10964,742,10222,9095,377,49,243,4,36
34461,11388,550,10838,9738,425,25,211,6,37
34465,17960,1543,16417,14544,695,48,378,6,77
34470,20483,2795,17688,13345,2962,41,361,7,79
34471,27632,3907,23725,18741,3115,46,626,9,71
34472,31701,6573,25128,16695,5973,120,548,17,278
34473,21548,7894,13654,7555,4694,38,268,10,217
34474,17781,4358,13423,9402,1821,27,1405,5,114
34475,14780,2068,12712,5820,6231,40,71,4,49
34476,26522,4360,22162,17922,2309,70,650,13,183
34479,14127,1521,12606,9803,1943,43,119,3,40
34480,21709,3100,18609,14426,2457,41,622,9,124
34481,23097,2022,21075,19329,819,50,245,6,88
34482,23565,4279,19286,14619,3709,49,157,3,85
34484,6050,512,5538,4730,239,19,306,1,18
34487,8,0,8,6,0,0,0,0,0
34488,11392,754,10638,9321,583,57,53,7,38
34491,31545,3879,27666,25254,964,83,304,20,85
34498,588,26,562,534,4,0,4,0,2
34601,23001,1918,21083,17683,2059,96,164,10,67
34602,8735,910,7825,6510,825,30,84,6,36
34604,12800,2110,10690,9234,705,40,208,1,51
34606,28548,4579,23969,21390,1050,62,244,19,126
34607,8544,838,7706,6825,313,31,134,5,44
34608,34363,6884,27479,23663,1581,75,451,18,185
34609,43997,8158,35839,30517,2165,133,987,14,266
34610,15400,2107,13293,11935,327,40,182,7,47
34613,18869,1691,17178,15967,373,43,184,8,40
34614,9221,1108,8113,7316,242,18,62,5,24
34637,9763,1407,8356,7127,568,20,249,4,36
34638,31746,7329,24417,18615,2351,82,1658,19,205
34639,28165,5790,22375,18359,1539,62,966,7,184
34652,26697,3698,22999,20141,937,82,528,17,112
34653,33381,4489,28892,25593,1167,81,517,27,148
34654,23508,1944,21564,19373,446,43,554,7,85
34655,45628,4602,41026,36521,1120,60,1367,14,188
34661,260,15,245,234,2,0,0,0,2
34667,34910,3179,31731,29128,663,137,417,21,105
34668,48781,9005,39776,34166,2316,163,649,31,187
34669,15089,1690,13399,12019,453,35,225,1,51
34677,22524,3176,19348,16297,844,36,1131,25,116
34679,273,21,252,243,2,0,0,0,3
34681,1884,82,1802,1707,5,4,15,1,12
34683,33453,2505,30948,28284,445,52,613,16,111
34684,27078,2236,24842,22575,570,29,644,7,88
34685,17680,1536,16144,14262,404,21,677,5,70
34688,8090,556,7534,6796,86,14,333,1,11
34689,27436,2463,24973,21667,1627,60,402,16,149
34690,14115,2092,12023,10287,706,47,295,4,79
34691,23688,3495,20193,17020,1482,71,470,9,104
34695,17927,1552,16375,14394,605,43,495,3,66
34698,38010,2845,35165,31852,1001,67,683,44,160
34705,2670,695,1975,1820,41,6,15,2,9
34711,67980,14170,53810,39551,7251,195,2563,47,1093
34714,25737,8748,16989,12816,2271,74,547,17,178
34715,22763,4992,17771,13309,2408,52,782,15,219
34729,148,30,118,94,1,0,4,1,0
34731,12111,1116,10995,9352,924,45,172,42,46
34734,4166,912,3254,2111,485,8,338,1,61
34736,24679,6260,18419,13191,3105,70,595,9,323
34737,3406,470,2936,2619,145,17,51,0,12
34739,833,67,766,710,12,2,2,2,4
34741,56454,38715,17739,9393,4214,55,2124,14,579
34743,38454,29315,9139,3738,3502,50,699,22,424
34744,59232,36394,22838,13510,5279,79,1788,33,553
34746,56344,29343,27001,14980,6191,75,2666,36,951
34747,26560,7463,19097,14993,1040,42,962,12,323
34748,45481,5081,40400,30120,7606,95,698,93,247
34753,6657,3104,3553,2161,886,33,153,6,83
34756,3985,517,3468,3029,147,9,81,3,38
34758,43282,26119,17163,5995,8330,63,898,33,613
34759,42067,21796,20271,9439,8427,60,785,21,405
34760,986,117,869,672,121,6,9,0,12
34761,48193,12590,35603,18551,10844,119,2936,38,813
34762,567,61,506,399,66,2,8,0,0
34769,27594,11419,16175,13369,1123,66,394,28,146
34771,26503,9610,16893,13471,1450,49,803,24,161
34772,33499,14449,19050,15063,1921,41,618,28,294
34773,5186,1036,4150,3610,151,17,67,3,41
34785,18677,2624,16053,10077,5132,121,162,3,59
34786,46553,9050,37503,25827,2519,53,4364,28,779
34787,88636,19137,69499,47859,8757,106,5309,43,1233
34788,19409,1764,17645,15561,1131,47,266,6,51
34797,1388,131,1257,1082,90,4,31,0,4
34945,5831,768,5063,3875,902,39,64,0,27
34946,6793,953,5840,2497,3123,12,36,6,10
34947,13933,3050,10883,2466,7736,41,170,2,80
34949,8027,411,7616,7182,94,11,101,2,19
34950,16582,3849,12733,3319,8722,31,93,8,73
34951,15357,1497,13860,11428,1511,46,177,14,67
34952,42630,7140,35490,27858,4785,77,822,17,261
34953,77023,19338,57685,34374,17163,114,1505,39,893
34956,10322,5845,4477,2375,1898,10,62,3,27
34957,22955,1443,21512,20028,401,25,323,0,84
34972,19514,6316,13198,9622,2844,112,75,12,76
34974,23699,3914,19785,17843,567,311,274,4,85
34981,4494,957,3537,2700,610,5,37,3,15
34982,27067,7148,19919,14795,3622,48,278,3,153
34983,43654,9793,33861,22450,8049,62,835,24,387
34984,16721,3553,13168,9155,2698,37,371,6,178
34986,30027,5253,24774,18531,4136,26,794,13,223
34987,14430,2345,12085,9725,1418,14,345,4,74
34990,31160,2669,28491,26255,319,38,705,14,105
34994,17843,2964,14879,11954,1970,32,251,0,80
34996,11042,798,10244,9606,240,12,89,2,32
34997,44000,8437,35563,31773,1614,68,589,12,132
35004,11477,405,11072,8902,1373,28,217,4,35
35005,7578,287,7291,3453,3580,25,17,1,21
35006,3259,48,3211,2896,119,25,4,4,11
35007,28274,3873,24401,18412,4320,56,318,16,87
35010,20271,833,19438,12681,5983,39,161,0,39
35013,129,107,22,19,0,0,0,0,0
35014,3679,40,3639,2015,1509,5,7,2,12
35016,17495,673,16822,15776,59,72,128,4,20
35019,2220,105,2115,1997,4,8,6,0,3
35020,24213,2880,21333,3300,17377,49,25,6,47
35022,23163,1206,21957,10420,10629,36,197,2,59
35023,25657,1056,24601,15436,8145,53,82,9,75
35031,8245,957,7288,6864,32,28,28,3,9
35032,92,8,84,69,15,0,0,0,0
35033,3692,46,3646,3500,10,12,5,0,7
35034,5021,123,4898,2409,2410,0,1,0,4
35035,1527,72,1455,1158,225,7,1,0,6
35036,167,5,162,49,112,0,0,0,1
35040,19214,1462,17752,11556,5152,39,130,5,65
35042,6156,177,5979,4597,1176,17,8,0,10
35043,13841,548,13293,11139,1262,36,236,6,58
35044,7771,123,7648,4641,2763,18,20,1,19
35045,15228,1076,14152,11409,2058,36,119,2,69
35046,5080,170,4910,4677,82,8,7,0,2
35049,3983,463,3520,3329,26,12,19,0,13
35051,9173,431,8742,7130,1171,23,25,0,30
35052,337,5,332,297,22,0,0,1,0
35053,2834,50,2784,2652,13,7,6,0,4
35054,4085,60,4025,3710,113,12,27,1,5
35055,22299,1410,20889,19334,252,61,276,16,38
35057,13954,495,13459,12636,66,37,55,29,24
35058,11098,711,10387,9874,31,39,62,2,18
35060,442,46,396,91,273,7,0,0,10
35061,1327,74,1253,105,1098,2,1,0,12
35062,8505,109,8396,7670,280,32,27,4,14
35063,3443,67,3376,3100,68,12,7,1,4
35064,10149,165,9984,217,9610,6,9,3,10
35068,8492,1150,7342,4067,2855,9,108,1,21
35070,97,2,95,88,1,0,0,0,0
35071,17162,506,16656,13335,2371,40,247,13,50
35072,4910,70,4840,2989,1673,7,3,0,11
35073,2412,78,2334,1616,588,6,11,2,4
35074,71,6,65,56,5,0,0,0,0
35077,13813,672,13141,11974,482,57,69,4,25
35078,2052,45,2007,1529,384,7,2,0,11
35079,9122,171,8951,8289,136,39,14,0,26
35080,19692,1015,18677,15005,2325,43,332,12,77
35082,12,0,12,12,0,0,0,0,0
35083,3174,116,3058,2894,17,19,12,0,3
35085,9171,1316,7855,6898,632,26,22,1,12
35087,2294,158,2136,2014,2,9,6,1,4
35089,1949,78,1871,962,831,0,7,0,15
35091,3683,64,3619,3242,231,7,6,0,2
35094,14936,861,14075,11307,1994,35,87,6,63
35096,8263,133,8130,5966,1757,21,46,11,21
35097,1751,55,1696,1585,14,5,6,1,4
35098,1484,59,1425,1359,8,3,1,0,3
35111,18852,533,18319,13845,3650,56,86,4,82
35112,446,3,443,374,18,0,10,0,5
35114,7565,862,6703,5155,1108,24,75,7,25
35115,15260,2340,12920,9676,2460,47,75,13,61
35116,4908,111,4797,4463,94,14,20,1,8
35117,6407,122,6285,5594,377,18,53,1,9
35118,3252,80,3172,2687,324,10,1,1,2
35119,91,26,65,17,32,2,1,0,0
35120,16073,518,15555,13067,1556,40,84,3,47
35121,16016,2919,13097,11916,478,36,74,2,25
35124,25667,3716,21951,17362,2910,39,629,16,109
35125,10821,277,10544,8779,1139,34,67,2,28
35126,21400,1309,20091,12871,6130,43,110,10,68
35127,9546,133,9413,3251,5920,20,8,3,10
35128,10479,251,10228,8626,1089,17,96,2,20
35130,3194,45,3149,2724,281,23,3,0,9
35131,4119,107,4012,3498,265,9,3,1,18
35133,4094,174,3920,3674,32,7,13,1,11
35135,1852,45,1807,1489,227,2,21,1,4
35136,1603,24,1579,1275,241,4,1,0,9
35143,3275,77,3198,2969,69,7,7,0,1
35146,12566,195,12371,10606,1326,19,38,0,25
35147,5769,320,5449,4671,417,26,76,1,15
35148,2653,36,2617,2334,118,11,18,0,5
35149,539,9,530,364,136,0,2,1,8
35150,17971,431,17540,10975,5786,30,66,8,67
35151,7417,114,7303,6300,745,35,6,0,13
35160,27074,619,26455,13944,11570,59,88,5,62
35171,3434,310,3124,2835,188,3,14,1,5
35172,3170,205,2965,2710,82,12,14,1,2
35173,31413,1053,30360,25327,3211,80,510,7,79
35175,5029,172,4857,4517,24,35,21,0,6
35176,855,20,835,775,28,4,0,0,0
35178,3445,81,3364,2574,648,14,2,0,27
35179,9742,252,9490,8973,17,42,20,5,13
35180,14204,226,13978,12770,550,33,30,3,23
35181,32,4,28,25,0,1,0,0,0
35183,631,2,629,602,4,4,0,0,2
35184,5783,174,5609,4936,421,14,12,6,21
35185,1,0,1,0,0,1,0,0,0
35186,5199,165,5034,4612,197,13,17,0,13
35188,3020,125,2895,2662,119,4,3,2,5
35203,3595,97,3498,1356,1990,2,49,0,14
35204,9271,582,8689,374,8037,26,18,1,23
35205,20137,1287,18850,10932,5732,35,1397,40,76
35206,15648,1021,14627,3142,10959,28,87,1,45
35207,7911,456,7455,348,6917,10,5,0,24
35208,12982,429,12553,420,11848,16,7,1,40
35209,27827,1758,26069,18352,6032,32,779,11,64
35210,14344,1498,12846,8331,3782,15,201,2,29
35211,24775,991,23784,2255,20614,44,360,5,59
35212,11240,432,10808,2473,7983,20,41,1,30
35213,14964,306,14658,13603,425,15,191,0,32
35214,18287,526,17761,2680,14598,38,21,5,61
35215,46772,3388,43384,6939,35069,79,119,19,127
35216,36673,2685,33988,23465,7534,47,1599,23,134
35217,12891,1813,11078,3043,7502,36,46,101,34
35218,6521,142,6379,200,6037,16,8,0,11
35221,4036,65,3971,89,3788,13,1,1,14
35222,8419,315,8104,5361,2281,7,136,5,33
35223,11972,192,11780,11267,87,5,147,0,11
35224,5327,306,5021,1304,3521,14,23,0,21
35226,38471,1306,37165,29275,3864,38,2495,2,145
35228,9525,374,9151,542,8399,21,9,2,19
35229,2292,38,2254,149,2069,0,18,0,2
35233,2588,166,2422,1385,609,11,313,1,13
35234,4873,264,4609,472,4010,1,12,1,17
35235,20059,938,19121,6083,12163,34,238,0,75
35242,57008,2409,54599,44361,5354,87,2633,22,186
35243,21607,695,20912,18232,1187,23,726,2,83
35244,37448,1609,35839,24769,6579,65,3015,6,163
35249,0,0,0,0,0,0,0,0,0
35254,969,17,952,808,114,2,2,0,2
35401,41852,3161,38691,18806,17788,71,876,16,229
35404,20982,1548,19434,9077,9141,30,378,11,57
35405,45155,1256,43899,17812,24019,73,668,21,142
35406,16664,814,15850,13435,1142,22,678,7,35
35441,1077,10,1067,582,446,3,2,1,0
35442,5937,705,5232,1370,3738,16,30,0,2
35443,1669,8,1661,199,1412,0,1,0,3
35444,4467,151,4316,3769,312,18,13,2,16
35446,2354,148,2206,1828,299,3,5,0,1
35447,3078,180,2898,1396,1408,3,5,0,2
35452,4371,273,4098,3724,195,10,10,0,17
35453,12682,1004,11678,8804,2283,20,75,0,31
35456,4587,244,4343,3346,810,7,13,0,15
35457,75,3,72,65,2,0,1,0,0
35458,701,50,651,604,26,2,5,0,0
35459,786,16,770,224,529,0,1,0,0
35460,558,4,554,69,482,0,0,0,1
35461,1825,15,1810,1243,527,0,10,0,0
35462,4648,45,4603,746,3773,3,5,0,5
35463,1818,16,1802,1127,621,3,1,0,3
35464,436,1,435,54,380,0,0,0,0
35466,5678,136,5542,4500,835,6,30,1,3
35469,319,5,314,141,167,0,0,0,0
35470,5055,85,4970,1627,3140,22,93,2,6
35473,17888,1092,16796,12349,3488,38,264,16,58
35474,7829,174,7655,4467,2947,26,20,0,29
35475,20164,713,19451,17752,993,29,112,6,39
35476,8697,1068,7629,3341,3940,23,60,0,49
35477,106,1,105,12,89,0,0,0,0
35480,1976,29,1947,1269,643,2,0,2,2
35481,3112,40,3072,1843,1135,0,2,0,4
35487,529,45,484,356,81,0,21,3,23
35490,5257,250,5007,4237,523,9,15,5,12
35491,5,0,5,0,4,0,0,0,0
35501,10284,998,9286,7050,1681,26,82,1,34
35503,8948,205,8743,8239,168,19,34,0,8
35504,13715,462,13253,12386,295,49,91,0,31
35540,2324,28,2296,2199,7,12,3,3,4
35541,3457,30,3427,3315,15,11,5,0,2
35542,1180,19,1161,1099,22,4,3,0,1
35543,1124,36,1088,1033,5,3,5,0,1
35544,660,3,657,628,7,3,0,0,2
35545,73,4,69,63,0,0,0,0,0
35546,4180,85,4095,3783,116,16,4,0,13
35548,1494,17,1477,1424,1,1,3,0,3
35549,3780,79,3701,3395,137,4,10,0,6
35550,5229,86,5143,4666,273,6,4,0,7
35552,971,9,962,847,76,2,0,0,2
35553,4529,58,4471,4259,22,12,4,3,14
35554,1131,45,1086,1037,20,2,1,0,1
35555,9282,243,9039,7136,1501,27,36,1,15
35559,30,3,27,25,1,0,1,0,0
35563,3967,83,3884,3458,234,14,9,0,4
35564,2155,70,2085,1989,6,3,6,0,0
35565,12777,779,11998,11341,86,41,39,3,15
35570,10774,370,10404,9363,552,38,33,8,24
35571,999,16,983,959,3,5,0,0,0
35572,1022,10,1012,930,6,6,3,0,2
35573,1,0,1,0,0,0,0,0,0
35574,1471,18,1453,1319,107,0,2,0,3
35575,976,14,962,933,3,0,1,0,4
35576,3131,37,3094,2641,359,7,2,0,0
35577,14,0,14,13,0,0,0,0,0
35578,5421,90,5331,5104,26,26,7,1,3
35579,3105,29,3076,2784,178,7,4,0,4
35580,3860,64,3796,3330,300,7,3,0,18
35581,5232,205,5027,4803,14,16,8,2,13
35582,4182,204,3978,3772,39,26,9,2,8
35584,379,15,364,234,119,0,0,0,0
35585,1538,114,1424,1365,8,2,0,0,1
35586,4235,74,4161,3552,487,9,1,3,6
35587,887,3,884,857,5,2,3,0,0
35592,4396,73,4323,3726,451,7,4,0,12
35593,1853,43,1810,1749,5,10,3,0,1
35594,7681,191,7490,6837,336,16,21,3,12
35601,34958,7799,27159,16417,8787,128,199,46,141
35603,32380,2439,29941,22795,5022,132,415,13,82
35610,1846,28,1818,1740,5,17,7,0,0
35611,27168,3165,24003,17946,4550,108,153,24,73
35613,22935,941,21994,18731,1796,82,242,17,85
35614,7788,777,7011,6256,297,34,37,2,14
35615,52,0,52,25,22,0,2,0,0
35616,3756,77,3679,3082,435,4,14,2,10
35618,1710,43,1667,728,807,37,3,1,7
35619,5048,184,4864,4205,200,124,6,3,10
35620,9592,424,9168,8330,293,56,28,0,23
35621,2914,36,2878,2714,3,15,3,0,3
35622,7257,138,7119,6684,60,43,21,8,15
35630,32671,1886,30785,21893,6802,93,359,16,68
35632,1096,52,1044,675,210,6,111,0,0
35633,20446,464,19982,17865,1241,71,81,7,67
35634,10910,222,10688,9939,270,32,81,4,22
35640,25913,797,25116,22644,862,135,129,10,74
35643,2913,63,2850,1769,784,105,3,0,7
35645,13414,230,13184,12222,299,33,76,0,33
35646,4268,115,4153,3064,878,37,7,4,3
35647,1152,74,1078,1021,13,4,2,0,1
35648,3737,62,3675,3524,18,12,2,1,4
35649,63,1,62,51,2,1,1,0,0
35650,13741,398,13343,11045,589,590,40,1,23
35651,1122,22,1100,881,21,79,5,2,8
35652,8215,123,8092,7444,315,29,32,3,9
35653,12239,4086,8153,6991,794,33,13,0,28
35654,8511,1645,6866,6143,294,74,41,0,25
35660,9434,350,9084,6191,2350,20,54,2,33
35661,18714,647,18067,13768,3173,88,279,1,41
35670,7780,261,7519,6775,145,90,27,4,37
35671,1976,258,1718,1058,511,19,5,2,8
35672,5985,122,5863,4143,899,306,20,1,7
35673,8100,492,7608,6491,331,205,18,0,23
35674,19536,485,19051,15801,2344,67,74,0,47
35677,1808,19,1789,1737,7,6,0,0,1
35739,5426,290,5136,4429,305,59,32,1,15
35740,3357,56,3301,2835,203,44,14,0,12
35741,3529,128,3401,2958,145,28,87,5,11
35744,2527,106,2421,2235,8,23,6,0,3
35745,262,4,258,233,0,12,1,0,0
35746,799,21,778,688,14,12,1,0,0
35747,6173,100,6073,5704,26,24,28,3,21
35748,7794,219,7575,6494,439,91,81,4,25
35749,28780,1354,27426,16650,8628,100,368,31,130
35750,14192,547,13645,11346,980,170,114,6,53
35751,226,3,223,185,0,8,0,0,0
35752,2008,49,1959,1660,156,22,4,0,1
35754,4950,343,4607,4275,54,34,14,4,11
35755,677,15,662,626,5,5,1,0,7
35756,22978,1416,21562,13537,5018,104,1462,25,114
35757,16962,1059,15903,10223,4112,92,486,31,94
35758,48192,2888,45304,31396,7430,145,3361,74,281
35759,9894,388,9506,6280,2391,70,144,12,33
35760,5186,140,5046,4613,49,86,14,3,8
35761,12561,453,12108,9510,1403,178,85,5,51
35763,21889,966,20923,18090,928,115,529,11,91
35764,522,10,512,469,2,3,3,0,0
35765,3845,56,3789,3419,6,84,9,0,7
35766,180,1,179,159,0,12,0,0,0
35768,11436,464,10972,9541,558,116,50,0,23
35769,10419,509,9910,8983,272,54,92,1,20
35771,3746,93,3653,3343,18,65,11,0,5
35772,4688,244,4444,3628,363,63,6,2,15
35773,13199,731,12468,9185,2235,118,79,7,90
35774,110,6,104,93,0,9,0,0,0
35775,602,21,581,476,65,3,3,0,2
35776,3480,67,3413,3140,18,71,9,1,8
35801,22539,812,21727,18400,1842,103,353,26,52
35802,23842,999,22843,18160,2820,74,610,36,74
35803,29001,1521,27480,22703,1698,140,1151,6,124
35805,23189,5969,17220,7868,7659,118,343,60,105
35806,25702,1322,24380,14507,7402,134,951,28,140
35808,865,51,814,506,225,4,28,3,0
35810,29976,2245,27731,5204,20989,93,149,44,116
35811,30075,1287,28788,18517,8092,158,291,12,111
35816,15035,1053,13982,3829,8942,72,406,28,35
35824,9378,677,8701,5128,2514,29,442,17,62
35896,596,32,564,4,529,4,5,0,2
35901,18671,1151,17520,11002,5542,58,203,3,43
35903,17344,1021,16323,10159,5285,55,128,4,68
35904,13559,815,12744,10134,1720,39,48,4,40
35905,6706,100,6606,6091,201,29,48,2,18
35906,10444,289,10155,8210,1115,27,325,10,35
35907,9270,201,9069,8387,206,28,75,0,3
35950,22239,7280,14959,13083,941,86,117,14,36
35951,14219,4276,9943,9131,211,59,93,0,13
35952,7847,581,7266,6899,43,44,11,11,18
35953,7705,210,7495,6511,586,50,30,5,15
35954,12145,644,11501,9865,941,32,46,4,16
35956,9109,507,8602,8112,42,32,30,2,15
35957,16849,3631,13218,12142,220,78,64,103,41
35958,3218,31,3187,2935,4,30,11,0,0
35959,4747,61,4686,4232,229,33,13,0,11
35960,9883,173,9710,8778,543,27,26,0,19
35961,6053,1615,4438,3897,216,42,20,1,10
35962,7445,1950,5495,5165,23,72,9,6,8
35963,1765,178,1587,1463,21,8,10,0,0
35966,3511,55,3456,3174,0,44,9,0,8
35967,17233,3676,13557,12120,437,110,113,6,30
35968,5115,513,4602,4176,119,62,19,0,7
35971,4635,151,4484,4023,69,78,10,2,10
35972,1251,21,1230,1184,2,1,5,0,6
35973,2808,15,2793,2692,14,9,7,0,3
35974,1552,95,1457,1358,5,14,2,1,0
35975,1003,41,962,851,0,26,1,0,0
35976,16787,883,15904,14143,801,70,125,1,34
35978,5436,135,5301,4836,17,84,12,0,18
35979,1375,12,1363,1221,0,18,1,1,3
35980,5327,1114,4213,3983,24,24,8,0,23
35981,2055,30,2025,1853,9,33,2,0,0
35983,3553,88,3465,3211,90,29,4,0,4
35984,1976,27,1949,1854,22,2,1,0,1
35986,8091,522,7569,6943,52,132,21,0,8
35987,2671,139,2532,2350,34,11,4,0,4
35988,1871,181,1690,1554,10,15,2,0,2
35989,3265,472,2793,2608,17,27,15,0,3
35990,47,3,44,42,0,0,0,0,0
36003,1780,43,1737,661,1009,9,3,0,3
36005,1656,30,1626,1199,348,7,13,2,2
36006,1337,37,1300,1158,100,2,0,0,0
36008,47,2,45,35,1,6,0,0,0
36009,2454,31,2423,1850,478,9,6,0,7
36010,4866,130,4736,2457,2017,36,12,3,22
36013,464,12,452,330,105,0,9,0,0
36016,4077,77,4000,1660,2241,4,6,0,9
36017,3051,536,2515,1152,1300,6,18,0,4
36020,1250,49,1201,703,461,5,1,0,0
36022,14780,322,14458,12216,1552,38,42,1,31
36024,6028,121,5907,5104,556,10,19,1,17
36025,7993,252,7741,4370,3093,14,48,1,19
36026,967,8,959,809,111,1,1,0,0
36027,15708,827,14881,7118,7213,39,73,0,43
36028,1755,18,1737,1464,200,12,9,0,3
36029,791,8,783,403,364,0,3,1,2
36030,467,3,464,236,211,1,0,0,1
36031,98,0,98,19,79,0,0,0,0
36032,2290,28,2262,652,1563,3,5,0,0
36033,3615,35,3580,2004,1461,7,1,0,9
36034,821,19,802,637,99,8,5,0,1
36035,1973,50,1923,1463,349,19,8,0,5
36036,1738,33,1705,934,718,1,4,1,4
36037,12851,206,12645,5858,6273,11,139,4,30
36038,66,3,63,52,6,0,0,0,1
36039,285,8,277,51,206,1,1,0,0
36040,3358,46,3312,341,2901,1,7,0,1
36041,1430,39,1391,1142,193,5,5,0,1
36042,1380,10,1370,1248,89,8,0,0,0
36043,3428,156,3272,1941,1233,8,18,1,6
36046,1340,18,1322,927,339,0,4,0,4
36047,1227,19,1208,385,796,0,0,0,1
36048,1180,33,1147,507,607,6,1,0,2
36049,5299,73,5226,3671,1294,18,55,2,11
36051,2294,83,2211,1825,262,12,7,0,2
36052,808,12,796,574,198,0,2,1,0
36053,1826,24,1802,282,1486,2,2,0,11
36054,15204,807,14397,9525,3959,53,160,3,58
36057,102,0,102,34,66,0,0,0,0
36064,12929,619,12310,7686,3537,21,698,5,40
36066,22206,902,21304,15255,4127,85,775,8,95
36067,27534,1027,26507,19307,5754,72,112,14,92
36069,1923,30,1893,1114,709,5,4,1,2
36071,677,0,677,413,222,6,4,0,6
36075,1767,51,1716,457,1212,6,5,0,1
36078,13604,355,13249,9762,2823,28,65,3,59
36079,9624,272,9352,6132,2684,44,119,5,19
36080,2377,48,2329,2058,172,1,9,0,10
36081,15513,405,15108,7555,6550,59,378,3,70
36082,738,34,704,346,274,5,52,0,6
36083,9367,140,9227,781,8178,27,40,2,23
36088,3547,25,3522,15,3418,3,19,2,8
36089,8342,487,7855,1542,6173,1,8,4,17
36091,3822,250,3572,3010,409,8,8,0,19
36092,21517,679,20838,15093,4600,88,147,15,56
36093,12081,290,11791,9445,1600,43,162,4,31
36101,61,5,56,8,48,0,0,0,0
36104,9021,231,8790,2542,5868,15,132,5,7
36105,9961,220,9741,1108,8378,12,20,1,32
36106,15438,455,14983,6691,7278,19,466,28,47
36107,8418,1435,6983,2526,3995,30,77,2,46
36108,17117,866,16251,1981,13817,27,54,1,39
36109,24176,1247,22929,13728,7901,50,268,12,83
36110,11492,723,10769,2077,8247,25,102,4,17
36111,12793,396,12397,3854,8088,27,101,1,52
36112,1195,153,1042,497,487,2,41,1,1
36113,929,98,831,647,87,4,30,2,4
36114,0,0,0,0,0,0,0,0,0
36115,1154,146,1008,638,177,2,61,9,13
36116,43840,2366,41474,5741,33166,38,1496,15,143
36117,53172,1511,51661,19105,26465,80,4365,29,183
36130,0,0,0,0,0,0,0,0,0
36201,17631,626,17005,8920,7242,83,37,8,54
36203,19460,1608,17852,13188,3433,53,353,8,55
36205,838,19,819,387,393,0,8,0,1
36206,10946,489,10457,6664,3085,35,115,12,32
36207,19553,1040,18513,13047,4416,46,288,15,54
36250,4751,75,4676,4166,305,11,24,13,3
36251,5138,150,4988,4126,648,9,31,1,10
36255,921,8,913,878,4,4,1,1,1
36256,1503,14,1489,1293,158,5,0,0,1
36258,1688,56,1632,1525,45,8,4,0,2
36260,4278,195,4083,3237,662,16,12,1,8
36262,1485,13,1472,1413,6,3,4,0,0
36263,649,20,629,545,49,2,0,0,4
36264,8984,247,8737,7908,463,31,10,2,7
36265,22018,609,21409,14491,5504,67,362,26,69
36266,5812,305,5507,4246,981,26,9,2,13
36267,28,0,28,27,1,0,0,0,0
36268,5498,108,5390,4145,1002,10,22,3,6
36269,1319,3,1316,1269,3,4,1,0,3
36271,5984,95,5889,5394,200,15,20,1,13
36272,12854,251,12603,11344,653,51,33,7,27
36273,2943,34,2909,2802,10,5,5,0,6
36274,10223,158,10065,6947,2722,14,57,1,32
36276,2287,76,2211,1688,422,12,15,0,0
36277,5379,215,5164,4120,659,32,55,18,15
36278,4331,142,4189,3415,590,8,12,0,9
36279,2586,26,2560,2373,66,3,8,0,3
36280,4060,122,3938,3569,216,11,3,0,5
36301,38447,1922,36525,23020,11356,94,322,22,117
36303,31080,1356,29724,15545,12402,84,435,11,112
36305,16561,702,15859,12728,1944,48,394,16,62
36310,6195,114,6081,3870,1925,16,27,0,20
36311,2796,114,2682,2207,337,8,20,1,9
36312,5876,108,5768,4757,711,25,28,3,27
36313,204,7,197,138,39,2,2,0,1
36314,635,20,615,587,4,1,5,0,0
36316,1835,66,1769,1511,144,9,13,0,4
36317,465,7,458,278,168,1,1,0,0
36318,1320,39,1281,1197,17,6,2,0,1
36319,2285,42,2243,1889,249,8,5,1,6
36320,3576,106,3470,2835,435,18,9,1,6
36321,1783,43,1740,1454,196,10,1,0,5
36322,8137,944,7193,4879,1539,44,195,1,45
36323,7779,178,7601,5470,1732,83,10,4,21
36330,38595,4731,33864,23534,6896,205,926,55,134
36340,5186,140,5046,4080,646,33,39,0,9
36343,1440,14,1426,912,435,6,3,3,6
36344,5853,272,5581,4699,561,24,7,3,38
36345,8451,162,8289,6317,1626,19,39,0,26
36346,1550,12,1538,1411,32,33,1,1,0
36350,7475,323,7152,5097,1619,29,67,3,20
36351,4004,201,3803,3159,375,53,27,0,29
36352,5387,204,5183,4623,272,30,22,2,6
36353,2025,64,1961,1458,410,9,8,1,6
36360,19654,703,18951,12523,5350,77,166,10,54
36362,4468,712,3756,2965,314,23,139,17,21
36370,939,15,924,782,78,7,3,0,4
36371,445,13,432,373,42,1,3,0,1
36373,524,13,511,326,161,5,0,0,0
36374,1062,23,1039,908,106,4,2,0,0
36375,7647,438,7209,6219,591,42,13,5,13
36376,2183,66,2117,1645,361,6,5,3,7
36401,7023,207,6816,2847,3772,37,27,0,7
36420,10796,223,10573,8173,1826,39,108,0,27
36421,9166,124,9042,7869,837,29,71,0,13
36425,784,12,772,146,599,4,2,0,0
36426,15660,312,15348,10784,3738,136,54,14,13
36432,2326,39,2287,1520,657,18,6,0,4
36435,475,4,471,94,369,0,0,0,0
36436,530,1,529,330,194,0,0,0,0
36439,200,3,197,151,15,9,4,0,4
36441,3772,82,3690,3027,446,67,3,0,5
36442,3414,80,3334,2856,331,5,13,0,4
36444,536,10,526,349,165,2,1,0,1
36445,4272,42,4230,2806,1186,71,12,0,13
36446,325,3,322,219,100,0,0,0,0
36451,4567,36,4531,2742,1662,20,14,0,7
36453,2194,45,2149,1998,13,44,8,0,7
36454,79,0,79,75,0,2,0,0,0
36455,378,7,371,273,63,3,3,0,0
36456,1854,16,1838,1398,363,5,2,1,6
36460,10057,122,9935,4745,4809,69,56,0,20
36467,10123,177,9946,8182,1295,45,36,0,21
36470,31,1,30,16,9,2,0,0,0
36471,775,5,770,256,489,4,3,0,0
36473,191,2,189,165,10,2,0,0,0
36474,2747,39,2708,2381,212,13,4,0,5
36475,1746,16,1730,1009,630,17,6,0,3
36476,38,0,38,20,17,0,1,0,0
36477,4768,328,4440,3826,359,40,14,0,15
36480,1564,1,1563,1199,194,87,3,0,1
36481,314,1,313,42,264,5,0,0,0
36482,897,6,891,259,606,5,2,0,2
36483,544,2,542,508,15,2,0,0,0
36502,16050,339,15711,7703,5945,1301,50,8,33
36503,1255,1,1254,471,783,0,0,0,0
36505,1419,15,1404,964,304,67,3,0,3
36507,19608,381,19227,13662,4285,227,83,1,54
36509,1827,86,1741,992,262,4,398,0,9
36511,703,58,645,589,12,7,3,0,3
36512,28,2,26,8,9,5,0,0,0
36513,402,4,398,195,144,47,0,0,2
36518,2523,23,2500,1980,420,15,1,1,7
36521,5302,91,5211,4391,373,152,8,1,18
36522,7396,110,7286,5165,1120,529,22,1,14
36523,2779,60,2719,2382,111,12,51,1,17
36524,1009,17,992,602,343,1,4,0,0
36525,1848,30,1818,1459,227,28,2,1,7
36526,35720,1606,34114,27830,3949,131,438,27,106
36527,18034,752,17282,14878,980,83,415,13,76
36528,1778,42,1736,1615,5,19,12,3,1
36529,570,6,564,420,90,22,1,0,0
36530,8375,366,8009,7344,91,55,26,9,40
36532,36918,1522,35396,31510,2036,92,260,33,76
36535,35484,3890,31594,26199,3164,178,291,14,165
36538,330,1,329,183,134,0,0,0,0
36539,732,9,723,636,49,13,0,0,5
36540,955,2,953,198,739,0,3,0,0
36541,14999,419,14580,12024,1596,80,222,4,43
36542,16993,658,16335,14894,323,68,167,6,99
36543,20,1,19,17,1,1,0,0,0
36544,11717,524,11193,8279,1157,65,1144,27,20
36545,8659,84,8575,4253,4011,42,46,1,21
36547,0,0,0,0,0,0,0,0,0
36548,989,4,985,657,289,3,2,0,0
36549,5465,143,5322,4915,126,29,36,1,7
36550,199,1,198,136,42,11,0,0,0
36551,10514,654,9860,7986,1178,62,72,1,30
36553,2790,29,2761,826,909,888,2,0,6
36555,829,29,800,737,7,3,2,0,5
36556,226,5,221,130,81,7,0,0,0
36558,3441,30,3411,2686,640,8,4,0,1
36559,248,4,244,230,0,0,1,0,2
36560,3418,29,3389,734,1470,1039,2,3,4
36561,9146,237,8909,8362,85,39,61,2,22
36562,1863,30,1833,1601,81,64,2,0,1
36564,15,1,14,11,3,0,0,0,0
36567,14620,1054,13566,11929,615,119,89,7,49
36568,126,6,120,45,19,1,39,1,2
36569,783,2,781,576,171,11,1,0,0
36571,16759,329,16430,12854,2308,250,188,6,56
36572,6867,84,6783,5813,565,90,29,3,13
36574,1614,49,1565,1429,20,15,6,0,4
36575,20640,659,19981,14980,3779,124,167,9,54
36576,5228,579,4649,4190,158,16,42,3,17
36578,2042,51,1991,1808,31,25,12,0,12
36579,1393,19,1374,849,436,24,1,3,3
36580,6663,602,6061,5321,382,37,22,2,4
36581,191,1,190,56,131,0,0,0,0
36582,25903,1030,24873,17753,5097,181,522,10,105
36583,652,7,645,574,29,12,0,1,1
36584,718,7,711,501,160,12,2,0,0
36585,929,9,920,671,180,27,1,0,3
36587,11562,417,11145,9982,497,91,32,1,20
36602,910,16,894,536,303,5,7,0,7
36603,8184,65,8119,948,6968,14,9,4,21
36604,8798,234,8564,4788,3390,28,33,6,18
36605,25113,550,24563,6049,17483,58,133,14,89
36606,19042,647,18395,7099,10392,54,241,17,60
36607,6264,149,6115,2256,3624,16,9,3,14
36608,39782,1581,38201,22886,12917,177,696,20,160
36609,24265,1108,23157,11027,10080,72,987,32,77
36610,9699,51,9648,198,9197,18,7,1,21
36611,6457,189,6268,3153,2760,36,27,1,27
36612,4013,48,3965,199,3661,2,2,1,15
36613,12383,265,12118,5651,5828,125,39,0,42
36615,26,0,26,2,21,0,0,0,0
36617,11408,205,11203,180,10706,23,43,4,23
36618,17425,426,16999,5259,11001,48,99,1,75
36619,14441,693,13748,10786,1630,69,581,6,67
36652,118,6,112,90,22,0,0,0,0
36663,210,2,208,82,126,0,0,0,0
36688,2192,219,1973,1434,369,0,162,0,2
36693,18914,827,18087,11329,5373,52,514,10,54
36695,51174,2214,48960,33639,10680,246,2085,25,142
36701,21448,173,21275,6434,14243,41,108,6,23
36703,11754,100,11654,2209,9144,7,36,4,7
36720,689,3,686,28,657,1,0,0,0
36722,401,2,399,101,293,0,0,0,0
36723,220,5,215,7,204,1,0,0,1
36726,4948,49,4899,1615,3182,1,7,3,10
36727,45,4,41,24,16,0,0,0,0
36728,570,27,543,84,455,0,0,0,0
36732,8053,207,7846,3245,4390,1,48,1,9
36736,1299,8,1291,285,994,0,0,0,0
36738,808,12,796,256,519,4,0,0,0
36740,931,5,926,207,702,2,0,0,2
36741,73,0,73,20,47,2,0,0,1
36742,2269,71,2198,1402,749,4,4,0,8
36744,6444,35,6409,1922,4329,13,11,4,8
36748,2929,33,2896,1408,1420,0,1,0,13
36749,993,8,985,544,400,0,1,0,3
36750,2792,88,2704,2122,499,8,0,0,5
36751,843,3,840,89,743,0,0,0,3
36752,1559,20,1539,835,662,1,2,0,3
36753,10,0,10,6,1,0,0,0,0
36754,244,1,243,51,186,0,0,0,0
36756,4973,72,4901,1729,3065,8,10,1,0
36758,1321,19,1302,864,404,1,2,0,2
36759,1405,11,1394,473,895,4,1,1,3
36761,935,7,928,280,629,0,1,1,4
36763,70,3,67,62,3,0,0,0,0
36764,13,0,13,7,6,0,0,0,0
36765,1077,11,1066,272,769,0,0,0,1
36766,28,0,28,13,14,0,0,0,1
36767,1715,6,1709,245,1417,5,1,0,0
36768,726,9,717,222,476,3,1,2,3
36769,2473,20,2453,721,1681,5,1,0,0
36773,396,4,392,100,291,0,0,0,0
36775,807,3,804,175,609,2,0,0,1
36776,1347,2,1345,146,1184,2,0,0,5
36782,2140,24,2116,1061,1009,0,0,0,2
36783,737,1,736,373,350,0,0,0,1
36784,6887,58,6829,3762,2888,11,22,0,16
36785,1086,6,1080,274,788,5,0,0,1
36786,2635,13,2622,282,2303,5,0,0,0
36790,248,4,244,222,18,0,0,0,0
36792,1271,60,1211,1103,67,5,1,1,1
36793,461,4,457,410,26,2,0,0,0
36801,24590,2090,22500,11585,9559,32,485,11,66
36804,20687,845,19842,13146,5443,42,301,11,63
36830,47543,2201,45342,32211,6511,85,4856,14,113
36832,29349,1748,27601,16391,7265,59,2499,18,102
36849,4230,140,4090,1420,2650,1,5,1,1
36850,2596,39,2557,879,1595,6,8,0,7
36851,17,2,15,15,0,0,0,0,0
36852,2564,50,2514,1844,505,6,19,0,3
36853,8915,124,8791,6838,1687,20,24,0,19
36854,16399,501,15898,10670,4296,22,298,7,90
36855,1384,23,1361,1043,272,2,4,0,1
36856,7814,749,7065,2835,3575,20,96,68,43
36858,486,17,469,190,264,0,0,0,1
36860,1274,26,1248,258,950,2,0,1,5
36861,3319,43,3276,2874,280,5,15,0,5
36862,5806,127,5679,2535,3019,19,11,1,4
36863,12233,621,11612,5893,5298,29,63,5,19
36865,30,0,30,17,10,0,2,0,0
36866,3857,105,3752,2326,1270,3,7,0,11
36867,22505,1082,21423,12069,8020,66,240,24,80
36869,21748,1178,20570,8032,11470,65,122,26,70
36870,19325,1114,18211,13067,3916,71,104,39,71
36871,1118,48,1070,577,430,7,12,2,3
36874,9173,280,8893,6771,1664,31,28,4,20
36875,4464,154,4310,2965,1052,15,29,4,15
36877,12461,497,11964,9041,2240,37,87,7,37
36879,2586,90,2496,1900,402,10,72,4,10
36901,209,2,207,22,180,0,0,0,0
36904,3755,52,3703,2189,1430,5,18,0,4
36907,1635,8,1627,414,1197,1,1,0,0
36908,2312,15,2297,1933,309,4,0,0,0
36910,14,0,14,11,3,0,0,0,0
36912,1780,19,1761,265,1452,6,0,0,5
36913,41,0,41,38,2,0,0,0,0
36915,643,2,641,515,106,0,0,0,1
36916,542,3,539,188,341,2,0,0,0
36919,1830,10,1820,868,909,5,1,0,1
36921,982,8,974,792,156,2,0,0,1
36922,622,2,620,157,455,0,0,0,2
36925,3231,9,3222,399,2756,3,7,1,1
37010,5609,309,5300,4691,235,18,63,3,27
37012,2339,44,2295,2133,53,6,4,0,15
37013,96379,23051,73328,30798,33017,113,5439,39,437
37014,2498,125,2373,2155,82,7,36,1,7
37015,18761,974,17787,16278,480,43,85,13,46
37016,967,24,943,877,4,1,3,0,6
37018,2392,70,2322,2187,14,16,18,3,0
37019,890,29,861,777,42,6,1,0,0
37020,5272,273,4999,4532,142,13,73,0,18
37022,6072,223,5849,5507,97,12,15,2,20
37023,1731,41,1690,1574,13,9,2,0,5
37025,6779,225,6554,6120,45,35,20,0,14
37026,2500,83,2417,2231,16,3,2,0,12
37027,61370,2296,59074,49319,2353,72,4797,11,233
37028,650,20,630,596,0,1,1,0,1
37029,6289,219,6070,5648,128,19,40,3,13
37030,7258,224,7034,6519,193,18,46,0,10
37031,4296,148,4148,3809,123,9,20,1,12
37032,4663,214,4449,4096,99,20,16,0,15
37033,7865,174,7691,7160,172,23,23,0,20
37034,8412,375,8037,7530,176,20,14,0,8
37035,3796,121,3675,3421,40,12,18,5,20
37036,6486,193,6293,5809,248,16,13,0,14
37037,8864,476,8388,7122,576,32,164,1,27
37040,60382,5959,54423,34333,14257,226,1052,228,329
37042,83498,11348,72150,40217,22153,293,2091,543,538
37043,52792,3583,49209,38725,5519,134,1586,82,232
37046,5941,221,5720,5133,189,20,75,4,22
37047,2495,60,2435,2282,41,12,5,0,2
37048,6927,219,6708,6364,71,9,36,2,11
37049,3564,116,3448,3071,176,4,16,0,10
37050,1722,33,1689,1538,48,11,1,3,6
37051,4019,105,3914,3619,60,14,16,3,8
37052,2853,84,2769,2571,69,7,10,2,17
37055,29319,1762,27557,24399,1457,101,215,1,99
37057,1011,64,947,861,24,19,1,0,1
37058,7396,173,7223,6641,128,47,69,2,24
37059,1578,43,1535,1454,13,8,3,0,3
37060,2916,103,2813,2586,104,1,7,0,13
37061,4852,99,4753,4395,146,13,14,7,21
37062,12710,650,12060,11205,176,30,107,4,60
37064,62422,5133,57289,49451,3249,101,2072,37,310
37066,59370,5021,54349,43172,7440,153,856,31,240
37067,31465,1871,29594,22968,1264,43,4076,16,133
37069,20832,674,20158,18557,364,24,508,2,67
37072,33065,3158,29907,22335,5219,72,642,58,133
37073,14506,537,13969,12953,298,35,132,3,30
37074,10413,331,10082,7807,1816,13,25,0,16
37075,71023,4337,66686,55698,5756,171,1433,60,234
37076,39326,4121,35205,24079,7718,98,1305,18,178
37078,709,10,699,653,8,0,7,0,1
37079,2731,102,2629,2448,27,2,6,0,10
37080,7429,342,7087,6396,302,16,27,11,28
37082,6138,245,5893,5565,68,12,21,0,16
37083,15786,1231,14555,13890,84,31,30,6,24
37085,5268,193,5075,4634,190,10,35,0,9
37086,37463,9396,28067,15478,9404,79,1352,31,241
37087,51658,3696,47962,40181,4692,157,551,18,208
37090,18369,885,17484,15718,724,51,170,7,67
37091,22554,1818,20736,17647,1770,64,125,7,75
37095,2033,82,1951,1824,5,3,13,0,10
37096,5812,87,5725,5324,166,33,20,1,11
37097,2269,37,2232,2113,17,8,6,0,8
37098,5413,154,5259,4875,129,24,20,0,12
37101,6481,145,6336,5981,61,19,17,0,8
37110,32952,3225,29727,27258,919,62,229,9,115
37115,39821,8986,30835,15379,13247,77,417,15,168
37118,1403,29,1374,1262,34,3,5,4,3
37122,64018,3299,60719,51189,4103,161,2243,18,283
37127,20353,1444,18909,14249,2673,60,904,15,80
37128,70329,5225,65104,47345,10719,143,3144,33,323
37129,60494,4658,55836,44430,6251,135,1798,40,280
37130,59677,6368,53309,35332,13054,194,1504,34,362
37132,2880,99,2781,1707,874,5,44,1,14
37134,2981,65,2916,2699,44,10,10,0,1
37135,21176,1007,20169,16558,1366,20,1271,12,67
37137,2828,74,2754,2577,41,23,10,1,3
37138,23631,1454,22177,18190,2267,68,415,14,90
37140,1361,61,1300,809,480,3,2,0,0
37141,1186,36,1150,1043,41,0,0,0,4
37142,1970,42,1928,1780,66,3,12,4,2
37143,4032,146,3886,3598,70,9,23,1,34
37144,3300,77,3223,2973,85,7,15,1,5
37145,2493,52,2441,2320,15,9,1,0,1
37146,7567,324,7243,6635,194,27,54,6,22
37148,25318,1476,23842,21632,842,62,120,4,56
37149,2675,137,2538,2240,53,18,26,2,13
37150,4951,246,4705,4526,16,9,6,1,3
37151,534,14,520,473,14,0,0,0,0
37153,5726,248,5478,5023,123,9,52,2,21
37160,36976,7074,29902,24745,3266,91,253,11,119
37165,64,1,63,57,3,0,0,0,0
37166,14379,1365,13014,12234,169,28,54,5,29
37167,61731,9749,51982,36652,8938,101,3261,58,247
37171,1156,40,1116,1000,49,0,5,0,15
37172,31851,5206,26645,21055,4054,51,152,13,107
37174,48849,3815,45034,38853,2814,89,948,35,220
37175,987,44,943,860,2,8,0,0,1
37178,2281,57,2224,2082,31,10,3,1,21
37179,16995,923,16072,14558,518,41,275,7,56
37180,3316,126,3190,3039,58,2,6,0,6
37181,1509,34,1475,1394,14,5,2,0,2
37183,3494,146,3348,3074,96,22,23,2,1
37184,6250,217,6033,5462,229,30,14,0,12
37185,9082,241,8841,8001,389,16,24,0,64
37186,10263,348,9915,9300,78,32,37,0,26
37187,7382,281,7101,6685,40,27,27,0,28
37188,16281,758,15523,14195,325,31,167,2,70
37189,3636,269,3367,1730,1417,5,37,2,19
37190,8930,261,8669,8078,145,15,31,4,14
37191,3969,194,3775,3254,136,27,45,4,24
37201,2448,135,2313,1386,752,11,80,1,17
37203,20429,1062,19367,12957,4311,28,1189,6,63
37204,15959,648,15311,12756,1546,25,374,5,48
37205,24551,718,23833,21848,542,17,579,5,91
37206,27792,1614,26178,17020,7370,64,369,12,128
37207,38719,4295,34424,8789,23764,105,366,15,194
37208,21609,967,20642,7416,12038,23,300,4,100
37209,40498,4016,36482,25250,7408,80,2041,10,170
37210,17134,3624,13510,7457,4840,59,426,5,103
37211,81830,22465,59365,38172,11651,135,6081,33,403
37212,22318,1194,21124,15843,2064,39,2257,11,98
37213,112,7,105,44,54,0,2,0,0
37214,30480,2775,27705,20510,4734,73,834,17,142
37215,23756,699,23057,20859,493,35,936,1,61
37216,18191,1127,17064,12645,3210,39,264,7,101
37217,33115,9278,23837,12243,9577,56,667,18,173
37218,14875,633,14242,3251,10318,26,171,2,67
37219,2265,113,2152,1833,122,4,115,0,16
37220,6750,208,6542,6105,123,6,89,0,14
37221,42312,2145,40167,33125,3201,64,1727,12,189
37228,1710,60,1650,591,863,4,125,0,6
37232,0,0,0,0,0,0,0,0,0
37238,9,1,8,0,0,0,2,0,4
37301,1653,25,1628,1540,5,4,8,0,3
37302,4934,340,4594,4064,156,9,108,3,13
37303,25894,1424,24470,21539,1251,74,273,13,52
37305,735,10,725,684,1,2,1,0,3
37306,2749,142,2607,2379,95,3,11,3,4
37307,5092,64,5028,4768,21,25,5,1,8
37308,2825,67,2758,2593,20,8,10,1,6
37309,2137,62,2075,1895,46,5,9,0,4
37310,4384,138,4246,3862,153,13,12,3,16
37311,29687,3636,26051,21490,2486,96,207,60,115
37312,36291,2808,33483,29078,1672,80,805,35,125
37313,1360,8,1352,1308,4,1,5,0,2
37315,1760,184,1576,1205,236,0,72,0,5
37316,12,0,12,12,0,0,0,0,0
37317,2565,59,2506,2364,7,6,6,2,3
37318,1972,45,1927,1656,158,3,3,0,2
37321,19823,1649,18174,16694,456,46,134,4,43
37322,8855,144,8711,8184,102,42,20,0,26
37323,31497,1631,29866,27374,689,70,134,20,81
37324,5119,230,4889,4221,306,22,48,1,7
37325,1930,31,1899,1808,8,7,2,3,0
37326,420,0,420,386,0,7,8,0,0
37327,12412,557,11855,11271,51,41,58,4,24
37328,1504,84,1420,1311,18,7,0,6,7
37329,5381,122,5259,4964,29,8,27,0,6
37330,7026,128,6898,6412,129,13,39,2,15
37331,7792,243,7549,6795,290,26,36,0,12
37332,2713,75,2638,2472,21,11,10,2,2
37333,550,3,547,501,1,1,0,0,3
37334,23435,818,22617,19199,2022,77,139,5,68
37335,2824,142,2682,2475,28,12,7,5,5
37336,4650,117,4533,4243,71,22,18,6,5
37337,1499,8,1491,1444,5,7,6,0,0
37338,3328,180,3148,2942,12,10,8,0,3
37339,1923,15,1908,1819,2,3,2,0,0
37340,472,11,461,432,9,5,3,0,0
37341,12900,374,12526,10424,1281,22,119,8,52
37342,3809,194,3615,3391,27,0,18,1,20
37343,43626,2253,41373,35399,2781,96,1076,17,107
37345,2202,172,2030,1909,43,13,1,0,2
37347,8280,226,8054,7234,364,17,43,0,25
37348,1192,27,1165,1070,21,6,2,0,3
37350,2058,27,2031,1945,13,0,19,0,3
37351,376,12,364,308,11,0,4,0,0
37352,3347,39,3308,3114,72,8,16,0,1
37353,5168,301,4867,4388,107,14,47,4,27
37354,17535,599,16936,15739,218,50,80,3,33
37355,28487,1899,26588,24231,724,67,356,7,63
37356,2521,38,2483,2338,13,8,25,0,6
37357,6382,435,5947,5503,154,14,31,1,24
37359,684,14,670,636,10,0,1,0,3
37360,1667,65,1602,1452,33,9,21,0,5
37361,1684,39,1645,1546,12,2,4,1,2
37362,3678,102,3576,3408,22,7,1,2,2
37363,41120,3024,38096,32178,2826,68,1105,22,191
37365,1340,15,1325,1258,1,4,3,0,1
37366,958,7,951,912,0,0,3,0,0
37367,11835,327,11508,10346,783,38,29,0,1
37369,916,19,897,840,3,1,4,0,3
37370,4879,129,4750,4338,64,7,45,0,10
37373,3343,73,3270,3074,19,7,13,0,11
37374,1668,18,1650,1569,13,5,5,1,2
37375,3657,120,3537,3148,107,11,56,1,108
37376,387,10,377,359,1,1,2,0,1
37377,17004,475,16529,15515,98,21,223,9,43
37379,28552,654,27898,26140,352,53,120,6,48
37380,6305,117,6188,5188,583,29,53,1,19
37381,9213,173,9040,8473,103,38,44,0,23
37383,312,10,302,245,13,0,18,0,26
37385,8108,126,7982,7596,4,30,7,0,4
37387,4089,67,4022,3764,10,16,14,0,10
37388,26352,1066,25286,22155,1383,72,211,29,90
37391,1573,14,1559,1448,1,4,2,0,3
37394,74,2,72,53,10,0,1,0,1
37396,280,2,278,252,1,2,0,0,0
37397,9928,207,9721,9214,66,20,23,0,5
37398,15693,593,15100,13236,1021,47,151,7,55
37402,4464,122,4342,1852,2204,13,63,2,15
37403,5666,404,5262,3863,933,8,262,0,16
37404,13106,2665,10441,4270,5619,22,57,4,56
37405,18231,763,17468,15096,1081,37,459,3,66
37406,12422,342,12080,2311,9173,23,39,3,45
37407,9779,4121,5658,2350,2920,31,15,3,32
37408,3353,289,3064,2019,838,10,48,1,10
37409,2791,110,2681,2045,430,9,22,0,15
37410,4082,154,3928,309,3473,2,6,0,7
37411,17499,1316,16183,6178,9072,45,158,2,63
37412,21881,2835,19046,14638,2887,53,396,3,75
37415,23580,1492,22088,19090,1377,51,465,9,100
37416,14844,687,14157,6876,6403,32,171,8,58
37419,6438,138,6300,5719,160,15,138,4,17
37421,51686,4039,47647,32740,9577,135,2951,14,209
37450,0,0,0,0,0,0,0,0,0
37601,37079,2184,34895,30222,2095,67,468,13,116
37604,37025,2210,34815,29564,2234,90,868,21,204
37614,4027,311,3716,2889,548,17,110,0,117
37615,22151,608,21543,19835,366,49,363,7,65
37616,4864,115,4749,4541,22,6,2,1,6
37617,14422,168,14254,13609,105,20,67,3,35
37618,12729,177,12552,11883,75,44,56,0,27
37620,38245,849,37396,34684,854,62,277,11,86
37640,3664,45,3619,3481,4,13,2,0,0
37641,8699,223,8476,8092,64,23,15,0,21
37642,15041,203,14838,14129,136,22,49,6,22
37643,33752,728,33024,31077,378,95,113,5,71
37645,5469,77,5392,5179,45,10,18,1,6
37650,12329,735,11594,11153,35,25,23,0,12
37656,3611,57,3554,3378,14,14,15,1,6
37657,879,17,862,828,0,3,1,0,2
37658,4019,38,3981,3786,6,18,8,1,0
37659,29313,769,28544,26637,445,54,210,8,99
37660,39479,1022,38457,34729,1363,99,448,11,146
37663,14392,297,14095,13278,134,30,119,1,63
37664,28748,785,27963,25671,651,65,330,6,101
37665,5204,192,5012,4679,81,19,5,2,7
37680,661,6,655,631,0,3,2,0,0
37681,6234,154,6080,5789,38,4,6,4,10
37682,392,34,358,307,28,0,9,0,1
37683,12867,443,12424,11314,719,17,25,7,6
37686,8207,160,8047,7617,72,18,51,3,8
37687,4641,51,4590,4419,4,10,13,1,2
37688,963,7,956,925,0,0,0,1,2
37690,4332,124,4208,3960,42,3,13,0,10
37691,851,18,833,784,3,4,0,1,0
37692,4808,352,4456,4271,9,14,13,0,7
37694,1766,37,1729,1625,13,3,4,0,2
37701,8798,637,8161,6423,1123,29,105,3,39
37705,5031,63,4968,4739,14,13,11,0,9
37708,6584,146,6438,6161,38,13,11,0,11
37709,3900,72,3828,3655,24,4,12,1,6
37710,1025,20,1005,956,0,5,0,0,0
37711,5056,78,4978,4749,15,14,8,2,10
37713,1407,39,1368,1292,4,5,3,1,0
37714,4352,63,4289,4050,5,5,17,0,6
37715,835,1,834,808,0,0,0,2,0
37716,25920,537,25383,23487,413,68,167,10,90
37719,157,0,157,144,0,0,0,0,0
37721,14222,334,13888,13074,197,28,48,8,29
37722,6138,143,5995,5697,14,25,16,0,13
37723,977,23,954,898,7,4,3,0,4
37724,2581,16,2565,2419,25,5,34,0,2
37725,18395,446,17949,16910,239,60,84,5,44
37726,1959,28,1931,1860,4,3,1,1,6
37727,2175,30,2145,2071,9,6,3,1,0
37729,1381,5,1376,1353,0,1,0,0,0
37730,57,0,57,56,0,0,0,0,0
37731,786,6,780,758,5,3,0,0,1
37732,56,1,55,54,0,0,0,0,0
37733,40,1,39,34,0,0,0,0,1
37737,6293,164,6129,5751,50,19,43,6,11
37738,5001,686,4315,4025,24,18,82,6,18
37742,6160,132,6028,5712,23,22,20,0,15
37743,25755,946,24809,23053,647,35,81,5,69
37745,19714,1052,18662,17075,516,55,190,3,90
37748,17227,215,17012,15627,511,56,68,7,28
37752,6421,124,6297,5886,110,14,51,2,46
37753,862,11,851,801,2,9,0,0,1
37754,4826,107,4719,4475,31,5,23,0,11
37755,3567,29,3538,3432,8,11,4,0,0
37756,2764,22,2742,2673,2,1,4,0,0
37757,9494,107,9387,8976,20,13,37,0,49
37760,13726,850,12876,11871,344,43,105,4,54
37762,2893,19,2874,2738,42,6,5,0,2
37763,15465,316,15149,14059,239,37,92,3,44
37764,10583,466,10117,9415,49,43,61,3,26
37765,510,1,509,489,2,2,0,0,1
37766,18011,269,17742,16975,58,46,28,0,29
37769,5724,67,5657,5330,23,17,22,0,4
37770,2716,38,2678,2518,2,5,8,2,20
37771,16822,2801,14021,13025,183,31,139,0,54
37772,13453,681,12772,11940,123,19,175,1,33
37774,20678,1737,18941,17865,231,37,136,1,65
37777,12200,541,11659,10440,502,31,80,3,49
37779,3812,123,3689,3503,21,7,5,1,7
37801,28822,1182,27640,25006,562,67,445,7,111
37803,33463,904,32559,30335,388,79,273,1,111
37804,27075,1657,25418,23178,708,77,258,0,67
37806,3258,100,3158,2969,50,4,6,0,9
37807,10449,196,10253,9868,23,14,22,2,19
37809,2200,70,2130,2008,20,9,5,2,1
37810,1834,24,1810,1726,11,5,1,1,2
37811,3507,49,3458,3316,12,3,4,0,11
37813,18030,3395,14635,12997,676,32,121,89,30
37814,34130,5681,28449,25061,1276,71,512,173,82
37818,4908,74,4834,4583,32,8,4,1,5
37819,712,9,703,677,0,1,1,0,0
37820,7991,287,7704,7240,73,22,23,1,21
37821,22928,650,22278,20580,517,69,116,6,33
37825,8958,147,8811,8380,65,26,25,1,18
37826,4419,93,4326,3957,107,12,40,2,12
37828,1458,25,1433,1375,2,4,7,0,4
37829,1747,32,1715,1607,10,9,6,1,16
37830,31839,1952,29887,24533,2331,90,820,48,151
37840,9330,154,9176,8639,133,25,26,2,19
37841,9443,111,9332,8997,20,14,33,0,6
37843,3731,104,3627,3453,37,13,13,1,5
37845,362,2,360,347,0,0,0,0,0
37846,4994,484,4510,4196,54,14,12,0,24
37847,2602,13,2589,2538,3,3,2,0,1
37848,330,8,322,310,1,1,0,0,0
37849,27742,1325,26417,24285,653,44,215,10,64
37851,0,0,0,0,0,0,0,0,0
37852,2625,24,2601,2513,0,6,4,0,0
37853,3621,228,3393,3053,139,11,17,0,7
37854,12614,219,12395,11435,303,37,65,1,46
37857,21026,323,20703,19499,286,38,93,2,40
37860,4281,142,4139,3849,75,4,14,1,13
37861,8790,506,8284,7872,42,18,26,1,10
37862,23236,3807,19429,17941,236,65,390,7,94
37863,6988,1566,5422,4877,66,19,210,3,26
37865,22567,670,21897,20500,163,70,170,2,43
37866,1957,21,1936,1844,1,4,7,0,3
37869,4908,29,4879,4701,28,22,5,0,7
37870,4303,54,4249,4108,13,1,13,3,1
37871,9245,242,9003,8440,120,27,31,4,25
37872,2037,11,2026,1961,5,9,1,2,0
37873,4158,107,4051,3843,28,14,11,1,18
37874,15604,820,14784,13468,529,39,69,1,40
37876,32866,1490,31376,29626,239,112,207,1,51
37877,8739,339,8400,7860,83,23,68,4,27
37878,530,10,520,488,4,1,3,0,2
37879,10490,161,10329,9865,104,14,21,3,21
37880,3690,86,3604,3389,16,13,12,0,13
37881,2235,14,2221,2144,11,1,2,0,4
37882,3061,51,3010,2877,9,0,10,1,13
37885,5509,136,5373,5141,17,18,31,0,10
37886,4481,116,4365,4109,15,6,16,2,16
37887,7118,131,6987,5853,945,21,19,1,11
37888,2734,37,2697,2609,7,5,3,0,3
37890,6890,592,6298,5955,48,15,26,8,19
37891,3437,65,3372,3203,32,5,10,1,5
37892,1946,12,1934,1867,1,2,7,0,0
37902,2479,81,2398,2067,190,4,53,1,7
37909,16066,1221,14845,11802,1477,34,657,11,41
37912,22313,2364,19949,15131,3013,62,432,6,79
37914,20587,1044,19543,11002,7268,68,127,7,90
37915,5509,295,5214,1713,3084,29,23,4,36
37916,14400,842,13558,11122,1119,73,934,12,25
37917,25013,2287,22726,17424,3503,69,188,4,127
37918,46245,2612,43633,37777,3113,127,383,26,149
37919,30822,1554,29268,24865,1716,57,1153,12,115
37920,41210,1685,39525,34102,2421,114,505,9,172
37921,28903,3727,25176,17953,4990,71,294,24,160
37922,39623,1605,38018,33305,1008,54,1975,7,108
37923,29705,2629,27076,22392,1938,61,991,110,151
37924,12894,469,12425,10487,1178,16,144,2,47
37929,0,0,0,0,0,0,0,0,0
37931,31358,1705,29653,25842,1411,61,733,20,114
37932,21726,1236,20490,17452,859,37,991,8,104
37934,27414,1116,26298,22737,572,37,1857,15,126
37938,18207,388,17819,16755,184,31,153,8,35
38001,4464,595,3869,3123,620,2,4,0,21
38002,44385,2599,41786,30121,8048,93,1437,22,166
38004,11561,376,11185,9040,1281,33,132,16,51
38006,5178,647,4531,3566,753,1,20,1,22
38007,37,2,35,26,0,1,0,0,2
38008,9110,157,8953,3767,4841,19,72,3,32
38011,9427,256,9171,7745,884,18,47,4,34
38012,13901,742,13159,5053,7738,26,22,6,45
38015,2601,65,2536,2301,102,10,3,0,2
38016,48322,3554,44768,16618,23877,64,2210,13,275
38017,55114,2311,52803,37186,6826,79,6571,21,196
38018,37086,3017,34069,14754,15742,61,1897,7,201
38019,15129,288,14841,9071,5111,42,60,3,38
38021,40,4,36,35,1,0,0,0,0
38023,5443,138,5305,4343,634,19,37,3,13
38024,26518,949,25569,19504,4704,40,185,10,73
38028,7211,225,6986,5633,922,9,153,2,25
38029,81,6,75,54,6,0,3,0,0
38030,557,8,549,527,4,0,2,0,1
38034,2783,191,2592,2316,152,8,1,0,4
38036,220,8,212,90,115,2,0,0,2
38037,1718,41,1677,1215,394,7,0,0,2
38039,1758,16,1742,440,1260,5,3,0,8
38040,4984,140,4844,3865,716,21,11,0,39
38041,4075,91,3984,2476,1343,52,1,0,5
38042,685,6,679,437,230,1,1,0,0
38044,811,14,797,749,12,2,6,0,1
38046,28,0,28,27,1,0,0,0,0
38047,124,2,122,106,2,3,0,0,1
38049,4357,111,4246,2048,2020,3,3,5,13
38050,382,46,336,188,137,3,0,0,0
38052,3757,57,3700,3192,339,6,57,0,6
38053,26839,1609,25230,16719,6506,108,346,14,87
38054,93,22,71,32,18,0,0,5,3
38057,3519,70,3449,2042,1278,3,7,0,19
38058,10962,399,10563,8893,913,43,89,8,41
38059,7607,253,7354,6419,533,30,24,1,21
38060,11649,389,11260,7958,2709,11,101,2,34
38061,972,8,964,906,21,0,1,0,0
38063,16033,357,15676,8905,6082,56,41,0,19
38066,3068,77,2991,1952,914,3,9,0,21
38067,1233,15,1218,922,238,2,6,0,7
38068,10952,320,10632,6593,3546,20,39,5,36
38069,2498,42,2456,1200,1188,5,3,0,3
38070,89,7,82,41,41,0,0,0,0
38075,6680,205,6475,3233,3087,8,10,0,18
38076,762,12,750,555,173,1,1,1,3
38077,33,2,31,30,0,1,0,0,0
38079,4890,118,4772,3144,1484,10,8,1,2
38080,2408,67,2341,1876,353,6,5,4,4
38103,14739,1086,13653,8354,3659,35,1098,1,81
38104,22584,1033,21551,13651,6143,58,660,3,114
38105,6232,254,5978,889,4609,10,294,2,15
38106,22394,518,21876,335,20878,37,45,1,75
38107,15655,388,15267,2562,12030,34,142,5,53
38108,17051,4792,12259,2039,9571,49,102,2,89
38109,42437,714,41723,612,40128,70,34,5,154
38111,40533,5099,35434,15028,18129,58,923,12,119
38112,16970,2181,14789,5824,7865,30,395,7,50
38113,11,3,8,1,4,0,0,0,0
38114,23559,733,22826,1048,21188,48,34,8,48
38115,40076,4564,35512,2270,32198,51,248,4,111
38116,39107,1162,37945,1063,35990,64,66,5,147
38117,27138,1973,25165,20430,2937,26,690,17,101
38118,39627,7621,32006,2064,28620,43,521,8,136
38119,23997,1169,22828,11718,9448,34,860,4,111
38120,14536,503,14033,11712,922,16,871,5,69
38122,26432,9144,17288,9981,5582,42,620,8,133
38125,40970,2681,38289,4807,30624,67,1820,23,194
38126,5717,70,5647,154,5375,8,8,1,5
38127,40679,1335,39344,3872,34108,78,73,9,130
38128,43197,3951,39246,4154,33679,60,187,3,196
38131,14,7,7,0,3,0,0,0,1
38132,55,17,38,24,2,0,5,0,1
38133,22482,4035,18447,11750,4782,38,962,10,97
38134,41760,4075,37685,17042,18113,75,810,10,145
38135,29609,1399,28210,17252,8857,50,837,18,113
38138,25837,822,25015,21247,1320,38,1477,4,96
38139,16734,459,16275,13725,427,29,1502,1,36
38141,22333,3144,19189,942,17626,29,190,6,76
38152,127,18,109,37,67,0,0,0,0
38201,10095,410,9685,8393,802,22,48,0,38
38220,1919,67,1852,1511,252,2,10,0,6
38221,3113,63,3050,2902,1,10,6,4,2
38222,2591,37,2554,2398,29,9,3,7,5
38224,938,19,919,848,13,0,2,0,7
38225,5929,119,5810,5400,172,10,19,1,11
38226,272,9,263,238,4,0,7,1,1
38229,2738,55,2683,2560,28,7,1,0,2
38230,3499,50,3449,3162,159,12,11,0,8
38231,1739,136,1603,1471,79,3,1,0,1
38232,1990,16,1974,1905,6,2,0,0,5
38233,2653,52,2601,2307,171,11,1,0,4
38235,209,3,206,182,13,6,1,0,1
38236,606,18,588,513,47,2,2,0,4
38237,15826,569,15257,12267,2076,17,139,1,48
38240,1970,41,1929,1811,55,0,2,0,2
38241,789,29,760,725,0,0,2,0,2
38242,19940,521,19419,16152,2020,49,175,0,102
38251,2750,77,2673,2504,63,2,5,0,3
38253,970,49,921,887,11,0,2,0,0
38254,5,0,5,5,0,0,0,0,0
38255,2132,37,2095,1915,91,3,5,0,6
38256,3293,45,3248,3085,42,6,10,0,2
38257,4121,78,4043,3509,377,6,9,0,12
38258,1437,31,1406,1171,156,9,1,0,7
38259,730,14,716,654,21,4,0,0,2
38260,3838,64,3774,3616,44,6,4,0,4
38261,16627,1291,15336,11879,2590,33,87,0,42
38301,34170,1357,32813,14369,16990,69,103,4,100
38305,52686,2997,49689,30028,16596,89,1067,5,217
38310,6204,96,6108,5736,119,11,22,0,11
38311,865,24,841,793,26,1,4,0,0
38313,3194,74,3120,2850,134,8,11,3,10
38315,3653,85,3568,3272,139,9,10,0,12
38316,2706,36,2670,2490,91,5,11,0,5
38317,2521,43,2478,2201,146,9,7,0,12
38318,511,13,498,428,32,2,3,0,0
38320,10362,268,10094,9275,290,36,87,0,23
38321,2450,41,2409,2092,199,1,5,0,9
38326,2527,44,2483,2372,30,9,5,0,2
38327,480,6,474,449,7,0,2,0,2
38328,926,14,912,883,1,1,0,0,0
38329,3435,81,3354,3147,102,4,3,3,6
38330,4040,74,3966,3348,480,6,4,4,6
38332,1116,39,1077,990,43,3,2,0,1
38333,427,11,416,399,1,0,3,0,1
38334,1890,54,1836,1697,61,7,5,0,7
38337,1216,50,1166,989,135,1,1,0,2
38338,50,5,45,39,2,0,0,0,0
38339,653,9,644,562,69,0,1,0,0
38340,12802,384,12418,10403,1346,46,54,2,52
38341,2159,34,2125,1996,23,4,10,1,2
38342,1296,22,1274,1154,62,4,2,2,3
38343,15629,562,15067,9942,4537,19,45,4,38
38344,9059,166,8893,7438,944,25,48,2,29
38345,2089,37,2052,1945,52,1,4,0,2
38347,319,7,312,286,8,1,2,0,1
38348,909,14,895,823,35,0,0,0,2
38351,17838,518,17320,14979,1456,30,71,0,66
38352,587,34,553,483,20,4,4,0,1
38355,7669,229,7440,6642,410,13,89,0,26
38356,2272,54,2218,1758,378,1,18,0,5
38357,2999,30,2969,2823,70,2,4,0,1
38358,12153,334,11819,9095,2183,22,47,2,24
38359,289,1,288,270,5,2,2,0,2
38361,1068,23,1045,946,36,4,4,0,0
38362,1153,46,1107,681,346,1,7,0,5
38363,5406,228,5178,4875,130,2,34,0,7
38365,17,0,17,17,0,0,0,0,0
38366,2369,77,2292,2006,177,8,3,1,10
38367,2687,35,2652,2376,202,10,8,0,0
38368,1979,50,1929,1845,22,9,4,0,2
38369,1856,22,1834,1562,186,3,1,0,5
38370,634,18,616,540,44,5,3,0,0
38371,1275,33,1242,1172,8,10,2,0,0
38372,17939,409,17530,16066,621,51,114,0,46
38374,1848,20,1828,1779,8,1,2,0,2
38375,9071,176,8895,7542,933,17,34,0,23
38376,337,8,329,314,5,0,3,0,0
38379,1492,15,1477,1426,16,4,3,0,0
38380,529,9,520,494,10,1,0,1,1
38381,1418,31,1387,1014,335,1,4,1,2
38382,9250,327,8923,6997,1539,20,28,5,22
38387,409,14,395,368,6,0,7,0,2
38388,1596,36,1560,1239,215,2,5,2,5
38389,35,0,35,31,0,3,0,0,0
38390,943,24,919,826,41,8,7,1,3
38391,1112,32,1080,341,712,1,2,0,3
38392,739,10,729,599,114,0,1,0,3
38401,63075,5453,57622,45347,8676,144,536,27,258
38425,3578,106,3472,2601,792,5,0,0,8
38449,3001,70,2931,2681,79,5,21,1,0
38450,2479,55,2424,2355,4,1,0,1,7
38451,5491,175,5316,4947,90,17,10,1,17
38452,1032,28,1004,968,3,1,0,0,2
38453,395,3,392,348,7,3,0,0,0
38454,1086,22,1064,969,29,0,0,0,2
38455,80,0,80,52,27,0,0,0,0
38456,4832,90,4742,4521,29,9,10,0,21
38457,809,9,800,754,6,1,0,0,2
38459,471,8,463,446,0,0,3,0,0
38460,1341,10,1331,1243,31,1,0,0,0
38461,1521,55,1466,1334,56,3,4,2,5
38462,10488,268,10220,9611,154,23,51,4,20
38463,2737,57,2680,2583,18,2,0,0,10
38464,23517,785,22732,20885,612,49,139,0,69
38468,5347,104,5243,4981,36,14,19,0,19
38469,4239,66,4173,4017,16,6,7,1,11
38471,512,10,502,485,0,1,3,0,3
38472,2665,63,2602,2375,84,3,8,0,12
38473,1112,9,1103,1048,9,2,4,0,0
38474,8045,236,7809,6419,931,33,38,2,23
38475,763,9,754,712,14,0,9,0,1
38476,1295,67,1228,1126,28,14,3,0,3
38477,2785,62,2723,2306,282,20,20,0,10
38478,18571,501,18070,14486,2391,76,120,8,40
38481,891,17,874,837,1,3,3,0,1
38482,1773,60,1713,1647,8,3,6,0,0
38483,6100,108,5992,5752,27,16,4,0,16
38485,6289,109,6180,5895,79,9,20,0,24
38486,1024,24,1000,937,13,3,0,0,3
38487,1203,24,1179,1050,67,3,3,0,5
38488,2452,104,2348,2227,23,8,12,0,2
38501,41141,3667,37474,33307,1456,83,758,16,94
38503,0,0,0,0,0,0,0,0,0
38504,895,7,888,860,2,2,0,0,0
38505,844,32,812,534,227,0,10,0,0
38506,29976,1422,28554,26580,386,66,287,15,64
38541,1547,13,1534,1505,0,1,1,0,2
38542,24,2,22,21,0,0,0,0,0
38543,589,12,577,550,1,3,0,0,4
38544,7435,243,7192,6781,63,21,20,1,13
38545,1403,51,1352,1258,6,7,11,0,2
38547,2100,34,2066,1977,19,3,6,0,2
38548,812,32,780,729,7,2,2,0,2
38549,3574,71,3503,3417,6,2,11,1,5
38550,5,3,2,2,0,0,0,0,0
38551,3941,50,3891,3723,76,12,4,1,3
38552,348,2,346,321,7,0,0,0,0
38553,2462,60,2402,2302,2,3,2,0,9
38554,900,14,886,853,4,1,1,0,1
38555,19930,1004,18926,17892,126,46,207,6,25
38556,12742,215,12527,12096,16,19,26,0,4
38558,9064,204,8860,8492,65,14,33,0,16
38559,1301,23,1278,1214,6,0,7,0,2
38560,1309,18,1291,1208,5,4,3,0,2
38562,6301,107,6194,5944,21,13,8,0,13
38563,2467,47,2420,2234,35,4,19,0,2
38564,586,20,566,528,1,4,0,0,2
38565,1105,9,1096,1069,2,2,2,0,0
38567,868,13,855,794,10,4,3,0,1
38568,2110,26,2084,1993,1,11,1,0,2
38569,413,10,403,373,7,2,0,0,1
38570,9685,158,9527,9099,50,28,35,0,14
38571,14324,302,14022,13368,62,33,62,2,24
38572,12193,285,11908,11340,25,26,49,3,21
38573,2106,36,2070,2014,6,7,9,0,4
38574,8816,1076,7740,7330,50,4,29,1,16
38575,1152,30,1122,1096,0,0,2,0,0
38577,1175,10,1165,1137,3,4,2,0,0
38578,176,7,169,166,0,0,0,0,0
38579,1048,19,1029,984,5,2,5,0,0
38580,2015,20,1995,1929,9,5,2,0,2
38581,4354,288,4066,3811,50,8,13,0,5
38582,1438,23,1415,1341,6,4,5,0,3
38583,25302,681,24621,22972,397,65,116,11,56
38585,4276,58,4218,4076,11,6,7,1,2
38587,1501,42,1459,1373,4,10,3,0,2
38588,1117,22,1095,1020,3,4,0,1,6
38589,298,17,281,267,0,0,2,0,4
38601,2312,56,2256,1199,972,4,12,2,6
38603,2666,39,2627,1913,611,3,0,0,17
38606,15612,445,15167,7948,6784,23,52,1,13
38610,3486,165,3321,2378,829,3,3,0,15
38611,16537,1198,15339,10069,4651,34,69,6,22
38614,16970,307,16663,3233,12962,21,111,0,40
38617,857,2,855,96,746,2,0,0,0
38618,11467,331,11136,7642,3057,17,21,0,28
38619,4615,71,4544,1914,2477,21,6,5,9
38620,3419,51,3368,1636,1649,3,0,0,2
38621,1436,14,1422,474,907,4,0,0,3
38622,549,9,540,189,340,0,0,0,1
38623,162,0,162,21,136,0,1,0,0
38625,1135,13,1122,1083,15,2,3,0,0
38626,941,13,928,359,555,2,1,0,0
38627,1280,29,1251,1112,93,2,1,0,3
38629,1624,43,1581,1405,125,1,1,0,4
38631,966,4,962,15,934,0,0,0,1
38632,29210,990,28220,23876,2936,43,303,16,61
38633,2240,32,2208,1940,216,1,0,0,6
38635,14037,272,13765,4342,9036,18,10,9,40
38637,26736,2075,24661,10098,13180,36,200,18,114
38639,673,8,665,3,654,1,1,0,0
38641,2424,94,2330,1886,312,5,32,0,8
38642,2190,70,2120,917,1151,1,1,1,14
38643,1948,10,1938,357,1534,1,0,2,2
38644,90,0,90,15,72,0,0,0,1
38645,1192,20,1172,414,741,0,1,0,2
38646,2454,8,2446,710,1700,0,6,0,1
38647,1065,24,1041,272,714,1,0,0,3
38650,4120,110,4010,3563,332,3,9,0,9
38651,8724,663,8061,6368,1267,18,58,0,39
38652,16657,1072,15585,11841,3142,20,83,0,52
38654,56730,2585,54145,33513,17200,100,1079,42,215
38655,44153,1788,42365,30269,9048,33,1544,15,95
38658,2317,21,2296,1847,387,5,0,1,5
38659,2512,38,2474,1981,411,5,1,1,6
38661,1854,61,1793,1027,698,2,5,3,0
38663,11561,818,10743,8300,2090,14,15,0,24
38664,3420,63,3357,505,2764,4,19,0,37
38665,2548,98,2450,1984,374,4,7,0,5
38666,6558,98,6460,2489,3814,9,6,2,12
38668,14482,374,14108,8714,4914,26,36,1,47
38670,875,0,875,118,747,0,3,1,0
38671,36073,2389,33684,18329,13249,48,601,39,100
38672,15866,782,15084,8923,4803,26,679,15,71
38673,1041,19,1022,503,488,2,4,2,2
38674,1047,26,1021,741,247,0,0,0,4
38676,5530,115,5415,1133,4157,7,7,0,19
38677,4712,183,4529,3744,528,8,112,0,10
38680,6582,525,6057,3162,2569,13,57,7,19
38683,4948,83,4865,4449,271,2,7,0,8
38685,1317,14,1303,812,453,6,3,0,4
38701,21051,267,20784,5957,14167,33,221,2,16
38703,12731,136,12595,1646,10656,13,59,2,43
38720,452,9,443,270,163,0,0,0,0
38721,885,5,880,237,630,0,5,0,1
38722,407,1,406,55,347,0,1,0,0
38723,32,0,32,29,0,0,0,0,0
38725,685,11,674,247,421,0,1,0,0
38726,354,7,347,74,255,3,4,0,0
38730,1551,43,1508,1026,421,1,10,0,2
38731,49,1,48,39,9,0,0,0,0
38732,17652,516,17136,7211,9234,13,227,0,33
38733,12,0,12,7,5,0,0,0,0
38736,397,8,389,233,154,0,0,0,0
38737,2803,70,2733,519,2139,7,4,0,8
38738,3140,198,2942,1285,1652,0,0,0,0
38740,393,8,385,139,236,0,1,0,0
38744,712,37,675,360,298,1,2,0,2
38745,72,1,71,18,51,0,1,0,0
38746,399,21,378,98,270,0,1,0,0
38748,3384,30,3354,937,2346,0,1,0,1
38751,10682,183,10499,2146,8098,5,74,0,21
38753,1243,35,1208,583,600,2,2,0,0
38754,1345,23,1322,326,961,3,0,0,1
38756,6112,112,6000,2257,3568,3,19,1,7
38759,1242,125,1117,731,339,3,6,0,6
38760,696,6,690,27,643,0,0,0,0
38761,2256,60,2196,507,1661,1,4,0,0
38762,2196,15,2181,32,2106,0,2,0,5
38764,265,5,260,30,223,0,1,0,0
38765,117,0,117,3,114,0,0,0,0
38767,8,0,8,4,4,0,0,0,0
38768,102,6,96,13,78,0,0,0,0
38769,1869,35,1834,232,1558,1,1,0,1
38771,2959,37,2922,493,2377,0,0,0,6
38772,117,4,113,63,50,0,0,0,0
38773,2566,30,2536,515,1979,0,8,0,2
38774,2191,21,2170,121,2014,1,0,0,4
38776,12,1,11,6,4,0,0,0,0
38778,1335,10,1325,255,1050,2,0,0,0
38781,214,0,214,0,212,0,0,0,1
38801,29795,1444,28351,14130,13003,43,302,7,91
38804,17314,640,16674,11390,4485,23,215,3,40
38821,11847,214,11633,9348,1926,29,29,1,19
38824,7788,73,7715,5683,1814,12,19,2,8
38826,5139,104,5035,3512,1241,3,137,1,20
38827,2441,199,2242,2155,11,4,4,0,2
38828,4599,115,4484,3915,410,5,13,1,13
38829,18367,332,18035,15115,2215,44,74,5,37
38833,2348,35,2313,2201,22,9,9,2,4
38834,27823,1149,26674,21501,3985,50,172,17,43
38838,1494,44,1450,1383,12,1,0,0,0
38839,81,9,72,32,35,0,0,0,0
38841,3085,359,2726,2361,260,4,2,0,5
38843,11952,213,11739,10027,1289,24,29,0,28
38844,131,0,131,130,0,0,0,0,0
38846,2003,35,1968,1850,21,7,4,0,1
38847,3165,82,3083,2968,20,13,0,0,2
38848,870,8,862,810,22,1,0,0,2
38849,6062,127,5935,4913,757,9,25,2,1
38850,3176,139,3037,2012,929,3,7,0,7
38851,8781,461,8320,4926,3152,9,28,0,7
38852,9365,155,9210,8628,232,28,16,0,2
38855,4798,81,4717,4507,92,7,8,0,3
38856,1657,14,1643,1609,4,2,3,0,0
38857,3688,125,3563,3362,104,1,12,1,5
38858,6914,133,6781,5099,1493,11,16,1,3
38859,691,10,681,674,0,0,0,0,1
38860,5535,72,5463,1747,3584,4,7,0,7
38862,2271,46,2225,1464,707,1,2,1,2
38863,20195,1455,18740,15242,2774,40,50,1,42
38864,1618,30,1588,1490,41,4,0,0,1
38865,4755,75,4680,4102,400,14,4,0,2
38866,12556,243,12313,10191,1497,10,210,6,21
38868,4905,82,4823,2437,2225,0,8,2,4
38869,370,5,365,262,77,1,2,1,6
38870,2567,15,2552,2315,170,2,4,0,3
38871,2105,77,2028,1870,94,2,0,1,1
38873,2622,50,2572,2298,171,5,10,0,0
38876,1404,27,1377,1317,18,2,4,0,4
38878,2557,463,2094,1576,455,0,4,0,2
38879,118,4,114,8,98,2,0,0,3
38901,18282,256,18026,8950,8479,23,78,2,23
38913,354,6,348,336,7,0,2,0,0
38914,520,13,507,380,86,0,0,0,0
38915,3634,103,3531,2518,910,7,5,0,5
38916,4389,120,4269,2596,1519,4,2,0,10
38917,3679,63,3616,2764,742,4,12,0,5
38920,723,2,721,520,176,0,0,0,0
38921,4523,25,4498,1321,3110,1,7,0,0
38922,3342,27,3315,1791,1428,5,3,0,1
38923,1188,10,1178,568,576,3,1,0,7
38924,606,21,585,120,456,2,1,0,3
38925,2040,12,2028,1211,778,4,2,0,1
38927,1125,9,1116,814,277,0,0,2,0
38928,406,4,402,38,360,0,0,0,0
38929,1239,21,1218,681,497,2,1,0,0
38930,23438,579,22859,5981,16240,11,197,0,15
38940,2106,25,2081,1587,436,4,5,0,3
38941,4004,190,3814,376,3365,4,10,0,11
38943,696,4,692,514,166,0,0,0,0
38944,329,2,327,135,176,0,0,0,0
38946,248,10,238,45,189,0,0,0,0
38947,79,1,78,53,22,0,0,0,0
38948,1975,31,1944,1215,691,7,4,0,0
38949,248,4,244,230,4,0,0,0,0
38950,331,1,330,145,181,0,0,0,0
38951,1093,15,1078,677,373,2,2,0,0
38952,395,8,387,143,229,0,0,0,0
38953,629,1,628,467,135,0,0,0,0
38954,1086,71,1015,342,657,0,2,0,3
38957,514,3,511,211,289,1,0,1,0
38961,1103,8,1095,699,374,0,0,0,0
38962,42,0,42,10,32,0,0,0,0
38963,3292,375,2917,844,2045,3,0,0,0
38964,119,1,118,70,46,0,0,0,0
38965,9219,160,9059,6233,2534,20,24,2,22
38966,639,7,632,83,542,1,0,0,0
38967,6590,71,6519,3222,3125,0,24,0,7
39038,5401,56,5345,820,4384,9,10,0,6
39039,2187,32,2155,1286,812,4,7,1,2
39040,2998,19,2979,1932,955,0,17,0,5
39041,3376,36,3340,904,2357,3,5,0,7
39042,39069,846,38223,28833,7846,74,309,2,66
39044,3718,31,3687,2755,808,3,5,0,19
39045,1261,2,1259,144,1092,1,4,0,3
39046,27866,1380,26486,7661,18038,52,183,1,39
39047,39191,1057,38134,29888,6006,73,846,2,137
39051,15677,1119,14558,7589,5828,759,69,4,37
39054,393,14,379,106,242,0,2,0,0
39056,27346,718,26628,13766,10704,29,1257,7,104
39057,2388,32,2356,1041,139,1100,2,0,1
39058,1468,70,1398,1153,179,20,31,0,3
39059,12073,479,11594,5134,6105,8,42,12,14
39061,43,1,42,16,26,0,0,0,0
39062,397,0,397,301,84,1,0,0,1
39063,3111,19,3092,429,2608,1,0,0,0
39066,3912,46,3866,1093,2676,8,3,0,12
39067,1260,11,1249,944,269,5,3,0,1
39069,5227,56,5171,379,4684,7,11,5,6
39071,5674,50,5624,3138,2306,13,26,0,12
39073,20613,468,20145,16527,2838,32,40,1,52
39074,14552,2453,12099,5464,6267,35,64,0,27
39078,773,13,760,324,418,2,0,1,3
39079,1858,23,1835,428,1361,7,2,0,3
39082,1259,5,1254,857,375,4,2,0,1
39083,9517,439,9078,2689,6093,5,49,6,13
39086,1885,14,1871,219,1633,2,0,0,2
39088,25,0,25,21,4,0,0,0,0
39090,12639,284,12355,6164,5823,17,62,4,30
39092,2870,85,2785,1731,983,3,4,0,6
39094,3860,66,3794,2265,1403,11,27,0,6
39095,6826,29,6797,1097,5550,17,16,0,8
39096,2310,14,2296,144,2126,1,1,0,1
39097,722,10,712,136,562,0,0,0,0
39108,1749,23,1726,1111,578,0,3,0,2
39110,48474,1007,47467,37572,6594,43,1888,8,137
39111,9517,252,9265,5606,3352,10,54,2,24
39113,461,104,357,40,312,1,1,0,1
39114,9673,101,9572,5827,3439,12,15,0,28
39115,81,2,79,21,54,0,0,0,0
39116,2249,36,2213,1998,148,4,9,0,1
39117,10573,1573,9000,6572,2101,57,24,0,15
39119,5132,75,5057,2584,2344,3,21,0,6
39120,29634,1008,28626,10784,16945,57,166,7,34
39140,2119,23,2096,1094,958,0,2,0,0
39144,975,13,962,172,762,0,1,0,0
39145,5163,112,5051,4077,803,8,21,0,11
39146,2591,22,2569,392,2126,6,3,0,0
39148,24,1,23,0,18,1,2,0,1
39149,1657,12,1645,810,797,0,3,0,2
39150,5079,36,5043,634,4324,5,0,0,5
39152,1138,24,1114,881,219,0,1,0,1
39153,3029,30,2999,2220,731,8,5,0,6
39154,9512,117,9395,5342,3786,9,31,2,26
39156,449,9,440,364,62,0,5,0,1
39157,24611,1646,22965,11311,9792,31,1029,4,105
39159,2933,54,2879,837,1968,0,9,3,0
39160,2596,16,2580,978,1553,3,3,0,4
39162,193,11,182,144,30,0,1,0,1
39166,442,1,441,103,327,0,0,0,1
39167,50,0,50,47,3,0,0,0,0
39168,5941,78,5863,2906,2815,6,10,2,8
39169,2443,18,2425,162,2221,8,0,0,0
39170,9303,116,9187,4918,4087,13,15,0,8
39173,17,0,17,16,1,0,0,0,0
39174,491,28,463,152,249,16,36,0,2
39175,4408,107,4301,1475,2729,15,3,4,7
39176,2099,33,2066,1041,964,10,5,0,1
39177,53,3,50,41,9,0,0,0,0
39179,1162,7,1155,353,783,0,1,0,0
39180,30383,673,29710,13417,15176,49,271,0,62
39183,13890,194,13696,7128,6052,18,88,0,36
39189,3566,68,3498,1578,1310,536,5,1,5
39191,8280,223,8057,5964,1866,14,32,6,16
39192,1508,10,1498,815,640,1,21,0,0
39193,510,6,504,232,271,0,0,0,0
39194,20063,1004,19059,5439,13128,45,89,5,28
39201,574,38,536,183,314,6,16,2,2
39202,7405,211,7194,3470,3396,21,122,1,13
39203,4395,87,4308,319,3854,3,20,5,8
39204,15433,286,15147,1118,13540,34,33,3,30
39206,22553,428,22125,2036,19599,10,73,1,57
39208,34228,1696,32532,20375,10506,50,340,86,120
39209,25227,566,24661,1653,22358,31,25,4,62
39210,456,42,414,293,78,8,32,0,0
39211,24900,687,24213,11277,12089,32,231,4,65
39212,29087,548,28539,2934,24970,46,49,3,75
39213,19507,119,19388,301,18669,31,20,3,31
39216,4061,100,3961,2443,1266,4,97,1,10
39217,1466,115,1351,379,947,0,0,2,21
39218,7231,592,6639,4771,1522,2,165,3,9
39232,9052,265,8787,6064,1947,14,535,0,40
39269,0,0,0,0,0,0,0,0,0
39272,14022,136,13886,3225,10275,11,95,2,26
39301,23537,505,23032,11849,10338,31,149,5,76
39305,19809,513,19296,11992,6449,27,292,14,61
39307,16231,380,15851,4270,11072,27,45,4,45
39309,163,31,132,89,23,1,11,0,0
39320,1594,33,1561,1265,262,2,6,0,3
39322,1718,15,1703,1055,607,0,3,0,0
39323,1236,61,1175,1061,80,0,5,1,2
39324,1,0,1,0,1,0,0,0,0
39325,6029,137,5892,4882,823,5,32,2,12
39326,555,12,543,198,331,3,2,0,0
39327,4237,64,4173,2889,1138,39,15,0,1
39328,4258,29,4229,1284,2841,19,3,1,8
39330,3020,46,2974,2409,467,2,1,3,6
39332,1631,32,1599,1131,424,3,1,0,3
39335,2960,80,2880,1695,1096,8,6,0,4
39336,1247,12,1235,608,575,10,9,0,6
39337,1781,38,1743,1654,60,0,3,0,0
39338,2960,13,2947,1396,1498,0,1,0,5
39339,14385,179,14206,6635,7104,152,35,1,13
39341,6607,103,6504,1603,4735,9,5,0,3
39342,1632,57,1575,607,897,0,27,2,5
39345,5898,66,5832,2150,3511,13,18,0,14
39346,2059,26,2033,1297,680,11,2,0,3
39347,1407,7,1400,609,761,1,0,0,2
39348,575,0,575,51,521,1,0,0,1
39350,24480,369,24111,12150,5903,5246,100,0,65
39352,693,1,692,226,457,1,2,0,0
39354,1676,20,1656,860,719,32,4,0,3
39355,6497,54,6443,4382,1889,11,5,2,11
39356,575,0,575,314,248,2,0,0,0
39358,1523,13,1510,447,1038,13,1,0,3
39359,231,10,221,177,40,1,0,0,0
39360,3606,30,3576,1292,2198,9,2,0,6
39361,1194,20,1174,329,797,2,0,0,0
39362,2569,22,2547,1323,1150,3,4,1,1
39363,1382,7,1375,855,489,1,0,0,2
39364,2854,48,2806,1507,1174,5,3,1,10
39365,7633,103,7530,6074,1214,53,40,0,5
39366,1316,9,1307,313,972,6,0,0,0
39367,14291,306,13985,7773,5928,19,29,2,11
39401,43183,1871,41312,17133,22188,102,528,24,161
39402,44633,2000,42633,27038,12829,66,1041,41,140
39406,2674,123,2551,1165,1195,5,71,1,100
39421,2700,20,2680,974,1628,1,12,0,6
39422,5071,83,4988,2486,2381,7,3,0,4
39423,2306,35,2271,1429,783,13,0,2,2
39425,1763,52,1711,1503,100,19,7,1,2
39426,17472,711,16761,15184,603,89,81,0,47
39427,1247,14,1233,769,424,4,4,0,1
39428,8726,219,8507,4512,3766,10,38,3,15
39429,16073,276,15797,9666,5648,22,51,0,27
39437,14158,599,13559,10515,2643,33,60,8,5
39439,4353,47,4306,1402,2586,211,2,0,5
39440,19759,2021,17738,5360,11666,45,133,4,86
39443,22938,1038,21900,18030,3236,41,58,9,37
39451,6657,75,6582,4260,2138,22,5,0,2
39452,28668,753,27915,24902,1904,102,83,5,52
39455,9257,210,9047,7462,1136,30,20,1,13
39456,1243,12,1231,809,355,14,3,0,1
39459,3604,272,3332,3001,202,4,7,0,12
39461,605,2,603,590,7,0,1,0,0
39462,1103,20,1083,730,308,2,3,1,0
39464,2267,53,2214,2121,36,4,2,0,2
39465,23002,951,22051,17975,2976,49,128,1,44
39466,27897,1337,26560,20163,4751,106,157,0,109
39470,12373,357,12016,10048,1403,71,50,0,19
39474,5363,51,5312,1748,3473,4,3,0,6
39475,12943,311,12632,10373,1685,31,70,9,32
39476,7489,93,7396,6469,678,17,10,0,15
39477,614,13,601,502,43,27,1,0,1
39478,1974,24,1950,1392,517,1,0,2,1
39479,5713,140,5573,5093,336,6,20,1,18
39480,2390,100,2290,1908,346,7,6,0,4
39481,1853,30,1823,1514,263,5,1,0,4
39482,11411,256,11155,9542,1170,15,44,2,32
39483,5489,85,5404,4226,1021,14,7,0,6
39501,22599,1344,21255,6933,12907,95,211,42,71
39503,53643,3459,50184,29823,15995,221,1101,84,223
39507,17724,1252,16472,11238,4063,60,238,17,29
39520,14963,654,14309,11262,1957,98,176,1,71
39525,9537,441,9096,8127,335,39,130,2,34
39529,0,0,0,0,0,0,0,0,0
39530,8392,1080,7312,3495,2740,23,658,5,23
39531,19965,1926,18039,11038,5167,65,538,33,85
39532,34348,2162,32186,24054,4283,118,1660,27,129
39534,1692,321,1371,846,280,4,137,16,10
39540,12707,994,11713,6940,2618,34,1326,17,42
39553,17032,1713,15319,8947,5267,99,228,17,50
39556,7403,232,7171,6689,134,36,37,0,17
39560,18611,932,17679,14357,1615,65,512,14,70
39561,2064,32,2032,1814,115,10,7,0,2
39562,16780,364,16416,14336,1303,58,67,8,28
39563,12300,462,11838,2700,8711,23,40,1,24
39564,42539,2766,39773,31147,4487,159,1523,25,141
39565,19972,883,19089,16462,937,125,364,21,68
39567,10280,938,9342,6288,2639,19,57,2,31
39571,14892,553,14339,10981,2269,77,240,12,56
39572,1200,30,1170,858,228,15,6,0,2
39573,9436,362,9074,8128,518,50,44,3,47
39574,14049,497,13552,11983,638,71,82,4,33
39576,6526,288,6238,4774,1067,27,56,4,23
39577,10310,164,10146,6988,2708,41,47,8,27
39581,11512,2277,9235,3886,4854,32,95,0,20
39595,92,28,64,31,13,0,6,1,0
39601,22819,250,22569,13618,8332,35,137,6,56
39629,6621,62,6559,5217,1137,17,10,0,7
39630,829,12,817,375,424,0,0,0,2
39631,2982,20,2962,1059,1817,4,3,0,8
39633,836,12,824,418,374,1,0,0,3
39635,180,5,175,100,65,0,0,0,1
39638,3195,43,3152,1409,1682,4,1,0,2
39641,4083,61,4022,3150,775,4,11,2,4
39643,1354,31,1323,945,327,1,6,0,10
39645,4869,53,4816,2836,1846,6,17,0,10
39647,1167,6,1161,947,188,0,1,0,1
39648,21831,378,21453,7289,13342,54,185,7,57
39652,7094,96,6998,2754,3983,28,15,0,21
39653,2683,19,2664,1990,625,3,3,0,2
39654,5527,115,5412,3510,1739,12,18,3,4
39656,811,2,809,390,393,0,1,0,3
39657,2302,26,2276,1285,923,7,3,0,9
39661,2718,28,2690,1231,1416,0,1,0,7
39662,1610,17,1593,1330,222,1,9,0,1
39663,2785,32,2753,1325,1356,0,6,0,8
39664,2479,19,2460,1976,401,4,14,0,0
39665,972,20,952,631,286,2,5,0,1
39666,10467,133,10334,6570,3403,32,47,0,24
39667,11693,182,11511,5994,5128,43,49,5,45
39668,616,12,604,268,317,0,0,0,2
39669,5582,43,5539,1520,3884,12,5,0,6
39701,12487,214,12273,3619,8296,15,66,3,23
39702,22661,341,22320,10516,11188,46,69,0,28
39705,13773,562,13211,8257,4033,23,340,13,39
39730,10579,105,10474,4870,5320,13,21,2,15
39735,3902,47,3855,2551,1183,7,0,0,1
39736,278,8,270,33,236,0,0,0,1
39737,248,5,243,199,41,1,0,0,0
39739,2521,49,2472,744,1654,2,10,0,1
39740,5801,126,5675,4884,519,21,31,0,11
39741,1393,3,1390,799,562,2,5,0,3
39743,1790,15,1775,345,1401,0,2,0,0
39744,5562,90,5472,4052,1228,14,9,1,12
39745,917,18,899,745,129,3,3,0,1
39746,2965,34,2931,2403,488,0,5,0,1
39747,1662,21,1641,906,679,4,0,0,1
39750,3031,52,2979,2048,865,1,5,0,2
39751,1294,18,1276,877,374,1,3,0,0
39752,2549,32,2517,2262,179,1,4,0,7
39753,7,1,6,4,2,0,0,0,0
39755,960,9,951,429,499,6,0,0,1
39756,1882,12,1870,321,1523,0,0,0,1
39759,43337,1058,42279,23438,16076,64,1435,8,107
39762,4963,160,4803,3679,893,25,66,1,122
39766,2897,65,2832,2084,620,5,7,0,8
39767,698,14,684,614,42,2,3,0,0
39769,1822,23,1799,1437,325,3,0,1,3
39771,116,3,113,108,4,0,0,0,0
39772,1610,28,1582,746,786,3,0,0,3
39773,14869,163,14706,5747,8557,26,49,1,33
39776,1574,37,1537,929,559,0,7,0,1
39813,1705,31,1674,513,1129,4,11,0,0
39815,1630,177,1453,440,974,4,0,2,2
39817,11378,570,10808,5013,5475,22,52,8,22
39819,12117,913,11204,5892,4824,21,116,3,37
39823,8813,154,8659,3732,4664,23,38,0,8
39824,322,4,318,206,108,0,0,0,0
39825,1530,49,1481,1134,302,6,8,2,3
39826,539,29,510,213,283,0,0,0,0
39827,4189,379,3810,3157,483,28,2,1,7
39828,15698,2576,13122,6813,5761,43,82,3,60
39832,49,0,49,44,3,0,1,0,1
39834,2246,174,2072,1550,453,9,4,0,1
39836,448,18,430,219,196,0,1,0,3
39837,5894,138,5756,3689,1905,11,27,0,4
39840,4693,108,4585,1419,3035,8,20,2,18
39841,740,24,716,288,406,4,0,0,1
39842,8099,135,7964,2595,5125,11,52,1,10
39845,8334,206,8128,5113,2714,4,63,1,22
39846,1885,60,1825,655,1137,0,5,0,0
39851,2129,31,2098,745,1293,1,6,0,7
39854,2274,22,2252,1263,905,10,12,0,5
39859,1234,35,1199,878,275,2,0,0,2
39861,959,9,950,692,219,3,5,0,2
39862,1117,18,1099,550,520,4,6,0,1
39866,1947,57,1890,624,1239,0,9,1,0
39867,396,19,377,154,204,3,0,0,4
39870,2014,121,1893,976,862,1,9,0,2
39877,475,9,466,315,129,0,7,0,1
39885,45,1,44,9,33,0,0,0,0
39886,1286,14,1272,656,591,2,0,0,2
39897,3585,157,3428,2522,756,7,14,1,12
40003,1894,47,1847,1757,25,3,1,0,3
40004,30890,916,29974,26333,1989,39,231,7,97
40006,4977,104,4873,4653,21,19,10,2,5
40007,180,8,172,170,0,0,0,0,1
40008,4085,100,3985,3735,105,6,14,1,7
40009,988,20,968,925,5,0,2,0,1
40010,584,14,570,534,15,0,3,0,2
40011,2518,75,2443,2304,28,8,6,0,6
40012,627,14,613,581,6,0,3,0,1
40013,5955,148,5807,5443,76,10,16,0,14
40014,22255,917,21338,19522,469,40,300,6,68
40019,3921,244,3677,3225,215,13,11,0,14
40020,133,2,131,127,0,0,0,0,0
40022,946,36,910,828,24,0,4,0,9
40023,5956,157,5799,5273,217,9,90,2,18
40025,491,6,485,428,2,0,26,0,2
40026,6177,220,5957,5450,64,7,116,4,24
40031,25322,1656,23666,20877,1329,56,200,3,83
40033,12726,606,12120,10242,1180,1,104,46,38
40036,251,6,245,220,2,0,1,0,2
40037,2888,38,2850,2766,12,0,6,0,3
40040,541,5,536,524,1,1,0,0,3
40041,545,8,537,497,23,0,4,0,1
40045,3007,65,2942,2829,2,7,12,1,1
40046,1892,31,1861,1770,19,2,4,0,4
40047,23597,498,23099,21790,223,42,113,9,46
40049,104,0,104,103,0,0,0,0,0
40050,1558,29,1529,1421,40,6,3,0,0
40051,4366,64,4302,4143,14,9,5,1,8
40052,620,13,607,587,0,0,1,0,0
40055,2070,44,2026,1943,15,3,10,1,7
40056,3522,117,3405,3072,124,5,41,3,8
40057,3489,102,3387,3257,20,4,3,0,6
40058,34,2,32,28,1,0,0,0,0
40059,20254,688,19566,16845,748,10,1162,7,86
40060,1091,9,1082,1054,2,0,2,0,5
40061,143,2,141,131,6,0,3,0,1
40062,305,1,304,299,1,0,1,0,0
40063,0,0,0,0,0,0,0,0,0
40065,32729,4624,28105,23893,2276,59,255,22,126
40067,5461,375,5086,4563,209,9,61,0,34
40068,2752,77,2675,2514,42,8,14,0,4
40069,8397,417,7980,6963,620,16,32,5,36
40070,553,27,526,496,4,1,3,0,0
40071,16106,365,15741,14681,224,21,79,9,23
40075,1294,15,1279,1217,8,1,0,0,8
40076,2701,55,2646,2494,18,4,7,0,10
40077,599,15,584,554,10,0,0,0,4
40078,2356,39,2317,2229,20,6,2,0,8
40104,1183,29,1154,1066,8,9,0,0,8
40107,2144,20,2124,2038,6,6,3,0,3
40108,12601,327,12274,11341,209,25,87,7,49
40109,2465,66,2399,2244,39,6,19,2,6
40110,280,12,268,262,2,0,1,0,0
40111,1628,26,1602,1499,19,2,0,1,2
40115,585,15,570,520,4,2,0,0,15
40117,2688,94,2594,2307,98,11,13,6,6
40118,10017,1666,8351,7261,515,19,97,2,38
40119,2100,27,2073,1959,12,11,9,0,5
40121,7749,1386,6363,4007,1354,50,257,120,35
40140,908,19,889,841,5,1,1,0,3
40142,2417,77,2340,2141,57,12,10,0,15
40143,5710,66,5644,5196,170,10,16,0,11
40144,1807,10,1797,1736,19,0,5,0,2
40145,977,24,953,916,0,2,0,0,0
40146,3779,67,3712,3309,168,14,8,2,16
40150,4268,71,4197,3928,24,13,16,0,10
40152,822,6,816,777,4,4,5,0,1
40155,1040,46,994,869,49,10,5,0,0
40157,951,7,944,891,2,8,2,0,8
40160,23582,2027,21555,13249,5337,107,546,182,205
40161,175,6,169,158,1,4,2,0,0
40162,6337,302,6035,5276,335,10,52,6,38
40165,36161,838,35323,32833,520,90,226,11,72
40170,399,11,388,348,5,0,0,0,0
40171,300,2,298,284,0,1,0,0,2
40175,15338,724,14614,11704,1395,65,292,43,113
40176,1211,20,1191,1138,5,7,0,0,2
40177,1680,53,1627,1491,21,2,4,2,13
40178,455,5,450,440,2,1,0,0,1
40202,7179,332,6847,3115,3083,24,371,1,41
40203,16801,518,16283,6105,9160,62,144,10,101
40204,14600,553,14047,11768,1141,50,299,10,87
40205,24077,769,23308,21172,694,26,370,6,150
40206,20196,960,19236,15861,1876,34,552,10,95
40207,30104,1137,28967,25953,1281,21,646,14,76
40208,17048,1033,16015,9743,4695,55,453,13,100
40209,426,66,360,243,56,2,10,0,5
40210,14418,408,14010,1337,11943,33,36,6,65
40211,21310,407,20903,1228,18704,55,26,8,146
40212,16360,299,16061,5261,9913,39,27,3,109
40213,16698,2920,13778,10141,2584,39,169,24,87
40214,46220,6163,40057,24913,9501,91,3191,88,235
40215,21230,2017,19213,9708,7551,72,595,18,108
40216,43434,3147,40287,19252,18097,98,765,10,202
40217,13061,427,12634,10516,1044,24,444,1,35
40218,33437,4216,29221,12896,11989,66,2595,21,189
40219,40300,9239,31061,18882,9238,72,950,30,216
40220,34315,2268,32047,23203,5254,52,1993,33,157
40221,2,0,2,0,1,0,0,0,0
40222,21725,1188,20537,16649,1584,37,1320,6,117
40223,23227,1189,22038,17458,1934,32,1518,8,157
40228,18655,1452,17203,11562,3708,32,966,7,58
40229,39380,3042,36338,29444,3990,69,690,20,157
40231,0,0,0,0,0,0,0,0,0
40241,31016,1466,29550,22467,3340,31,2242,19,128
40242,10686,548,10138,8272,1157,20,225,0,38
40243,11521,543,10978,9215,815,15,400,2,56
40245,37866,1620,36246,28252,3554,39,2690,11,138
40258,26807,1522,25285,18620,5032,62,217,10,113
40272,37747,2322,35425,29211,3574,82,281,118,129
40280,177,8,169,134,7,0,19,0,6
40291,39719,3019,36700,28461,5269,51,860,19,187
40299,43030,2714,40316,32595,4364,50,1100,24,151
40310,575,5,570,523,19,1,0,4,0
40311,7159,172,6987,6744,41,9,8,2,13
40312,6010,87,5923,5721,37,6,10,0,3
40313,2873,46,2827,2682,44,2,5,0,3
40316,328,7,321,310,1,0,0,1,0
40322,3148,28,3120,3029,17,6,2,1,1
40324,51035,3124,47911,42053,2768,47,562,20,166
40328,1303,13,1290,1240,6,2,5,0,2
40330,20440,678,19762,18047,723,33,69,8,82
40334,82,0,82,82,0,0,0,0,0
40336,12566,110,12456,12086,29,24,7,0,8
40337,5604,67,5537,5356,13,1,13,0,10
40339,99,5,94,45,43,0,0,0,0
40342,23232,518,22714,21091,478,50,102,4,68
40346,845,9,836,815,4,1,0,0,0
40347,3114,174,2940,2653,165,6,17,1,7
40348,582,12,570,546,13,0,1,0,1
40350,265,4,261,253,2,0,0,0,2
40351,22305,497,21808,20602,328,31,151,5,102
40353,22358,844,21514,19887,598,24,132,1,53
40355,276,20,256,237,12,0,0,0,0
40356,44381,2055,42326,37766,1982,77,442,26,140
40357,116,15,101,95,0,0,0,0,1
40358,819,12,807,789,2,0,0,0,2
40359,7158,112,7046,6728,46,11,11,2,13
40360,7644,127,7517,7265,68,4,8,1,10
40361,18214,1352,16862,14957,1011,28,72,7,63
40363,38,0,38,36,0,0,0,0,0
40370,2867,67,2800,2642,16,5,7,0,4
40371,2779,21,2758,2665,2,1,5,0,1
40372,2344,27,2317,2192,10,7,7,1,2
40374,1979,48,1931,1819,56,0,3,0,4
40376,107,3,104,102,0,0,0,0,0
40379,3784,95,3689,3417,56,4,15,1,15
40380,7067,107,6960,6735,27,11,20,0,22
40383,24592,1873,22719,20381,1083,24,161,7,67
40385,3172,48,3124,3030,22,5,4,0,3
40387,1969,17,1952,1893,10,5,0,0,0
40390,7469,286,7183,6488,195,19,199,1,31
40391,36461,1462,34999,31782,1634,63,212,14,77
40402,3000,19,2981,2884,2,10,2,1,4
40403,26994,730,26264,24231,596,46,199,15,79
40404,765,110,655,376,165,1,35,2,1
40409,3644,16,3628,3488,9,4,3,0,1
40419,4669,91,4578,4414,16,13,6,0,16
40422,25918,1367,24551,20817,2093,33,346,3,86
40434,36,4,32,31,0,0,0,0,0
40437,4413,68,4345,4191,16,2,10,0,4
40440,2237,83,2154,2047,23,2,9,0,2
40442,1187,12,1175,1109,3,8,1,0,4
40444,14075,384,13691,12752,286,27,47,8,27
40445,820,11,809,784,0,0,0,0,3
40447,7410,56,7354,7160,3,20,12,2,4
40448,40,0,40,40,0,0,0,0,0
40456,8949,101,8848,8551,36,28,23,0,11
40460,908,9,899,872,0,1,1,0,1
40461,2629,59,2570,2446,12,4,7,0,9
40464,1063,18,1045,979,6,0,1,0,1
40468,1840,36,1804,1648,39,4,5,1,9
40472,1597,22,1575,1536,1,1,0,0,0
40475,62531,2192,60339,52682,3097,136,766,39,177
40481,363,1,362,357,0,0,1,0,0
40484,12034,295,11739,10855,414,12,41,2,27
40486,2263,15,2248,2191,7,5,4,1,4
40489,3951,46,3905,3788,14,3,2,0,3
40502,26080,989,25091,22208,1123,27,692,3,86
40503,28073,1628,26445,22588,1024,26,1574,9,137
40504,26042,5607,20435,14989,3580,34,631,22,89
40505,26278,3361,22917,15590,5616,69,213,15,153
40507,2043,86,1957,1476,313,5,50,3,18
40508,25586,2064,23522,14919,6444,52,832,9,278
40509,44572,2936,41636,29846,6363,28,3019,6,201
40510,1562,158,1404,1065,279,2,21,1,4
40511,36146,6134,30012,17407,10023,52,863,21,176
40513,11244,349,10895,8377,264,16,1800,5,36
40514,16427,721,15706,13043,713,14,1188,2,33
40515,36244,1759,34485,28214,2942,58,1330,21,149
40516,2795,336,2459,1920,392,3,20,0,6
40517,37751,3352,34399,22600,8225,99,1066,15,192
40526,2600,159,2441,1992,253,0,75,1,113
40536,0,0,0,0,0,0,0,0,0
40601,52133,2073,50060,41815,4475,93,1029,15,221
40701,31051,544,30507,29098,124,82,205,0,47
40729,5815,66,5749,5517,63,13,8,0,4
40734,3877,47,3830,3631,4,11,6,0,6
40737,1448,17,1431,1374,4,8,0,0,0
40740,3094,28,3066,2931,19,14,10,0,12
40741,23327,409,22918,21597,182,43,171,2,38
40744,20246,335,19911,19013,125,36,154,2,23
40759,2564,36,2528,2458,8,3,12,0,0
40763,411,0,411,400,0,2,1,0,1
40769,18481,372,18109,16911,467,42,106,10,32
40771,1011,6,1005,968,1,1,6,0,2
40801,64,1,63,58,5,0,0,0,0
40803,89,0,89,86,0,0,0,0,0
40806,2215,19,2196,2079,34,3,5,0,2
40807,477,10,467,445,10,0,0,0,1
40808,113,3,110,103,0,0,1,0,0
40810,1271,7,1264,1216,3,0,0,0,0
40813,507,3,504,484,1,0,1,0,1
40815,1177,13,1164,1133,6,0,1,0,0
40816,7,0,7,7,0,0,0,0,0
40818,90,0,90,80,1,1,0,0,0
40819,762,5,757,724,0,0,0,0,0
40820,493,2,491,484,0,0,0,0,0
40823,3529,36,3493,3216,111,6,12,0,8
40824,480,5,475,462,1,1,0,0,0
40826,636,3,633,620,0,0,0,0,1
40827,657,2,655,638,3,0,0,0,0
40828,4304,32,4272,4080,60,10,4,0,11
40829,177,4,173,163,4,0,3,0,0
40830,176,0,176,158,2,0,1,0,0
40831,5181,71,5110,4694,179,12,44,0,15
40840,443,1,442,430,1,0,1,0,1
40843,181,2,179,164,2,3,1,0,0
40844,215,1,214,208,0,0,0,0,0
40845,396,4,392,371,3,0,0,0,1
40847,143,3,140,124,4,0,0,0,1
40849,103,1,102,100,0,0,0,0,0
40854,1171,15,1156,1094,13,6,5,0,4
40855,777,13,764,636,95,1,1,0,3
40856,524,2,522,506,0,0,0,0,0
40858,214,0,214,213,0,0,0,0,0
40862,530,6,524,492,1,1,2,0,2
40863,444,0,444,435,0,2,0,0,0
40865,380,5,375,352,0,1,1,0,2
40868,1019,1,1018,1003,1,0,1,0,0
40870,486,6,480,463,1,1,3,0,1
40873,2242,10,2232,2152,6,6,1,0,0
40874,322,3,319,307,0,1,1,0,0
40902,727,3,724,690,2,3,0,0,0
40903,721,10,711,676,6,2,1,0,1
40906,11187,124,11063,10457,227,46,25,1,8
40913,258,32,226,196,23,0,1,0,1
40914,577,2,575,564,1,0,0,0,0
40915,714,3,711,692,7,0,0,0,3
40921,274,5,269,264,0,0,0,0,0
40923,931,6,925,901,1,1,0,0,1
40927,470,1,469,459,1,1,2,0,0
40935,2032,13,2019,1966,12,1,0,0,2
40939,176,4,172,156,0,0,0,0,1
40940,518,14,504,484,3,1,0,0,2
40941,159,1,158,156,0,0,0,0,0
40943,640,8,632,603,2,6,1,0,0
40946,64,0,64,57,0,1,0,0,0
40949,483,9,474,453,0,2,8,0,1
40953,685,1,684,664,0,1,1,0,0
40958,431,0,431,419,3,2,0,0,0
40962,17714,286,17428,16243,771,24,18,5,17
40964,78,2,76,69,2,0,1,0,0
40965,12477,179,12298,11267,401,17,111,2,35
40972,1402,29,1373,1312,20,1,2,6,3
40977,8196,40,8156,7776,140,9,10,2,18
40979,98,1,97,94,1,1,0,0,1
40981,12,2,10,10,0,0,0,0,0
40982,264,0,264,262,0,0,0,0,0
40983,204,2,202,201,0,0,0,1,0
40988,470,2,468,457,1,0,0,0,0
40995,120,0,120,113,0,2,0,0,0
40997,300,3,297,283,1,2,0,0,0
41001,19294,207,19087,18055,126,25,142,1,75
41002,2338,36,2302,2187,28,4,6,0,0
41003,2671,50,2621,2479,8,8,2,0,9
41004,4070,33,4037,3890,15,6,5,0,2
41005,24192,927,23265,20903,827,38,276,63,64
41006,4384,38,4346,4151,9,4,7,1,15
41007,4036,29,4007,3854,5,0,11,0,7
41008,7602,713,6889,6436,131,20,26,3,1
41010,3158,38,3120,2961,11,6,6,1,10
41011,26470,2170,24300,19313,3230,51,254,21,136
41014,7048,580,6468,5034,912,17,26,2,27
41015,21599,560,21039,18729,845,39,165,29,78
41016,5684,135,5549,5087,121,10,27,2,8
41017,40333,1324,39009,35342,1020,49,868,48,112
41018,29305,1953,27352,23597,1364,48,347,201,105
41030,6445,219,6226,5824,49,14,22,9,32
41031,16341,349,15992,15006,307,20,44,1,39
41033,2113,33,2080,2021,0,0,6,0,5
41034,1101,13,1088,1026,11,1,10,0,1
41035,11087,364,10723,10162,68,24,24,21,13
41039,2936,18,2918,2803,27,6,2,0,4
41040,7403,114,7289,6982,37,17,21,1,18
41041,7414,141,7273,6949,107,5,7,3,34
41042,54183,4745,49438,41611,3586,86,1316,119,180
41043,1766,15,1751,1675,2,1,2,1,4
41044,1021,9,1012,973,5,3,4,0,1
41045,1323,29,1294,1214,22,0,15,0,1
41046,1739,65,1674,1596,6,4,0,0,1
41048,16523,682,15841,14095,481,18,302,30,76
41049,2397,26,2371,2321,2,6,7,0,4
41051,31582,912,30670,28361,560,19,289,13,77
41052,322,12,310,298,0,0,0,0,1
41055,1757,33,1724,1628,49,0,6,0,1
41056,14004,313,13691,11881,955,28,86,0,40
41059,2692,46,2646,2512,16,5,8,1,11
41063,2934,37,2897,2770,10,0,5,0,0
41064,1978,18,1960,1893,6,3,6,0,0
41071,19796,958,18838,15814,1642,12,215,11,76
41073,5548,155,5393,5036,92,9,30,2,19
41074,5703,218,5485,5050,100,25,29,1,21
41075,17517,376,17141,15930,236,12,296,3,49
41076,17440,310,17130,15501,573,29,290,11,106
41080,1805,25,1780,1683,7,3,6,0,8
41083,1301,49,1252,1183,12,0,5,0,5
41085,857,9,848,809,6,0,1,0,5
41086,2225,99,2126,2043,4,2,2,0,3
41091,24820,836,23984,21455,531,30,1002,12,70
41092,3771,111,3660,3470,8,4,24,1,15
41093,2773,42,2731,2647,12,6,6,0,0
41094,14480,494,13986,12980,166,15,155,8,56
41095,3602,294,3308,3068,55,3,10,6,3
41097,7259,156,7103,6700,63,11,17,3,16
41098,1917,70,1847,1739,28,2,4,1,5
41101,18559,390,18169,16500,540,46,171,3,56
41102,21101,274,20827,19297,703,35,120,3,41
41121,1631,16,1615,1564,6,3,2,0,1
41124,976,7,969,925,3,0,1,0,1
41129,9331,69,9262,8916,56,7,32,0,21
41132,414,10,404,397,0,0,0,0,3
41135,223,0,223,219,0,0,0,1,0
41139,8371,78,8293,7813,59,13,48,0,31
41141,2216,22,2194,2114,12,3,0,1,1
41142,34,0,34,33,0,0,0,0,0
41143,14153,170,13983,13339,188,31,52,1,16
41144,9861,88,9773,9364,94,27,23,0,28
41146,392,2,390,380,2,0,0,0,0
41149,519,6,513,503,0,0,0,0,0
41159,530,3,527,522,2,0,0,0,2
41164,12231,82,12149,11869,15,18,5,0,11
41166,752,6,746,726,3,3,0,0,1
41168,2993,15,2978,2852,24,3,6,0,6
41169,5589,45,5544,5244,33,12,76,0,9
41171,4708,67,4641,4311,245,8,9,0,12
41174,1039,11,1028,975,5,1,1,1,5
41175,5378,33,5345,5124,7,11,19,4,7
41179,7364,42,7322,7094,15,11,7,2,2
41180,1118,11,1107,1068,1,0,1,1,1
41181,34,0,34,34,0,0,0,0,0
41183,1508,10,1498,1443,8,0,10,0,2
41189,2194,17,2177,2124,2,0,1,0,0
41201,276,3,273,265,0,0,0,0,0
41203,473,1,472,466,0,0,0,0,0
41204,493,1,492,474,0,2,1,0,0
41214,536,3,533,525,0,1,0,0,0
41216,1390,7,1383,1344,1,4,2,0,0
41219,2081,18,2063,2028,4,1,0,0,3
41222,2594,10,2584,2528,6,3,4,0,1
41224,5655,275,5380,4490,776,33,15,0,0
41226,245,2,243,241,0,0,0,0,0
41230,12670,122,12548,12231,29,2,22,3,19
41231,1050,1,1049,1030,0,3,1,0,0
41232,539,0,539,529,0,0,0,0,1
41234,510,2,508,499,0,2,0,0,0
41238,1133,16,1117,1088,2,1,0,0,0
41240,6279,82,6197,5971,22,9,63,3,7
41250,748,0,748,738,0,0,0,0,0
41254,562,2,560,546,1,0,2,0,0
41255,1025,7,1018,1001,0,3,0,0,0
41256,2084,17,2067,2010,2,1,14,0,0
41257,609,9,600,589,1,1,0,0,0
41260,768,10,758,739,3,2,2,0,1
41262,1291,7,1284,1260,3,2,0,0,1
41263,513,3,510,500,0,0,1,0,0
41264,536,2,534,528,0,0,0,0,0
41265,1665,10,1655,1603,1,6,6,1,2
41267,1017,0,1017,989,0,2,0,1,0
41268,599,3,596,574,2,4,6,0,0
41271,277,4,273,262,0,1,0,0,0
41274,593,1,592,573,0,1,3,0,1
41301,5756,51,5705,5583,24,8,5,1,15
41310,17,0,17,16,0,0,0,0,0
41311,6759,54,6705,6271,274,1,0,0,17
41314,4260,43,4217,4109,12,0,1,5,4
41317,437,8,429,388,0,0,0,1,0
41332,1106,8,1098,1085,3,2,0,0,2
41339,10368,68,10300,9941,55,10,37,6,0
41348,1352,12,1340,1185,3,1,0,0,0
41351,19,0,19,19,0,0,0,0,0
41352,565,3,562,550,3,1,0,0,0
41360,336,4,332,324,5,0,0,0,0
41364,148,0,148,143,0,0,0,1,0
41365,487,5,482,465,0,0,0,0,0
41366,73,0,73,73,0,0,0,0,0
41367,351,3,348,337,0,0,0,0,0
41385,430,2,428,420,0,0,0,0,0
41386,32,0,32,32,0,0,0,0,0
41390,152,0,152,148,0,0,0,0,0
41397,169,1,168,164,0,0,0,0,0
41408,315,3,312,311,1,0,0,0,0
41421,321,2,319,306,0,0,0,0,0
41425,1202,8,1194,1169,2,1,1,1,0
41464,451,1,450,437,1,0,0,0,1
41465,10732,63,10669,10446,13,14,5,6,12
41472,10786,399,10387,9646,484,17,16,3,10
41501,22636,434,22202,20854,372,32,288,7,44
41503,552,5,547,497,12,2,22,0,3
41512,789,4,785,773,6,0,0,0,2
41513,426,1,425,418,0,0,0,0,1
41514,3380,28,3352,3195,27,9,13,0,10
41517,68,0,68,61,1,0,0,0,1
41519,986,1,985,951,0,1,1,0,1
41522,4886,22,4864,4744,12,6,2,0,9
41524,291,3,288,284,3,0,0,0,0
41526,24,1,23,23,0,0,0,0,0
41527,557,9,548,520,0,1,11,0,7
41528,566,3,563,550,3,0,1,0,0
41531,942,5,937,891,13,0,1,0,0
41534,229,3,226,220,2,0,0,0,0
41535,468,0,468,450,6,0,0,0,0
41537,4739,42,4697,4576,13,5,8,0,1
41538,219,0,219,212,0,0,0,0,0
41539,1583,24,1559,1538,0,1,0,1,1
41540,360,2,358,356,0,0,0,0,0
41543,521,1,520,498,0,0,2,0,0
41544,735,9,726,694,3,0,4,0,2
41547,345,2,343,337,0,0,0,0,0
41548,714,9,705,677,4,0,1,2,0
41553,2206,16,2190,2141,4,7,4,0,3
41554,820,13,807,801,1,0,0,0,0
41555,672,12,660,631,3,4,0,0,0
41557,1717,20,1697,1652,0,2,2,0,1
41558,720,3,717,702,1,0,2,0,2
41559,275,3,272,270,0,0,0,0,0
41560,375,0,375,368,3,0,1,0,0
41562,2162,14,2148,2110,0,1,3,0,1
41563,381,4,377,366,1,0,0,0,0
41564,813,3,810,797,0,0,2,1,0
41566,438,4,434,416,1,1,2,0,0
41567,278,0,278,269,4,0,0,0,0
41568,752,6,746,736,1,0,0,0,3
41571,460,5,455,451,0,0,0,0,1
41572,3383,22,3361,3276,1,2,5,0,1
41601,834,11,823,811,6,0,1,0,0
41602,838,6,832,818,1,0,5,0,0
41603,1491,10,1481,1454,5,0,2,0,2
41604,554,1,553,538,1,1,0,0,0
41605,685,3,682,664,3,0,1,0,0
41606,473,0,473,456,1,1,0,0,3
41607,269,0,269,269,0,0,0,0,0
41612,137,6,131,127,0,0,0,0,1
41615,753,2,751,743,3,0,1,0,1
41616,565,1,564,552,0,0,0,1,0
41619,470,1,469,461,1,1,3,0,1
41621,298,3,295,279,2,0,3,0,0
41622,256,0,256,255,0,0,0,0,0
41630,1015,3,1012,992,0,0,0,0,0
41631,891,16,875,857,0,0,1,0,1
41632,400,2,398,398,0,0,0,0,0
41635,2863,38,2825,2772,7,4,8,0,4
41636,757,3,754,731,7,0,0,0,0
41640,1183,18,1165,1128,0,0,0,0,1
41642,646,1,645,625,1,0,0,0,0
41643,92,0,92,91,0,0,0,0,0
41645,1162,3,1159,1123,7,0,0,0,0
41647,1133,7,1126,1079,5,0,5,0,0
41649,2259,21,2238,2184,3,3,2,0,7
41650,620,4,616,601,1,0,1,0,0
41651,336,0,336,330,0,0,0,0,0
41653,10937,122,10815,10507,31,11,53,0,6
41655,860,6,854,826,3,0,2,0,1
41659,598,9,589,567,5,0,2,0,2
41660,722,3,719,695,4,2,1,0,0
41663,277,3,274,266,3,0,0,0,0
41666,877,3,874,838,2,3,0,0,2
41667,377,1,376,359,0,0,0,0,0
41669,616,2,614,578,18,0,2,0,2
41701,16761,167,16594,15507,321,26,217,0,19
41712,223,1,222,216,1,1,2,0,0
41713,36,0,36,36,0,0,0,0,0
41714,375,1,374,368,4,0,0,0,0
41719,1173,8,1165,1079,22,1,13,0,0
41721,668,10,658,638,1,2,0,2,3
41722,1380,4,1376,1320,18,3,9,0,1
41723,1314,8,1306,1281,3,7,0,0,1
41725,297,0,297,277,0,0,0,0,0
41727,983,3,980,967,4,1,0,0,0
41729,208,1,207,194,0,0,1,0,2
41731,1070,4,1066,1029,1,1,2,0,0
41735,247,1,246,239,0,0,1,0,0
41739,167,1,166,165,1,0,0,0,0
41740,892,2,890,862,0,0,0,0,4
41745,302,0,302,298,0,0,0,0,0
41746,609,0,609,588,4,1,2,0,0
41749,3176,29,3147,3051,22,7,8,0,1
41751,306,0,306,292,1,1,1,0,0
41754,462,1,461,453,1,0,2,0,1
41759,573,9,564,533,9,2,2,0,0
41760,242,0,242,239,0,0,1,0,0
41762,146,2,144,138,0,0,0,0,1
41763,540,0,540,532,0,0,1,0,0
41764,586,9,577,572,0,0,0,0,0
41766,282,0,282,263,0,3,0,0,0
41772,243,3,240,238,0,0,0,0,0
41773,1299,7,1292,1246,9,0,6,0,0
41774,2778,13,2765,2665,2,9,0,0,2
41775,121,1,120,118,0,0,0,0,0
41776,1378,6,1372,1344,2,0,0,0,0
41777,881,12,869,847,3,4,3,0,0
41778,171,3,168,159,0,1,0,0,0
41804,749,0,749,729,0,4,0,0,1
41810,359,3,356,344,1,0,1,0,0
41812,257,0,257,242,1,0,0,0,0
41815,717,1,716,707,0,0,2,0,0
41817,626,3,623,614,0,0,2,0,0
41819,320,1,319,309,0,2,0,0,0
41821,486,0,486,475,0,1,1,0,0
41822,1679,24,1655,1617,4,2,1,0,1
41824,583,0,583,558,5,0,2,0,2
41825,460,0,460,453,1,0,0,0,0
41826,848,3,845,828,2,0,0,0,2
41828,637,1,636,632,0,0,1,0,0
41831,1087,12,1075,1052,2,0,0,0,0
41832,491,1,490,480,0,0,1,0,0
41833,374,1,373,361,0,2,1,0,0
41834,413,4,409,399,0,0,0,0,0
41835,756,6,750,711,10,0,1,0,1
41836,836,6,830,818,3,0,3,0,0
41837,803,4,799,780,1,0,0,0,1
41838,546,2,544,533,1,0,0,0,2
41839,658,2,656,638,0,0,0,0,0
41840,1043,1,1042,988,15,0,1,0,4
41843,641,2,639,633,1,0,0,0,0
41844,1183,5,1178,1151,2,1,5,0,2
41845,338,2,336,326,0,1,0,0,2
41847,478,0,478,442,31,0,0,0,0
41848,56,0,56,54,0,0,0,0,1
41849,189,0,189,181,2,0,0,0,0
41855,615,3,612,597,2,0,0,0,0
41858,7150,57,7093,6896,32,14,39,0,6
41859,276,0,276,274,0,0,0,0,0
41861,213,0,213,204,0,0,0,0,0
41862,786,2,784,775,1,0,1,0,0
42001,31579,926,30653,24470,4108,81,389,7,121
42003,28592,1050,27542,22406,3239,67,232,10,89
42020,2256,49,2207,2094,24,3,3,0,4
42021,1328,26,1302,1215,34,4,4,0,0
42022,97,1,96,87,2,0,0,0,0
42023,2397,82,2315,2189,25,5,4,0,0
42024,1453,15,1438,1327,53,0,5,0,1
42025,19604,340,19264,18385,71,36,98,6,22
42027,2202,47,2155,2024,23,11,5,0,0
42028,559,10,549,516,2,1,0,0,1
42029,6105,109,5996,5696,13,15,14,1,18
42031,3057,80,2977,2529,311,6,9,0,1
42032,191,3,188,153,22,0,0,0,0
42035,956,25,931,880,1,22,3,0,3
42036,1257,21,1236,1170,9,1,6,0,0
42037,46,1,45,38,0,0,0,0,0
42038,5691,109,5582,4964,463,20,19,0,15
42039,1695,21,1674,1590,27,3,2,0,0
42040,1028,21,1007,954,6,2,4,0,0
42041,4267,102,4165,3217,674,11,16,5,25
42044,3394,60,3334,3180,6,8,17,1,5
42045,2150,44,2106,2009,7,7,3,0,5
42047,178,1,177,169,0,0,0,1,0
42048,2177,34,2143,2054,13,3,0,0,1
42049,1491,44,1447,1327,33,2,10,0,2
42050,3229,86,3143,2238,776,7,1,6,3
42051,2894,151,2743,2586,56,7,7,0,12
42053,4837,74,4763,4435,93,7,24,1,4
42054,1027,23,1004,962,3,2,3,0,2
42055,2657,41,2616,2459,43,4,14,0,4
42056,1704,12,1692,1504,87,0,11,0,1
42058,2230,53,2177,2044,6,8,4,0,5
42060,88,0,88,78,1,0,1,0,0
42061,49,1,48,47,0,0,1,0,0
42064,8116,102,8014,7704,79,14,5,5,18
42066,23081,2336,20745,18187,1380,45,125,3,53
42069,942,37,905,860,3,10,9,0,0
42071,29703,1179,28524,25431,1212,37,407,11,101
42076,1100,28,1072,1013,7,6,2,0,0
42078,1760,32,1728,1642,4,2,3,4,1
42079,1378,60,1318,1259,10,5,0,0,1
42081,1973,41,1932,1815,6,2,2,1,2
42082,1852,23,1829,1726,12,3,7,1,2
42083,320,9,311,294,0,0,0,0,0
42085,826,25,801,747,13,1,4,0,1
42086,4045,81,3964,3631,114,11,17,0,11
42087,2241,42,2199,2064,30,5,9,0,1
42088,2745,65,2680,2485,73,6,13,0,3
42101,64444,6361,58083,42546,8765,123,3068,253,275
42103,22106,1012,21094,17819,1156,24,1181,90,94
42104,37309,1767,35542,27911,2545,59,2977,301,216
42120,2523,78,2445,2333,6,4,5,0,5
42122,5092,143,4949,4598,74,13,32,13,18
42123,814,29,785,757,0,0,0,0,4
42124,136,1,135,135,0,0,0,0,0
42127,6394,221,6173,5616,232,9,36,1,25
42129,7063,178,6885,6606,50,1,4,0,21
42130,147,8,139,131,3,0,0,0,0
42131,144,5,139,136,1,0,0,0,0
42133,1536,64,1472,1422,6,2,1,0,3
42134,18881,640,18241,15580,1581,53,92,6,62
42140,1280,84,1196,1158,8,0,1,0,0
42141,32207,1467,30740,27787,1402,56,216,49,123
42151,575,10,565,561,2,0,0,0,2
42153,63,0,63,62,0,0,0,0,1
42154,654,7,647,597,24,0,5,0,3
42156,380,6,374,361,1,0,0,2,1
42157,495,6,489,483,0,0,0,0,2
42159,1236,28,1208,1064,68,2,6,0,6
42160,2101,74,2027,1840,64,7,6,3,8
42163,39,0,39,39,0,0,0,0,0
42164,17133,454,16679,15822,187,34,42,6,33
42166,2337,61,2276,2180,28,4,0,0,4
42167,8057,332,7725,7315,204,7,8,0,19
42170,1626,59,1567,1399,61,6,8,1,13
42171,7552,161,7391,6990,168,8,27,0,14
42202,2273,138,2135,1837,182,8,4,0,5
42204,704,38,666,555,78,0,3,2,1
42206,6000,100,5900,5505,150,8,9,0,16
42207,1137,6,1131,1106,0,0,0,0,0
42210,4213,47,4166,3975,20,17,13,1,4
42211,13224,304,12920,11527,832,29,27,6,30
42214,769,12,757,719,8,1,0,0,5
42215,1404,26,1378,1211,112,5,2,0,1
42217,3768,72,3696,3424,124,12,4,0,8
42220,6697,296,6401,5776,355,9,4,3,23
42223,20135,3897,16238,11342,2693,108,504,217,77
42232,726,21,705,628,52,4,3,0,0
42234,2312,172,2140,1581,392,6,11,0,14
42236,963,40,923,841,34,0,0,0,3
42240,41791,1819,39972,26713,10653,125,451,30,143
42252,74,2,72,72,0,0,0,0,0
42254,298,10,288,250,21,0,0,0,4
42256,4938,94,4844,4671,17,4,6,2,2
42259,1046,8,1038,958,46,0,7,3,1
42261,10146,559,9587,9229,13,16,15,3,19
42262,8814,1105,7709,4521,2218,58,129,25,70
42265,830,28,802,748,37,0,1,0,2
42266,2596,86,2510,2147,272,8,4,2,5
42273,406,2,404,397,0,0,3,0,0
42274,2335,52,2283,2131,27,10,12,5,12
42275,965,11,954,931,1,0,1,0,4
42276,14897,518,14379,12332,1314,24,77,1,66
42280,541,22,519,506,1,0,2,0,0
42285,373,9,364,348,1,2,0,0,0
42286,1414,68,1346,1250,60,0,2,0,2
42301,44883,1981,42902,36536,3189,54,1056,45,142
42303,41877,1839,40038,35185,1535,55,1306,12,144
42320,8442,608,7834,7491,67,8,13,0,17
42321,578,7,571,556,4,2,0,0,2
42322,83,2,81,78,2,0,0,0,0
42323,866,21,845,806,10,1,0,0,0
42324,1122,13,1109,1073,7,2,0,0,2
42325,1784,27,1757,1718,4,2,3,0,1
42326,424,3,421,418,0,1,0,0,0
42327,3929,60,3869,3753,7,4,11,0,15
42328,1245,32,1213,1163,5,3,1,0,3
42330,9501,288,9213,8354,581,24,24,3,22
42332,148,3,145,136,3,0,1,0,0
42333,1082,45,1037,1003,5,2,0,0,0
42337,1775,22,1753,1655,43,6,1,0,2
42338,88,4,84,75,0,0,0,0,0
42339,905,9,896,861,6,2,1,0,0
42343,1792,23,1769,1723,14,4,1,0,4
42344,836,15,821,778,8,0,0,0,10
42345,11307,130,11177,10303,507,20,18,0,17
42347,6126,190,5936,5663,48,7,23,2,23
42348,4823,65,4758,4601,24,3,14,0,5
42349,1353,16,1337,1297,0,2,0,0,3
42350,1334,29,1305,1272,3,0,0,2,5
42351,4294,107,4187,3977,67,7,17,0,10
42352,1989,45,1944,1875,8,8,5,0,7
42354,327,16,311,298,2,0,0,0,0
42355,1822,91,1731,1647,14,2,6,0,4
42356,68,1,67,64,0,0,1,0,0
42361,583,16,567,544,1,1,5,0,0
42366,6210,80,6130,5942,16,3,22,0,5
42367,877,21,856,798,19,3,6,0,5
42368,1337,3,1334,1291,4,1,3,0,0
42369,311,6,305,294,0,0,0,0,1
42370,52,3,49,48,1,0,0,0,0
42371,539,1,538,528,0,0,0,0,2
42372,1735,33,1702,1622,33,2,0,0,1
42374,105,2,103,94,1,1,3,0,1
42376,6678,143,6535,6235,60,8,24,1,15
42378,3277,42,3235,3157,9,0,3,1,1
42404,2277,38,2239,2128,12,4,6,1,7
42406,2756,51,2705,2507,70,5,5,1,7
42408,6226,89,6137,5875,30,4,8,1,7
42409,2436,39,2397,2246,69,2,0,0,4
42410,1310,53,1257,932,245,0,1,1,2
42411,1521,15,1506,1437,29,2,3,2,1
42413,2929,49,2880,2727,30,10,13,0,2
42420,37664,1246,36418,30688,3527,68,222,40,151
42431,26566,819,25747,21656,2481,42,200,25,81
42436,1298,21,1277,1203,24,5,6,0,3
42437,7422,128,7294,6109,795,16,28,0,22
42440,729,13,716,674,22,0,1,0,2
42441,1455,26,1429,1377,11,2,1,0,6
42442,3103,48,3055,2889,38,4,4,1,3
42444,35,0,35,29,0,3,0,0,0
42445,11009,176,10833,9647,628,20,48,0,29
42450,3909,63,3846,3252,374,5,8,0,17
42451,691,19,672,644,3,2,2,0,1
42452,2354,52,2302,2198,28,3,7,0,5
42453,488,8,480,449,1,1,0,0,3
42455,3306,683,2623,2470,21,10,8,0,16
42456,1691,25,1666,1619,7,0,2,0,4
42458,872,0,872,849,1,0,3,0,0
42459,4109,43,4066,3721,149,4,3,1,10
42461,1454,18,1436,1331,55,5,0,0,7
42462,1362,8,1354,1280,35,1,1,0,3
42463,109,0,109,105,0,0,0,0,2
42464,1809,10,1799,1723,21,2,2,2,3
42501,18047,695,17352,16178,323,52,74,3,44
42503,24670,781,23889,22445,276,53,297,3,66
42516,412,3,409,394,5,2,0,0,0
42518,2989,55,2934,2764,11,11,7,0,6
42519,2961,31,2930,2801,4,7,4,0,8
42528,1578,81,1497,1431,16,3,6,0,2
42533,848,16,832,787,13,3,3,1,1
42539,10134,398,9736,9368,55,21,39,1,32
42541,483,6,477,463,0,1,0,0,2
42544,5787,55,5732,5515,17,19,17,2,10
42553,5499,154,5345,5112,27,14,18,1,3
42565,789,18,771,757,2,0,0,0,0
42566,605,8,597,581,2,1,3,0,0
42567,5671,116,5555,5369,16,3,18,0,15
42602,9084,250,8834,8506,39,14,10,3,15
42603,727,12,715,692,5,2,1,2,0
42629,4994,135,4859,4599,60,18,18,2,9
42631,138,2,136,133,0,1,0,0,0
42633,18296,873,17423,16691,219,24,58,3,17
42634,1357,17,1340,1316,4,1,2,0,0
42635,4892,243,4649,3579,889,27,16,1,4
42638,128,0,128,120,0,0,0,0,0
42642,12939,642,12297,11838,52,37,86,1,14
42647,3726,27,3699,3589,3,6,4,0,1
42649,2179,14,2165,2104,2,4,2,0,2
42653,4201,59,4142,3984,9,14,8,2,10
42701,52731,2536,50195,41242,4467,154,1124,104,216
42712,1872,41,1831,1743,7,9,5,0,4
42713,1876,30,1846,1737,42,10,8,0,3
42715,389,13,376,323,4,4,3,0,15
42716,1601,58,1543,1432,16,2,2,2,5
42717,5850,75,5775,5416,148,1,2,6,6
42718,26099,698,25401,22798,1263,25,245,11,111
42721,3660,43,3617,3463,15,12,7,0,1
42722,816,22,794,755,15,0,0,1,0
42724,5107,110,4997,4655,56,13,35,5,11
42726,5190,71,5119,4766,177,3,12,0,11
42728,16451,581,15870,14790,484,22,57,6,53
42729,1574,18,1556,1492,3,3,2,0,0
42732,1913,20,1893,1774,20,10,3,0,2
42733,1530,40,1490,1413,6,5,7,0,4
42740,1878,29,1849,1705,37,3,15,0,4
42741,315,6,309,298,1,1,0,0,0
42742,52,0,52,50,0,0,0,0,0
42743,8900,165,8735,8301,130,17,21,2,21
42746,1965,33,1932,1806,53,4,1,3,3
42748,8991,312,8679,7905,313,27,24,12,30
42749,5219,99,5120,4481,375,12,11,1,18
42753,633,7,626,598,1,0,0,0,1
42754,15566,219,15347,14671,109,50,57,2,55
42757,2948,76,2872,2733,28,9,3,1,8
42758,129,2,127,120,2,0,0,0,2
42759,41,2,39,36,0,0,0,0,0
42762,450,9,441,404,4,2,10,0,3
42764,724,8,716,686,9,0,1,0,2
42765,6342,105,6237,5827,217,1,16,0,0
42776,2747,34,2713,2592,25,7,1,0,6
42782,821,15,806,751,11,2,4,0,6
42784,2799,54,2745,2639,13,8,5,0,7
42788,301,2,299,288,0,2,2,0,0
43001,2705,102,2603,2434,7,7,18,0,7
43002,2026,81,1945,1533,71,2,269,0,3
43003,2776,47,2729,2601,27,3,3,0,5
43004,29982,1242,28740,15632,7733,28,3721,13,149
43005,282,3,279,263,1,0,0,0,2
43006,715,2,713,686,1,4,2,0,0
43007,88,0,88,85,0,0,0,0,0
43008,2378,27,2351,2240,13,4,8,0,3
43009,2083,28,2055,1921,26,2,9,0,6
43010,245,1,244,225,1,0,1,1,0
43011,7559,124,7435,7084,29,2,15,1,17
43013,1220,5,1215,1141,5,3,2,0,4
43014,3850,31,3819,3680,17,1,6,0,8
43015,57563,2192,55371,48024,2010,72,2359,26,231
43016,44517,1995,42522,28660,1829,54,10088,12,171
43017,43619,2289,41330,31664,1672,55,5880,9,200
43018,373,24,349,296,7,0,13,0,7
43019,9419,94,9325,8933,28,12,26,6,37
43021,14622,376,14246,12718,367,10,541,8,68
43022,4120,184,3936,3550,93,1,130,1,85
43023,14462,427,14035,12575,224,15,510,4,202
43025,5541,88,5453,5090,32,16,28,1,18
43026,64607,3826,60781,49966,3592,73,3737,11,298
43027,58,0,58,55,0,0,0,0,1
43028,7781,84,7697,7316,50,5,24,0,18
43029,629,4,625,589,9,1,1,0,3
43030,344,7,337,312,1,3,2,0,4
43031,13189,338,12851,12025,82,25,97,3,40
43032,39,2,37,34,0,0,0,0,0
43033,352,11,341,311,0,3,0,0,1
43035,33032,1203,31829,21732,1871,53,6657,5,141
43036,267,6,261,243,3,0,0,0,1
43037,323,4,319,293,0,0,1,0,1
43040,35853,984,34869,31239,1012,58,1076,0,121
43044,5352,56,5296,5029,34,10,11,0,6
43045,1928,33,1895,1793,6,2,6,0,12
43046,3195,49,3146,2976,19,7,14,0,5
43047,31,8,23,16,0,1,0,0,2
43050,29594,711,28883,27098,339,87,168,8,63
43054,27781,1036,26745,20715,2127,27,2421,6,128
43055,62590,1120,61470,55768,1753,137,411,18,216
43056,17479,281,17198,15985,307,25,94,9,46
43060,2667,33,2634,2514,13,4,2,0,6
43061,4593,95,4498,4244,26,2,38,0,12
43062,32125,859,31266,26077,1707,76,1856,5,107
43064,17301,600,16701,14442,181,34,1343,0,70
43065,44829,1381,43448,36237,945,43,4324,15,158
43066,1264,26,1238,1168,6,0,5,0,10
43067,1410,27,1383,1307,8,0,4,0,3
43068,59585,3571,56014,27624,18955,103,5711,8,413
43070,158,3,155,128,6,0,0,0,6
43071,2442,36,2406,2297,9,4,7,1,2
43072,5504,92,5412,5126,23,14,24,0,31
43074,15288,389,14899,13694,224,13,222,2,49
43076,9145,75,9070,8610,44,26,17,1,35
43077,241,10,231,203,0,4,1,0,0
43078,20067,388,19679,17915,557,41,76,6,72
43080,5321,67,5254,4951,33,10,11,1,23
43081,64338,2701,61637,47331,7841,95,2929,10,307
43082,32459,968,31491,26832,1626,38,1654,5,125
43084,844,10,834,811,9,2,0,0,0
43085,25566,1320,24246,19996,1704,30,1027,6,156
43101,322,3,319,313,0,0,0,0,1
43102,4610,44,4566,4292,21,13,5,1,20
43103,12282,199,12083,11306,121,22,42,2,31
43105,8458,135,8323,7902,41,7,29,4,17
43106,1590,103,1487,1406,18,2,3,1,2
43107,3232,34,3198,3000,14,21,4,0,15
43109,94,4,90,65,9,0,4,0,1
43110,40953,1741,39212,23196,12227,72,1170,9,226
43111,178,3,175,170,0,2,0,0,0
43112,5052,71,4981,4716,40,12,24,0,4
43113,24165,366,23799,22084,428,52,139,6,75
43115,1260,13,1247,1166,15,3,3,1,12
43116,2732,61,2671,2421,71,1,40,1,4
43117,31,0,31,25,0,1,1,0,0
43119,30072,2929,27143,21181,2688,38,1457,11,132
43123,66188,2891,63297,54659,3617,91,1306,12,267
43125,14295,755,13540,9220,3021,33,344,2,129
43126,322,4,318,306,0,0,1,0,1
43127,284,4,280,257,0,1,0,0,0
43128,2267,52,2215,2022,64,1,6,7,9
43130,62010,1048,60962,56320,1528,107,309,8,154
43135,4267,29,4238,4059,14,5,9,0,5
43136,1977,49,1928,1594,178,9,20,1,10
43137,2684,118,2566,2224,127,9,25,0,4
43138,18445,176,18269,17358,116,33,58,0,39
43140,24030,601,23429,19724,2555,29,165,4,75
43142,94,3,91,87,0,0,0,0,0
43143,5935,130,5805,5478,28,18,22,0,22
43144,373,0,373,363,1,1,0,0,0
43145,1920,37,1883,1764,20,2,3,1,2
43146,12627,219,12408,10376,1486,22,71,3,35
43147,45281,1699,43582,31850,7434,75,1788,14,191
43148,2431,31,2400,2285,22,4,8,0,6
43149,2335,11,2324,2221,7,1,6,0,5
43150,2302,25,2277,2163,3,5,3,0,4
43151,269,16,253,239,0,1,0,0,0
43152,969,5,964,910,2,0,1,0,1
43153,861,54,807,747,2,2,0,0,13
43154,3014,21,2993,2856,14,4,2,0,4
43155,2531,27,2504,2372,5,6,2,1,9
43156,203,6,197,188,2,3,0,0,0
43157,599,9,590,556,2,0,1,0,0
43158,182,2,180,175,0,0,0,0,0
43160,22117,472,21645,20104,415,34,149,2,69
43162,6945,116,6829,6451,49,4,24,0,21
43164,2216,30,2186,2050,12,5,2,0,6
43201,37528,2300,35228,25637,4734,27,2945,20,164
43202,20427,918,19509,15587,855,26,1980,4,98
43203,8726,396,8330,2187,5404,26,97,4,77
43204,42315,5694,36621,25747,6551,92,1406,23,226
43205,12044,557,11487,4207,6351,43,118,5,104
43206,21594,895,20699,10935,8143,64,327,13,131
43207,46853,2810,44043,27654,12655,152,690,17,258
43209,27727,1079,26648,18104,6623,28,444,11,169
43210,14126,450,13676,12406,792,0,332,40,46
43211,23160,2049,21111,5172,14202,58,112,11,171
43212,24171,915,23256,19643,719,7,1721,7,131
43213,35105,4014,31091,12906,15504,87,549,13,227
43214,26805,825,25980,22098,1492,39,1023,3,87
43215,20761,1076,19685,15250,2341,43,1059,6,120
43217,2408,185,2223,1566,388,3,60,4,5
43218,0,0,0,0,0,0,0,0,0
43219,30457,2277,28180,4891,20436,65,1343,13,253
43220,27736,1201,26535,20671,1273,34,3191,5,112
43221,33844,1136,32708,28667,552,39,1862,9,106
43222,4124,331,3793,2374,1003,16,31,3,25
43223,27951,2908,25043,15819,6881,85,474,6,139
43224,43544,4670,38874,15872,18542,77,2047,10,250
43227,25041,2919,22122,4741,15366,44,519,5,160
43228,58465,9672,48793,31214,12364,78,1873,16,294
43229,54310,6106,48204,16963,23566,115,4674,9,414
43230,58372,2592,55780,38178,11120,93,2968,27,313
43231,22126,1653,20473,8539,9117,17,1557,4,182
43232,44823,3226,41597,12253,25810,99,625,24,283
43235,45561,3089,42472,32929,2867,62,4141,19,233
43240,7661,459,7202,3856,775,11,2210,5,56
43302,54094,1758,52336,45591,4017,126,322,12,122
43310,3185,46,3139,2984,9,7,9,0,10
43311,20029,659,19370,17359,563,45,218,6,96
43314,3096,45,3051,2892,16,3,10,0,15
43315,7090,76,7014,6685,26,11,10,0,13
43316,5931,109,5822,5601,17,9,44,1,8
43317,184,29,155,147,0,0,0,0,2
43318,3609,33,3576,3414,14,6,8,2,11
43319,1062,39,1023,946,6,9,3,1,2
43320,1440,39,1401,1328,7,2,2,3,0
43321,250,4,246,230,1,0,0,0,1
43322,310,3,307,292,2,1,0,0,0
43323,609,10,599,579,3,0,0,0,4
43324,2753,35,2718,2611,12,1,11,0,7
43325,151,0,151,147,1,0,0,0,0
43326,13328,290,13038,12379,90,19,36,6,31
43330,120,4,116,112,1,2,0,0,0
43331,4428,65,4363,4112,11,7,21,1,23
43332,2136,69,2067,1975,4,5,3,0,4
43333,826,5,821,785,4,0,4,0,1
43334,6721,116,6605,6300,28,14,24,0,18
43336,91,0,91,87,0,0,0,0,0
43337,1001,12,989,956,2,1,1,0,3
43338,10423,174,10249,9714,66,18,33,4,43
43340,1754,25,1729,1633,3,1,18,0,2
43341,911,34,877,841,1,2,1,0,0
43342,3256,40,3216,3057,5,0,13,1,15
43343,1233,7,1226,1172,1,1,2,0,5
43344,5702,98,5604,5337,14,4,22,0,17
43345,874,10,864,828,7,1,5,0,0
43346,56,1,55,55,0,0,0,0,0
43347,1492,16,1476,1411,3,0,9,0,7
43348,1880,50,1830,1711,16,4,16,1,4
43350,127,0,127,119,0,1,0,0,0
43351,10144,395,9749,9385,40,7,35,2,25
43356,1161,13,1148,1081,5,0,9,0,9
43357,4848,50,4798,4493,35,2,22,0,18
43358,2587,31,2556,2413,8,14,14,0,5
43359,720,10,710,698,0,0,1,0,0
43360,1590,20,1570,1501,6,2,2,0,0
43402,31459,2214,29245,26082,1124,44,702,4,78
43403,5422,217,5205,4305,575,3,80,1,15
43406,1740,100,1640,1547,8,3,2,0,4
43407,631,22,609,567,5,2,0,0,4
43408,251,16,235,221,3,0,0,0,0
43410,10219,756,9463,8936,66,13,32,2,29
43412,4033,203,3830,3658,15,4,10,0,23
43413,1430,60,1370,1320,4,0,0,1,0
43414,73,1,72,67,0,0,0,0,0
43416,2769,169,2600,2478,7,4,12,0,6
43420,29332,4083,25249,22000,1619,35,121,5,91
43430,4631,324,4307,4086,11,8,19,0,23
43431,4500,374,4126,3969,13,3,2,0,8
43432,1354,65,1289,1224,7,5,1,1,6
43433,101,24,77,65,0,0,2,0,0
43434,89,9,80,68,2,0,1,1,1
43435,1484,90,1394,1345,2,1,5,0,3
43436,10,1,9,9,0,0,0,0,0
43437,447,19,428,414,3,2,0,0,0
43438,256,1,255,245,0,0,5,0,0
43439,62,7,55,45,2,2,1,0,0
43440,4665,117,4548,4425,16,5,16,0,3
43442,1015,97,918,854,6,2,4,0,0
43443,1856,91,1765,1699,8,3,1,0,1
43445,1188,88,1100,1042,1,0,8,0,5
43446,118,0,118,110,0,0,0,0,2
43447,3343,212,3131,2963,22,0,12,0,16
43449,8057,352,7705,7397,34,6,15,3,21
43450,3454,164,3290,3164,16,0,11,0,5
43451,1126,115,1011,939,6,2,1,0,5
43452,13443,798,12645,11857,237,12,72,2,25
43456,678,4,674,655,4,0,1,0,3
43457,1443,74,1369,1298,9,9,7,0,3
43458,312,16,296,276,0,1,1,0,0
43460,6230,381,5849,5395,118,7,50,1,11
43462,1096,75,1021,968,2,1,1,0,2
43463,253,14,239,229,2,0,4,0,0
43464,1336,72,1264,1179,5,0,2,0,2
43465,5599,368,5231,4869,88,4,13,0,21
43466,2141,91,2050,1970,12,5,2,0,9
43467,131,6,125,121,1,0,0,0,0
43468,565,22,543,520,3,0,0,0,0
43469,3014,202,2812,2707,6,2,10,0,7
43501,844,35,809,772,1,2,3,0,5
43502,7064,877,6187,5951,40,4,32,0,23
43504,1110,20,1090,1061,2,2,2,0,0
43505,98,0,98,94,0,0,0,0,1
43506,15010,824,14186,13467,63,29,112,0,45
43510,157,3,154,151,0,0,0,0,0
43511,856,38,818,790,5,0,4,0,0
43512,28208,3410,24798,23120,574,57,112,13,72
43515,8174,560,7614,7181,26,19,18,1,20
43516,2776,252,2524,2434,4,5,11,2,3
43517,3494,146,3348,3214,6,4,10,0,3
43518,2572,62,2510,2410,9,3,7,0,6
43519,143,7,136,131,0,0,0,0,0
43520,77,0,77,75,0,0,0,0,0
43521,2693,245,2448,2343,12,6,13,0,5
43522,3249,166,3083,2943,12,9,11,0,9
43523,133,3,130,126,0,0,1,0,0
43524,1239,168,1071,1028,9,3,3,0,2
43525,1191,58,1133,1087,5,1,6,0,1
43526,5995,355,5640,5379,21,14,16,1,7
43527,2152,277,1875,1821,8,2,5,0,5
43528,16746,899,15847,12855,1690,21,503,0,62
43529,220,41,179,169,1,0,0,0,0
43530,15,0,15,12,0,0,0,0,0
43531,156,9,147,146,0,0,0,0,0
43532,3775,122,3653,3469,16,4,10,0,9
43533,1509,67,1442,1389,1,0,1,0,2
43534,1662,106,1556,1500,4,3,3,0,5
43535,721,61,660,646,1,3,2,0,0
43536,383,27,356,341,1,0,0,0,1
43537,29075,1393,27682,24580,1279,20,614,2,107
43540,1459,48,1411,1358,2,1,3,0,5
43541,137,26,111,101,0,0,0,0,1
43542,4443,164,4279,3942,73,3,89,2,15
43543,7364,278,7086,6763,28,14,43,0,21
43545,13954,1140,12814,12246,110,30,89,4,19
43547,370,26,344,329,3,0,0,0,0
43548,721,40,681,664,6,0,0,0,0
43549,1359,46,1313,1282,1,4,1,0,4
43551,43235,2364,40871,36450,837,42,1743,0,108
43553,330,30,300,283,2,1,9,0,0
43554,2413,122,2291,2198,8,0,6,0,3
43555,333,31,302,295,1,0,2,0,2
43556,1762,96,1666,1600,6,0,3,1,2
43557,3161,280,2881,2601,202,4,9,0,3
43558,13088,573,12515,11793,189,17,20,0,38
43560,34204,1328,32876,29201,996,36,1282,7,102
43565,349,25,324,303,4,0,0,0,0
43566,8371,289,8082,7614,59,5,96,0,30
43567,13240,1632,11608,10960,71,18,66,5,40
43569,2628,226,2402,2244,23,9,5,0,3
43570,3152,135,3017,2913,7,2,10,0,7
43571,7753,238,7515,7084,73,8,36,1,28
43604,9248,779,8469,2868,4986,28,62,4,60
43605,25007,4619,20388,14614,3864,55,104,3,117
43606,25671,1522,24149,14790,7289,66,779,41,152
43607,20494,899,19595,4693,12985,61,621,6,136
43608,12948,1687,11261,3184,7316,24,38,0,41
43609,20519,3465,17054,9439,5918,64,124,5,134
43610,4159,173,3986,773,2965,5,9,2,32
43611,18505,1594,16911,13961,1849,55,56,0,52
43612,29718,2705,27013,18025,6601,75,132,6,163
43613,32116,2426,29690,23132,4220,60,224,4,155
43614,29866,1952,27914,19943,5928,50,558,9,124
43615,39449,2219,37230,23715,10210,77,910,11,189
43616,20480,1746,18734,17308,395,25,158,9,60
43617,7659,297,7362,6241,423,3,374,0,30
43619,7454,633,6821,6234,85,10,83,0,19
43620,5019,270,4749,1550,2851,25,18,2,27
43623,20320,1050,19270,16625,1307,35,277,0,72
43701,55361,727,54634,48010,2722,89,242,4,285
43711,87,0,87,87,0,0,0,0,0
43713,7227,55,7172,6864,44,6,19,0,18
43716,1806,10,1796,1726,2,1,2,0,3
43717,156,1,155,143,0,0,0,0,0
43718,3049,19,3030,2888,3,7,8,0,6
43719,2319,25,2294,2227,7,3,0,0,0
43720,1304,4,1300,1239,13,1,1,0,4
43721,140,3,137,126,2,0,0,0,0
43722,324,3,321,313,1,0,0,0,0
43723,4671,65,4606,4331,30,7,13,0,1
43724,8865,140,8725,7773,749,21,18,0,11
43725,19520,254,19266,17802,439,57,108,6,43
43727,1517,16,1501,1419,15,0,1,0,7
43728,1072,15,1057,725,169,8,0,0,11
43730,2277,11,2266,2166,3,8,0,0,14
43731,5200,37,5163,4943,19,11,1,0,12
43732,1648,11,1637,1560,2,5,4,0,2
43733,57,3,54,48,0,1,0,0,0
43734,1212,9,1203,1141,4,0,14,0,6
43735,382,6,376,367,1,0,0,0,0
43736,19,0,19,19,0,0,0,0,0
43738,73,2,71,66,2,0,1,0,0
43739,2380,28,2352,2234,5,2,5,0,10
43740,220,1,219,203,0,1,0,0,1
43746,1261,13,1248,1178,7,1,2,0,5
43747,1229,8,1221,1203,1,0,1,1,0
43748,2711,16,2695,2593,1,12,10,0,4
43749,2308,12,2296,2206,8,7,5,1,3
43750,145,0,145,131,0,1,0,0,1
43754,1318,1,1317,1279,2,6,4,0,1
43755,1732,18,1714,1649,9,0,4,0,2
43756,4909,46,4863,4481,102,6,15,1,18
43758,3000,26,2974,2809,48,1,4,0,6
43759,235,0,235,223,2,0,0,0,0
43760,1949,19,1930,1824,9,3,8,0,6
43761,54,2,52,48,0,0,0,0,0
43762,5346,96,5250,4957,72,4,38,0,10
43764,8177,67,8110,7740,27,18,19,0,7
43766,1492,15,1477,1368,7,4,2,0,2
43767,1425,19,1406,1345,5,0,2,0,1
43768,223,2,221,211,4,1,0,0,1
43771,1796,17,1779,1709,6,4,0,3,3
43772,1811,13,1798,1719,4,2,4,0,2
43773,2964,26,2938,2864,3,3,7,0,3
43777,4568,29,4539,4293,14,18,5,0,12
43778,1428,21,1407,1364,4,2,2,0,1
43779,888,7,881,861,1,1,0,0,0
43780,2235,12,2223,2137,7,8,3,0,6
43782,727,7,720,683,0,1,2,0,0
43783,4743,37,4706,4529,15,5,12,0,11
43786,56,1,55,48,0,0,0,0,0
43787,2815,24,2791,2567,69,1,4,1,6
43788,816,4,812,788,1,1,0,1,0
43791,133,0,133,127,4,0,0,0,0
43793,4829,36,4793,4630,8,4,15,0,11
43802,1334,7,1327,1281,4,4,5,0,4
43804,4045,58,3987,3936,2,1,5,0,0
43805,66,0,66,65,0,0,0,0,0
43811,763,7,756,722,0,0,1,0,1
43812,18669,259,18410,17323,327,28,76,3,20
43821,4557,52,4505,4180,51,9,29,0,14
43822,4668,47,4621,4378,27,18,14,1,13
43824,3991,42,3949,3857,8,1,5,2,1
43830,6593,50,6543,6139,67,13,42,2,21
43832,7341,88,7253,6890,72,11,14,0,15
43836,107,2,105,100,1,0,3,0,0
43837,1784,20,1764,1672,6,4,1,0,2
43840,1279,15,1264,1213,5,0,4,0,5
43842,345,10,335,322,0,0,0,0,0
43843,1449,6,1443,1396,5,2,1,0,4
43844,3778,34,3744,3585,25,10,6,2,12
43845,4803,36,4767,4636,18,9,0,0,5
43901,2082,16,2066,1978,4,2,5,1,2
43902,200,0,200,190,2,0,0,0,0
43903,1937,5,1932,1850,2,3,3,0,0
43905,474,0,474,450,1,0,0,0,0
43906,7952,107,7845,7127,260,20,9,0,12
43907,5369,57,5312,4769,213,3,22,1,9
43908,1321,18,1303,1252,3,2,1,0,0
43909,78,1,77,70,0,0,0,0,0
43910,3379,21,3358,3158,23,1,11,2,2
43912,6060,70,5990,5428,206,4,28,1,16
43913,1322,11,1311,1240,9,2,0,0,3
43914,66,0,66,66,0,0,0,0,0
43915,1383,4,1379,1350,3,0,0,0,0
43917,2647,28,2619,2433,32,3,3,2,9
43920,21662,271,21391,19628,537,44,104,4,45
43925,119,3,116,104,1,1,0,0,2
43926,247,4,243,234,1,1,0,0,1
43928,235,1,234,226,0,0,0,0,0
43930,681,7,674,633,1,0,0,0,4
43931,168,0,168,167,1,0,0,0,0
43932,970,21,949,912,4,0,1,0,5
43933,1969,19,1950,1878,5,2,1,0,9
43934,227,0,227,211,2,0,1,0,0
43935,7968,96,7872,6974,341,16,14,0,24
43938,5196,103,5093,4599,144,11,10,4,73
43939,436,6,430,412,5,1,3,0,0
43940,321,7,314,292,1,0,1,0,1
43942,2271,25,2246,2166,2,1,6,0,3
43943,3452,28,3424,3240,23,5,3,2,11
43944,2328,18,2310,2209,10,7,4,1,4
43945,2972,26,2946,2794,28,1,2,0,2
43946,1836,6,1830,1767,2,0,0,1,3
43947,5002,89,4913,4742,14,1,17,0,4
43948,514,12,502,424,27,3,0,0,3
43950,16212,275,15937,14140,1143,22,150,10,29
43951,169,1,168,163,1,0,1,0,0
43952,17977,570,17407,13457,2592,38,130,7,91
43953,11637,204,11433,10188,592,12,117,3,19
43961,234,7,227,205,0,0,2,0,0
43962,66,0,66,62,0,0,2,0,0
43963,1249,14,1235,1159,14,1,5,0,7
43964,9098,69,9029,8412,121,15,43,7,14
43967,37,0,37,36,0,0,0,0,0
43968,6546,64,6482,5835,257,10,6,0,10
43971,1033,11,1022,936,30,0,1,1,0
43972,93,0,93,89,0,0,0,0,0
43973,1947,16,1931,1864,3,0,1,1,0
43974,99,1,98,93,0,0,0,0,0
43976,1543,12,1531,1438,13,0,3,0,1
43977,2178,7,2171,2056,16,0,5,1,4
43981,176,0,176,170,0,0,0,0,0
43983,436,9,427,403,4,0,2,0,0
43985,270,1,269,261,0,0,0,0,2
43986,1728,30,1698,1602,6,3,9,1,8
43988,2351,15,2336,2234,4,8,1,0,2
44001,20837,1225,19612,18458,205,28,153,3,46
44003,4275,43,4232,3996,38,2,12,2,25
44004,31661,2843,28818,24534,1829,69,125,1,125
44010,1666,40,1626,1514,8,2,7,3,3
44011,24847,1197,23650,21149,611,22,984,1,66
44012,25206,920,24286,22542,276,28,490,15,59
44017,18611,745,17866,15318,1212,32,406,5,51
44021,6347,96,6251,5986,34,2,20,0,7
44022,17150,404,16746,15230,460,6,472,3,41
44023,19075,413,18662,17303,514,5,210,0,41
44024,23795,441,23354,22114,221,14,161,1,57
44026,10877,221,10656,10159,65,2,74,0,40
44028,8931,285,8646,8175,25,18,62,2,44
44030,15868,411,15457,13400,1217,23,77,3,40
44032,1505,31,1474,1386,6,1,10,0,3
44035,61921,4923,56998,44536,7675,126,470,6,268
44039,35630,1635,33995,31311,634,31,563,7,107
44040,3032,78,2954,2684,62,2,117,0,12
44041,13910,729,13181,12228,149,18,54,1,26
44044,14911,455,14456,12257,1599,24,53,3,32
44045,421,19,402,378,9,2,0,0,0
44046,2187,23,2164,2087,30,4,3,1,2
44047,9156,162,8994,8537,80,15,18,0,10
44048,2178,20,2158,2035,21,7,3,0,4
44049,194,6,188,185,0,0,0,0,0
44050,6724,195,6529,6146,47,8,28,0,15
44052,29249,7778,21471,14155,5326,66,83,4,98
44053,20735,4294,16441,12940,2312,33,182,2,58
44054,12484,862,11622,10533,272,20,180,0,36
44055,19331,7951,11380,7627,2689,37,43,1,76
44056,12156,197,11959,9470,1455,8,568,3,41
44057,19447,691,18756,17426,182,29,127,1,26
44060,60360,1255,59105,54803,935,40,1007,3,141
44062,15085,133,14952,14596,62,4,40,2,19
44064,1618,22,1596,1510,15,2,7,1,5
44065,4058,75,3983,3775,59,0,12,0,14
44067,19995,443,19552,16767,1454,21,631,3,38
44068,226,5,221,209,1,0,0,0,0
44070,32442,1628,30814,27577,950,32,903,8,116
44072,4583,97,4486,4233,41,1,38,0,16
44074,11957,628,11329,9091,1168,31,232,2,77
44076,5313,57,5256,5078,46,8,11,2,5
44077,58253,7090,51163,44686,3191,58,585,11,216
44080,153,0,153,148,0,0,0,0,0
44081,6930,441,6489,6084,68,1,36,0,20
44082,1511,22,1489,1426,8,1,3,0,7
44084,3707,64,3643,3427,51,1,15,0,4
44085,3232,45,3187,3036,25,1,4,0,4
44086,2221,27,2194,2101,8,0,0,0,4
44087,22626,503,22123,15054,4387,12,1746,11,75
44089,15899,589,15310,14520,63,14,53,3,28
44090,11085,266,10819,10238,99,17,26,0,25
44092,16786,358,16428,13074,2364,22,239,2,66
44093,1454,9,1445,1373,13,3,2,0,3
44094,37634,800,36834,31922,2521,39,971,15,86
44095,32616,711,31905,28538,1500,45,285,6,49
44099,2528,5,2523,2463,17,2,1,0,1
44101,624,13,611,474,131,1,0,1,0
44102,43347,11524,31823,19027,9230,137,956,11,342
44103,14469,858,13611,1646,10986,42,395,3,66
44104,20202,485,19717,411,18705,29,35,5,66
44105,34100,1693,32407,6496,24331,66,57,4,219
44106,26608,1162,25446,10546,10039,52,3663,6,155
44107,51109,2504,48605,42275,2696,54,1223,16,196
44108,20005,353,19652,1273,17725,48,88,4,87
44109,39121,11628,27493,18859,6037,94,420,9,213
44110,17617,353,17264,2053,14527,28,36,6,69
44111,41045,8001,33044,22856,6328,84,1668,15,255
44112,18685,404,18281,790,16690,41,59,5,101
44113,20291,3107,17184,11606,4209,33,593,8,75
44114,7622,541,7081,3235,1835,13,1683,1,51
44115,8985,925,8060,2360,5051,12,268,2,51
44116,21821,707,21114,19589,290,21,512,8,79
44117,10533,242,10291,1943,7813,19,51,2,50
44118,40242,1307,38935,22986,12906,40,1084,5,338
44119,12134,248,11886,4312,6996,14,73,7,53
44120,34611,786,33825,7593,23648,50,1113,8,158
44121,32887,1023,31864,10469,19198,39,693,6,231
44122,36268,1019,35249,19973,11217,17,2337,4,273
44123,17620,369,17251,5823,10597,29,121,1,119
44124,40530,1175,39355,29065,5857,44,2718,2,203
44125,29663,1175,28488,12655,14305,36,290,4,89
44126,17235,730,16505,15097,437,14,279,5,71
44127,4179,456,3723,1210,2285,29,3,0,17
44128,28146,497,27649,674,26005,46,95,3,137
44129,28803,2139,26664,23256,1293,33,760,3,89
44130,50825,2965,47860,41037,2284,87,2587,8,170
44131,20664,537,20127,18587,279,17,609,1,62
44132,14524,342,14182,4555,8892,26,90,0,98
44133,31373,857,30516,27585,548,31,1336,0,67
44134,38845,2577,36268,32428,1276,71,911,5,119
44135,26684,4635,22049,14265,4979,64,1180,15,119
44136,25890,1059,24831,21330,816,21,1713,12,73
44137,23759,646,23113,4330,17718,47,148,5,135
44138,23088,846,22242,20429,461,7,461,1,75
44139,25331,607,24724,16378,3150,24,4181,3,92
44140,16163,436,15727,15019,95,2,162,1,26
44141,14130,279,13851,12735,108,6,492,3,30
44142,18598,1149,17449,15333,772,13,447,1,55
44143,25339,537,24802,14355,8500,17,1139,2,79
44144,21361,4335,17026,13361,1803,55,780,3,108
44145,34228,1157,33071,29020,773,16,1963,9,146
44146,29778,995,28783,9493,17800,47,242,11,111
44147,19872,615,19257,16963,516,10,1020,0,61
44149,20678,591,20087,17836,372,29,1195,2,61
44201,6658,81,6577,6250,28,6,26,0,19
44202,22167,475,21692,18717,929,11,1210,6,74
44203,39577,675,38902,34223,2217,80,250,16,123
44212,45749,1504,44245,40871,625,45,753,3,170
44214,2149,23,2126,2028,4,3,9,1,2
44215,2289,70,2219,2084,16,0,15,1,6
44216,9443,100,9343,8819,69,4,41,1,45
44217,4165,62,4103,3902,19,8,14,1,6
44221,29601,622,28979,24586,1298,50,1678,7,108
44223,18388,403,17985,15946,669,32,515,4,78
44224,38709,864,37845,33317,1597,16,1285,4,87
44230,8064,95,7969,7585,39,11,19,2,9
44231,8398,68,8330,7904,34,2,22,1,23
44232,30,5,25,19,0,0,0,0,0
44233,8025,147,7878,7489,33,6,114,0,23
44234,3763,94,3669,3344,165,2,24,0,26
44235,1960,23,1937,1865,10,5,3,0,0
44236,26216,637,25579,22668,626,13,1254,4,65
44240,38354,1056,37298,30730,2718,47,1602,10,155
44241,17659,474,17185,14223,1583,13,535,12,66
44243,5670,255,5415,4236,786,41,129,2,1
44250,1469,24,1445,1319,24,10,7,0,2
44251,928,13,915,869,2,0,4,0,1
44253,3438,76,3362,3210,16,3,5,0,8
44254,4784,74,4710,4453,27,2,28,0,7
44255,7558,116,7442,6962,79,8,24,0,32
44256,64815,1753,63062,58202,1194,63,794,11,279
44260,13152,188,12964,12310,43,13,39,0,25
44262,5020,89,4931,4374,111,5,201,2,23
44264,3370,76,3294,2834,105,11,188,1,13
44266,32606,605,32001,28213,1721,75,161,6,120
44270,8384,164,8220,7740,41,17,47,0,24
44272,5356,65,5291,4834,80,4,143,0,13
44273,6900,126,6774,6420,30,15,29,1,17
44274,265,2,263,253,1,0,0,0,0
44275,3257,55,3202,3055,9,5,4,0,5
44276,2023,24,1999,1918,10,0,5,2,0
44278,18671,305,18366,16184,787,15,513,4,40
44280,5343,75,5268,5038,15,0,38,0,13
44281,33241,663,32578,30452,309,48,377,12,57
44285,169,0,169,162,0,0,0,0,0
44286,6258,95,6163,5625,114,2,180,0,14
44287,7561,112,7449,7093,23,16,18,2,12
44288,3444,58,3386,3023,130,7,10,0,11
44301,14364,455,13909,8393,3992,20,373,6,69
44302,4661,149,4512,2565,1595,7,51,0,26
44303,7031,173,6858,5440,974,12,75,0,40
44304,4185,177,4008,2056,1408,8,361,5,22
44305,21214,613,20601,13283,5257,49,401,15,138
44306,21085,668,20417,8897,9142,48,741,22,119
44307,6959,221,6738,960,5353,21,42,4,48
44308,1037,43,994,602,265,6,60,0,6
44310,24984,1480,23504,10035,5379,47,6683,6,139
44311,6993,310,6683,3042,2893,29,271,1,39
44312,30510,558,29952,26407,1315,52,487,8,106
44313,25678,818,24860,17490,5532,27,446,4,119
44314,17686,389,17297,12112,3719,44,85,1,80
44319,21833,319,21514,19667,569,53,256,5,68
44320,19083,422,18661,4660,12869,27,160,6,137
44321,15993,396,15597,12001,1524,21,1311,2,65
44325,1259,35,1224,976,199,0,42,0,0
44333,19449,500,18949,16175,1224,11,710,1,65
44401,2648,37,2611,2494,1,3,1,0,3
44402,2951,28,2923,2771,9,2,3,0,10
44403,3690,37,3653,3482,32,3,6,3,3
44404,1300,5,1295,1264,2,0,1,0,2
44405,7837,1731,6106,3971,1744,12,15,2,19
44406,22740,550,22190,20618,362,15,490,3,64
44408,10526,173,10353,9945,35,6,54,1,15
44410,16824,254,16570,15646,171,18,109,1,41
44411,2319,55,2264,2119,15,1,5,0,8
44412,2472,26,2446,2334,6,7,15,0,2
44413,7186,105,7081,6731,40,17,17,1,26
44415,441,29,412,310,94,0,6,0,0
44417,1539,12,1527,1447,3,1,5,0,4
44418,1224,29,1195,1131,12,4,1,1,7
44420,15033,440,14593,12854,933,25,79,0,30
44423,2234,17,2217,2150,13,0,1,0,5
44424,130,0,130,128,0,0,0,0,0
44425,14280,315,13965,12934,423,11,68,1,26
44427,1555,18,1537,1490,2,5,1,0,4
44428,3115,38,3077,2911,8,8,12,0,3
44429,2437,36,2401,2257,14,1,13,0,0
44430,4723,110,4613,3538,853,6,11,0,11
44431,4629,43,4586,4414,11,0,15,1,11
44432,12276,228,12048,10770,870,36,27,0,23
44436,3382,138,3244,3051,64,10,2,0,10
44437,4073,85,3988,3740,65,3,10,0,4
44438,4762,72,4690,4183,219,3,12,0,8
44439,577,2,575,572,1,0,0,0,0
44440,4648,129,4519,4216,120,7,10,1,2
44441,1558,13,1545,1473,1,5,0,0,9
44442,4095,93,4002,3862,13,3,6,0,3
44443,1742,54,1688,1609,3,3,3,0,10
44444,10042,145,9897,9262,123,15,20,1,38
44445,3160,24,3136,2978,8,1,6,4,6
44446,20173,491,19682,17424,883,24,167,1,71
44449,1230,14,1216,1168,0,0,1,0,4
44450,1824,14,1810,1683,50,1,3,1,4
44451,3199,54,3145,3024,5,2,6,0,8
44452,3114,38,3076,2905,40,3,15,0,9
44454,935,13,922,881,5,3,2,0,2
44455,1558,19,1539,1490,1,4,2,0,0
44460,25393,752,24641,23245,188,41,129,3,71
44470,3681,43,3638,3446,21,1,7,0,11
44471,10445,601,9844,8824,448,15,51,5,20
44473,3719,44,3675,3487,43,1,21,0,8
44481,10258,132,10126,9246,395,14,34,1,38
44483,24840,651,24189,19390,3129,45,111,8,115
44484,22290,449,21841,18188,2189,34,291,6,52
44485,15172,389,14783,8179,5427,20,43,2,88
44490,721,7,714,690,2,1,0,0,1
44491,3950,36,3914,3785,10,4,8,0,1
44493,221,4,217,203,2,0,0,0,0
44502,9300,1197,8103,3844,3648,22,41,9,62
44503,1922,136,1786,747,986,5,2,0,5
44504,4577,282,4295,1887,2098,21,89,0,14
44505,17048,1901,15147,6363,7830,28,121,2,94
44506,2109,943,1166,267,805,7,4,2,8
44507,4598,590,4008,998,2663,13,17,4,19
44509,10934,928,10006,6471,2783,25,20,8,65
44510,2034,237,1797,267,1394,4,4,0,37
44511,18738,1073,17665,12114,4594,23,80,2,49
44512,33282,1679,31603,26370,3182,41,633,8,96
44514,22599,729,21870,20598,479,21,190,2,36
44515,27480,1070,26410,22730,2352,34,157,11,64
44555,215,8,207,190,6,4,2,0,3
44601,33688,725,32963,28440,2268,41,159,18,165
44606,8218,150,8068,7923,14,3,5,8,11
44607,67,0,67,65,0,2,0,0,0
44608,2646,33,2613,2508,7,2,7,1,7
44609,3592,39,3553,3386,10,3,3,0,6
44610,385,7,378,375,0,1,0,0,0
44611,2133,37,2096,2037,3,2,6,2,10
44612,5443,79,5364,5108,33,4,13,2,3
44613,1998,28,1970,1869,10,1,3,0,3
44614,12922,222,12700,11926,90,14,150,4,28
44615,10557,148,10409,9983,30,33,40,1,19
44618,7159,189,6970,6738,54,1,36,0,11
44619,250,4,246,241,0,1,0,0,1
44620,1428,12,1416,1332,8,5,0,0,1
44621,4606,61,4545,4311,56,6,3,4,4
44622,18921,1498,17423,16577,158,29,84,14,34
44624,5843,46,5797,5725,7,0,5,3,1
44625,1322,11,1311,1255,2,1,4,0,1
44626,2996,28,2968,2749,23,7,9,0,14
44627,7692,65,7627,7564,2,1,0,0,5
44628,1119,37,1082,1027,3,2,1,0,0
44629,2126,25,2101,2025,5,2,2,0,9
44630,28,2,26,20,0,0,0,0,0
44632,10047,201,9846,9258,55,32,46,2,20
44633,2565,15,2550,2504,13,2,4,0,0
44634,1995,13,1982,1914,1,0,5,0,0
44637,2437,27,2410,2310,6,3,1,0,2
44638,1555,24,1531,1463,7,1,6,0,5
44639,122,1,121,113,0,1,0,0,0
44640,151,4,147,141,0,0,0,0,0
44641,20399,340,20059,19033,138,29,89,3,44
44643,3218,39,3179,3032,13,10,3,1,8
44644,4378,55,4323,4070,51,14,4,1,10
44645,2670,57,2613,2487,14,4,1,0,13
44646,47973,1531,46442,40148,3060,74,508,9,146
44647,18368,392,17976,16566,388,34,57,6,75
44651,765,3,762,734,5,1,1,0,1
44652,542,6,536,461,28,3,4,0,6
44653,632,16,616,603,4,0,0,0,0
44654,20612,221,20391,19956,83,19,39,3,23
44656,2618,24,2594,2428,7,6,10,0,10
44657,9916,126,9790,9283,36,29,21,2,29
44659,160,6,154,150,0,0,1,0,1
44660,138,1,137,137,0,0,0,0,0
44661,248,3,245,230,0,0,0,0,0
44662,9562,104,9458,9061,83,12,24,1,14
44663,25601,1711,23890,22509,238,41,125,2,50
44665,54,0,54,51,0,0,0,0,1
44666,2935,29,2906,2769,12,7,17,1,11
44667,13723,671,13052,11810,432,27,183,4,49
44669,1454,14,1440,1383,6,1,2,1,1
44670,155,3,152,137,0,0,0,0,1
44671,348,7,341,315,2,1,0,0,0
44672,4589,46,4543,4375,14,4,13,1,5
44675,1890,7,1883,1819,4,0,1,0,6
44676,4771,50,4721,4572,8,9,4,0,10
44677,2805,36,2769,2621,21,1,15,5,6
44678,282,4,278,267,3,0,0,0,0
44680,4255,106,4149,3984,14,2,12,0,9
44681,8053,117,7936,7801,15,3,17,0,12
44682,1041,7,1034,1019,0,0,0,0,0
44683,8313,115,8198,7765,72,13,22,3,15
44685,29008,504,28504,26393,465,17,401,4,54
44687,456,5,451,451,0,0,0,0,0
44688,2958,35,2923,2710,46,10,7,0,12
44689,586,4,582,570,4,1,0,0,2
44690,153,2,151,149,0,0,0,0,0
44691,44666,1122,43544,39815,1089,53,611,8,124
44693,78,2,76,72,0,0,1,1,0
44695,1222,7,1215,1167,1,2,0,0,2
44697,260,1,259,253,1,0,0,0,0
44699,909,4,905,871,0,0,0,0,1
44702,1086,24,1062,709,268,5,10,1,8
44703,8015,739,7276,4400,1955,35,18,9,59
44704,3723,121,3602,1322,1920,18,4,0,36
44705,17779,971,16808,10647,4327,71,66,1,200
44706,16972,439,16533,13873,1556,39,30,2,95
44707,9163,310,8853,5532,2503,29,13,0,77
44708,25386,832,24554,20364,2156,28,349,23,129
44709,18509,627,17882,14588,1969,52,158,3,104
44710,9309,311,8998,6795,1347,26,16,6,42
44714,8923,306,8617,5952,1971,17,47,1,67
44718,12607,340,12267,10629,656,6,432,0,38
44720,40744,1177,39567,35771,1091,52,797,5,169
44721,13432,330,13102,11847,562,24,96,0,42
44730,5925,100,5825,5324,182,18,14,0,19
44802,948,18,930,907,4,1,3,1,2
44804,1127,38,1089,1041,7,1,7,0,5
44805,31238,569,30669,28904,300,47,277,26,56
44807,2264,68,2196,2122,0,1,2,1,7
44809,287,20,267,252,4,0,0,0,0
44811,12698,533,12165,11532,63,21,28,4,22
44813,8039,80,7959,7621,41,6,15,4,19
44814,2750,113,2637,2514,6,1,8,0,3
44815,679,56,623,587,3,3,4,0,2
44817,1370,61,1309,1268,2,0,5,0,0
44818,2399,35,2364,2291,9,2,1,0,4
44820,17114,238,16876,16100,121,15,84,4,26
44822,3431,29,3402,3266,10,4,8,1,14
44824,3882,135,3747,3613,7,5,7,0,3
44825,158,1,157,156,0,0,0,0,0
44826,1617,38,1579,1484,2,13,7,0,1
44827,6973,89,6884,6465,113,3,21,2,14
44828,186,15,171,157,4,0,2,0,0
44830,18442,1967,16475,14526,841,22,106,4,81
44833,16786,305,16481,15603,97,26,35,7,34
44836,2538,183,2355,2255,18,0,3,0,4
44837,4330,87,4243,4077,9,13,16,1,5
44838,258,4,254,239,0,3,1,0,0
44839,12472,374,12098,11443,109,14,79,3,10
44840,3137,39,3098,3038,4,0,2,1,11
44841,821,44,777,745,2,1,0,0,1
44842,5643,79,5564,5350,23,11,15,2,13
44843,2469,20,2449,2343,13,1,2,0,14
44844,718,18,700,681,1,0,2,0,2
44846,3322,100,3222,3077,13,7,11,0,5
44847,3488,57,3431,3308,3,3,7,1,4
44849,2162,32,2130,2064,4,4,1,0,2
44850,145,17,128,123,0,0,3,0,0
44851,5303,103,5200,4864,52,15,5,3,12
44853,1447,46,1401,1350,3,2,1,0,0
44854,1673,16,1657,1613,4,1,2,1,3
44855,1289,37,1252,1180,7,3,1,0,9
44856,95,3,92,84,0,0,0,0,0
44857,23619,1668,21951,20391,348,56,134,3,47
44859,1784,30,1754,1681,2,2,3,1,7
44861,112,3,109,106,0,0,0,1,0
44864,3182,57,3125,2937,32,12,7,0,15
44865,3164,196,2968,2863,12,5,7,2,12
44866,2372,26,2346,2241,8,5,8,2,1
44867,2280,48,2232,2131,1,1,5,1,8
44870,40416,1988,38428,28677,6479,86,322,4,189
44874,275,2,273,258,2,1,1,0,0
44875,13900,288,13612,13032,100,13,53,4,17
44878,3223,39,3184,3091,13,3,6,2,0
44880,2914,52,2862,2751,6,2,2,0,1
44881,117,2,115,110,1,0,0,0,0
44882,2617,61,2556,2479,13,1,6,1,5
44883,28690,1023,27667,25648,635,29,287,27,77
44887,958,33,925,889,4,1,2,0,1
44889,6702,159,6543,6231,18,12,13,0,18
44890,10759,1598,9161,8683,100,24,32,3,8
44901,0,0,0,0,0,0,0,0,0
44902,4891,156,4735,2781,1493,17,12,1,43
44903,25613,537,25076,20368,3043,34,145,15,120
44904,14368,265,14103,13024,298,19,136,8,44
44905,16827,371,16456,12604,3127,36,44,4,47
44906,16566,440,16126,13648,1301,37,270,5,78
44907,15014,350,14664,11970,1749,16,93,15,69
45001,927,21,906,761,62,8,1,0,4
45002,15458,289,15169,14230,186,16,99,2,38
45003,818,9,809,746,6,3,3,0,5
45005,31577,586,30991,28769,547,53,239,5,63
45011,73596,7476,66120,50209,9049,118,3060,193,277
45013,53911,1422,52489,47546,1904,98,267,22,176
45014,46169,3596,42573,29891,7737,65,2598,59,223
45015,12103,1458,10645,9021,668,20,111,56,65
45030,21234,356,20878,19737,139,36,129,4,44
45032,459,3,456,429,0,3,2,0,0
45033,323,1,322,309,1,1,1,2,0
45034,1166,24,1142,1058,13,1,29,0,7
45036,41060,1472,39588,34212,2796,57,823,6,120
45039,27529,905,26624,23787,616,24,1092,16,62
45040,57153,2342,54811,37333,2418,72,12397,107,210
45041,177,27,150,108,7,4,2,0,7
45042,26972,892,26080,23236,1253,42,182,2,88
45044,56128,4491,51637,40238,6608,90,1414,45,246
45050,12173,408,11765,10002,666,18,447,9,40
45051,393,15,378,337,34,1,0,0,0
45052,3830,40,3790,3596,17,14,10,1,6
45053,3375,40,3335,3201,7,6,5,0,6
45054,2499,53,2446,2282,11,5,11,1,5
45055,76,3,73,70,0,0,0,0,0
45056,28892,972,27920,23349,1177,45,2065,4,77
45062,775,13,762,730,2,1,0,0,2
45064,3112,23,3089,2943,10,6,8,0,15
45065,6725,252,6473,5801,155,2,170,5,24
45066,26399,718,25681,22901,602,30,942,4,94
45067,15004,386,14618,13358,298,45,95,14,46
45068,11911,233,11678,11004,75,7,109,0,19
45069,53694,2609,51085,38612,4497,56,5219,50,243
45070,151,0,151,146,0,1,0,0,0
45101,2125,46,2079,1955,24,5,6,0,2
45102,24954,673,24281,22350,408,50,221,6,66
45103,35237,820,34417,31346,720,63,628,11,95
45105,15,0,15,10,0,0,0,0,0
45106,11855,128,11727,11107,49,15,23,3,30
45107,9806,103,9703,9168,35,12,36,4,30
45111,384,6,378,292,58,0,3,0,1
45112,69,1,68,58,0,1,0,0,1
45113,3974,62,3912,3704,25,8,9,0,17
45115,217,0,217,215,0,0,0,0,1
45118,3716,43,3673,3458,12,8,5,1,7
45119,19,0,19,13,0,1,0,0,0
45120,3138,27,3111,2949,29,7,7,0,7
45121,8927,94,8833,8325,88,9,27,0,21
45122,10757,211,10546,9813,115,22,25,0,24
45123,8776,77,8699,8212,103,16,22,4,12
45130,3585,43,3542,3387,11,1,12,0,8
45131,213,0,213,199,0,1,0,0,0
45132,230,4,226,217,1,3,0,0,0
45133,23646,251,23395,21959,363,74,80,5,51
45135,4765,55,4710,4501,30,10,5,0,21
45140,56386,1735,54651,49152,927,46,2006,20,187
45142,4384,40,4344,4156,8,10,2,0,11
45144,3912,42,3870,3738,10,10,7,0,2
45146,1400,19,1381,1331,2,2,2,0,4
45147,106,2,104,84,2,1,4,0,2
45148,1539,24,1515,1468,1,3,3,2,2
45150,33735,823,32912,30171,624,47,455,18,124
45152,13617,394,13223,12334,161,16,134,1,42
45153,1826,28,1798,1682,5,5,2,0,4
45154,9439,128,9311,8830,51,13,27,0,30
45155,385,1,384,348,2,0,0,0,0
45156,63,3,60,57,0,0,0,0,0
45157,9705,205,9500,8913,84,32,22,2,29
45158,774,10,764,700,4,3,2,0,1
45159,3524,53,3471,3295,36,6,8,0,15
45160,627,12,615,583,4,0,2,0,0
45162,2730,37,2693,2543,19,2,4,4,6
45164,233,8,225,214,0,0,0,0,0
45166,83,0,83,80,0,1,0,0,0
45167,3441,41,3400,3179,77,3,9,0,4
45168,1345,10,1335,1316,0,3,0,0,0
45169,4686,60,4626,4395,22,10,5,0,23
45171,6174,44,6130,5865,31,13,6,0,15
45172,116,1,115,113,0,0,0,0,0
45174,2359,69,2290,2199,2,1,25,1,2
45176,9100,76,9024,8574,38,20,17,0,23
45177,22349,494,21855,19791,736,62,164,2,83
45202,16883,667,16216,10238,4604,22,587,8,69
45203,2365,60,2305,512,1661,1,24,1,4
45204,5818,360,5458,3236,1782,16,39,7,33
45205,19517,3751,15766,7532,6941,49,119,5,125
45206,10670,289,10381,4903,4723,15,218,4,68
45207,7484,264,7220,2381,4348,15,101,3,29
45208,18969,668,18301,16200,731,11,552,9,98
45209,10708,401,10307,8571,841,9,421,4,49
45211,37868,1467,36401,19407,14571,57,388,21,252
45212,21885,1246,20639,16006,3242,30,277,16,87
45213,12052,615,11437,6080,4491,26,194,0,63
45214,8901,358,8543,2119,5831,12,47,2,78
45215,30993,1047,29946,18153,9556,46,539,6,180
45216,9667,1660,8007,4351,2945,28,156,17,31
45217,6177,132,6045,3105,2484,16,77,4,37
45218,3957,198,3759,2861,588,7,34,0,15
45219,20644,746,19898,13483,4252,9,1274,12,74
45220,15466,532,14934,9126,2854,27,2156,5,99
45223,13174,561,12613,5772,5897,31,168,9,72
45224,20214,614,19600,7616,10864,20,179,3,95
45225,8006,292,7714,1388,5843,17,46,2,52
45226,5687,148,5539,4949,247,0,127,1,19
45227,18427,565,17862,11903,4646,24,384,10,91
45229,12540,330,12210,2320,9090,18,116,3,105
45230,27718,756,26962,23556,1583,35,446,8,86
45231,41934,1399,40535,19041,18043,79,1056,24,320
45232,7109,389,6720,1086,5064,26,45,0,56
45233,15596,203,15393,14335,407,14,87,3,52
45236,24223,869,23354,17718,2935,31,1470,24,112
45237,21029,535,20494,4760,14580,26,231,17,97
45238,46864,1659,45205,31683,10549,75,531,14,188
45239,28499,750,27749,15002,9717,55,1420,16,154
45240,28820,3047,25773,6861,15669,51,1669,66,198
45241,24380,1700,22680,18277,1453,28,1708,58,112
45242,23214,810,22404,17847,1233,13,2271,5,86
45243,15894,542,15352,13675,277,5,759,1,40
45244,28936,815,28121,25948,369,34,497,4,98
45245,20249,541,19708,17965,449,24,383,4,68
45246,15249,3312,11937,6831,3983,13,441,9,101
45247,23293,339,22954,20374,1455,7,332,3,71
45248,25181,401,24780,22940,633,16,269,8,75
45249,14005,1039,12966,9183,770,7,2130,171,54
45251,22073,963,21110,13451,5462,70,774,39,107
45252,4548,71,4477,4044,246,1,45,2,15
45255,22069,631,21438,19421,489,28,557,13,66
45267,0,0,0,0,0,0,0,0,0
45301,135,4,131,113,2,0,0,0,0
45302,4313,35,4278,4142,17,6,13,0,8
45303,2215,30,2185,2107,12,1,3,11,5
45304,7532,43,7489,7264,26,8,20,0,12
45305,11470,309,11161,9944,318,11,294,1,57
45306,2192,20,2172,2115,3,2,11,1,5
45307,269,3,266,244,5,0,0,0,2
45308,4488,45,4443,4274,14,6,6,1,19
45309,12050,183,11867,11221,108,17,96,4,22
45310,272,4,268,264,0,0,1,0,1
45311,5723,43,5680,5477,21,11,5,0,7
45312,1416,11,1405,1346,4,1,2,0,7
45314,6261,89,6172,5643,131,3,132,0,36
45315,4818,97,4721,3441,933,7,84,1,23
45316,115,0,115,105,3,0,0,1,1
45317,1018,19,999,949,4,3,0,0,5
45318,5438,54,5384,5108,40,12,13,0,40
45319,287,3,284,252,0,0,2,0,1
45320,15530,168,15362,14498,99,31,100,0,40
45321,859,7,852,827,0,0,4,0,2
45322,21185,418,20767,16566,2749,25,314,1,91
45323,5123,100,5023,4709,47,11,47,1,19
45324,40449,1490,38959,31132,3508,87,1389,43,228
45325,2558,25,2533,2401,15,2,8,1,17
45326,1170,8,1162,1132,2,0,0,2,0
45327,9388,151,9237,8748,135,8,39,0,24
45328,471,13,458,442,0,0,0,0,0
45330,830,4,826,805,2,1,1,0,0
45331,22213,389,21824,20711,189,52,134,11,67
45332,634,0,634,614,0,3,0,1,0
45333,1389,10,1379,1336,2,2,0,0,4
45334,2041,22,2019,1957,0,0,4,1,7
45335,7062,81,6981,6571,79,9,40,2,23
45336,100,1,99,94,1,0,0,0,0
45337,1519,15,1504,1465,5,3,1,0,4
45338,4950,34,4916,4733,9,5,18,1,9
45339,1169,12,1157,1126,4,2,1,0,2
45340,850,19,831,805,0,1,0,0,4
45341,3741,320,3421,3243,11,13,9,1,3
45342,37508,1271,36237,30507,2301,58,1487,14,143
45344,17042,1278,15764,14814,114,29,76,9,33
45345,5951,62,5889,5494,79,8,19,1,21
45346,2085,19,2066,1999,8,3,5,0,2
45347,4264,62,4202,4014,23,10,14,0,11
45348,968,52,916,902,1,1,0,0,5
45349,313,2,311,292,0,0,1,0,0
45350,78,0,78,77,0,0,0,0,0
45351,284,7,277,272,0,0,0,0,0
45352,183,0,183,177,0,0,0,0,0
45353,150,0,150,142,0,1,1,0,0
45354,572,35,537,503,8,0,0,0,0
45356,25106,529,24577,22183,752,25,158,8,110
45358,361,3,358,340,0,1,1,0,0
45359,1996,29,1967,1874,10,2,8,2,14
45360,300,5,295,284,5,0,1,0,3
45361,225,3,222,217,2,0,2,0,0
45362,1086,11,1075,1062,2,0,0,0,1
45363,1853,18,1835,1775,6,2,2,2,11
45365,29277,614,28663,25805,782,66,401,25,141
45368,4817,43,4774,4488,48,4,17,5,11
45369,3576,42,3534,3333,14,8,20,1,9
45370,2379,41,2338,2163,21,6,30,1,13
45371,23205,532,22673,20563,527,35,478,4,106
45372,352,5,347,323,2,0,5,1,0
45373,36863,854,36009,31955,1171,54,952,5,161
45377,15070,321,14749,13025,766,28,186,3,28
45378,402,5,397,377,2,0,0,0,1
45380,5573,44,5529,5416,4,10,9,0,7
45381,5424,41,5383,5134,22,17,10,2,22
45382,1179,11,1168,1105,1,3,4,2,5
45383,6885,74,6811,6455,35,15,20,0,19
45384,2258,15,2243,207,1942,9,4,0,48
45385,39446,969,38477,32042,3137,112,585,11,226
45387,5326,201,5125,4301,366,23,56,6,34
45388,878,6,872,860,2,0,0,0,2
45389,503,5,498,465,5,0,0,1,0
45390,3269,202,3067,2887,47,7,2,2,9
45402,10735,337,10398,2993,6657,18,138,10,62
45403,15130,2230,12900,9692,2151,46,114,6,95
45404,10730,922,9808,7210,1695,34,135,3,76
45405,18124,565,17559,4581,11762,31,79,11,146
45406,20622,485,20137,2692,16271,46,57,12,139
45409,12392,472,11920,10395,654,7,274,6,39
45410,15758,1445,14313,10822,2002,46,313,12,101
45414,20693,564,20129,15130,3389,26,342,9,119
45415,12811,292,12519,6994,4633,24,178,6,65
45416,5612,159,5453,1104,4052,11,9,0,46
45417,28079,777,27302,5023,20894,51,50,8,165
45419,16236,622,15614,13574,536,11,566,8,85
45420,25045,980,24065,20401,1531,53,504,24,117
45423,4,2,2,0,1,0,0,0,0
45424,50920,2108,48812,35309,8019,101,1793,33,302
45426,14391,259,14132,2605,10812,20,62,6,80
45428,303,11,292,210,76,0,1,0,0
45429,26514,809,25705,22670,1091,43,555,26,88
45430,7637,233,7404,6557,171,8,291,0,35
45431,26660,1554,25106,20051,1744,60,1629,13,113
45432,15105,551,14554,12783,625,36,274,4,59
45433,1567,163,1404,1025,180,0,55,5,1
45434,12628,381,12247,10727,228,10,603,3,44
45435,124,0,124,95,18,0,0,0,0
45439,11726,693,11033,8637,1360,24,343,4,54
45440,22676,798,21878,18575,1307,30,737,8,98
45449,18976,939,18037,14334,2292,29,438,9,68
45458,36474,1169,35305,28377,2123,50,3034,4,117
45459,28344,1213,27131,23428,1364,39,1063,10,121
45469,219,10,209,198,5,0,2,0,3
45501,0,0,0,0,0,0,0,0,0
45502,16767,272,16495,15275,378,38,98,7,45
45503,32870,985,31885,26982,2696,57,336,17,156
45504,17343,488,16855,14652,990,60,154,16,71
45505,19708,1196,18512,13836,3103,56,63,18,106
45506,13330,583,12747,6920,4650,39,60,13,83
45601,56849,817,56032,48853,3820,136,322,15,144
45612,5059,38,5021,4678,59,19,6,2,23
45613,3542,19,3523,3265,66,21,4,0,11
45614,4800,41,4759,4326,163,10,14,0,20
45616,1187,4,1183,1113,1,2,1,0,13
45617,76,3,73,73,0,0,0,0,0
45618,29,1,28,27,0,0,0,0,0
45619,7348,95,7253,6824,76,17,27,2,29
45620,875,3,872,820,4,0,1,0,0
45621,403,1,402,385,0,2,0,0,0
45622,485,2,483,445,4,1,3,0,0
45623,3235,24,3211,3063,24,11,9,1,1
45624,22,1,21,19,0,2,0,0,0
45628,5429,85,5344,4951,96,19,19,0,10
45629,3220,36,3184,2921,119,12,6,0,2
45630,222,1,221,205,2,0,0,0,0
45631,14200,135,14065,13046,315,19,110,0,48
45634,1893,7,1886,1802,2,3,4,0,2
45636,150,0,150,150,0,0,0,0,0
45638,20114,172,19942,18667,435,37,55,2,62
45640,15896,173,15723,14928,98,47,75,1,39
45642,35,0,35,34,0,0,0,0,0
45644,4316,24,4292,4080,18,9,4,0,6
45645,2750,9,2741,2663,8,4,1,0,3
45646,363,2,361,340,0,0,2,0,0
45647,2410,24,2386,2261,16,3,10,1,2
45648,11211,68,11143,10662,26,43,21,0,37
45650,348,0,348,331,0,4,0,0,0
45651,5691,32,5659,5466,18,11,11,0,8
45652,3131,40,3091,2941,13,12,6,0,2
45653,3907,38,3869,3654,9,17,8,1,2
45654,833,4,829,804,0,0,0,0,1
45656,6532,48,6484,6251,18,14,9,0,9
45657,2504,20,2484,2345,3,14,9,1,17
45658,2538,22,2516,2424,16,3,1,0,0
45659,2623,21,2602,2533,18,10,1,0,1
45660,8011,59,7952,7586,32,28,7,0,7
45661,7014,69,6945,6632,42,30,8,0,11
45662,27718,578,27140,24611,1073,97,152,4,123
45663,6343,86,6257,5999,10,26,12,0,12
45669,10223,111,10112,9557,102,32,106,2,8
45671,391,4,387,378,1,0,2,0,0
45672,1679,20,1659,1563,11,3,3,0,0
45673,398,3,395,366,3,3,0,0,0
45674,686,15,671,583,44,11,5,3,1
45677,73,0,73,63,0,0,0,0,0
45678,1140,21,1119,1076,1,0,3,0,3
45679,3097,26,3071,2937,4,1,3,0,2
45680,12326,170,12156,11080,448,27,26,0,22
45681,1589,11,1578,1482,6,3,1,0,4
45682,1998,15,1983,1874,11,15,7,0,7
45684,1838,7,1831,1762,1,12,4,0,2
45685,1040,18,1022,981,2,1,2,0,1
45686,3379,18,3361,3200,26,8,6,2,8
45688,403,3,400,388,2,4,0,0,0
45690,13527,132,13395,12714,81,46,52,6,14
45692,8460,77,8383,7975,22,15,17,0,6
45693,8797,71,8726,8450,30,21,14,1,6
45694,11783,148,11635,11138,42,22,51,2,9
45695,587,7,580,554,0,0,0,0,1
45696,1253,9,1244,1204,1,1,0,0,4
45697,4828,43,4785,4629,10,7,12,0,9
45698,262,0,262,250,1,0,0,0,1
45699,1236,18,1218,474,736,0,1,1,0
45701,33705,1146,32559,27633,2210,132,1110,1,150
45710,5547,48,5499,5269,19,22,16,0,33
45711,1065,14,1051,893,61,6,7,0,11
45714,10149,126,10023,9328,133,18,57,3,31
45715,2412,20,2392,2286,4,10,8,0,9
45716,490,8,482,462,0,3,1,0,0
45719,964,20,944,901,5,4,1,0,0
45720,12,0,12,8,2,0,0,0,1
45721,41,0,41,40,0,0,0,0,0
45723,3552,34,3518,3353,20,12,3,0,6
45724,1785,12,1773,1531,89,4,3,0,2
45727,478,5,473,457,0,0,0,0,1
45729,1460,16,1444,1345,13,0,3,0,2
45732,4524,20,4504,4297,53,7,3,0,12
45734,409,6,403,387,1,0,0,0,1
45735,1619,24,1595,1516,18,1,6,0,6
45739,160,0,160,155,1,1,0,0,0
45740,406,3,403,382,0,0,0,0,0
45741,809,5,804,756,1,1,0,0,1
45742,3018,24,2994,2859,29,2,8,0,10
45743,1383,4,1379,1340,4,1,2,0,1
45744,2656,25,2631,2549,5,11,3,0,1
45745,1104,11,1093,1047,0,2,2,0,1
45746,348,4,344,326,2,1,0,0,2
45750,26327,405,25922,24386,258,56,211,4,85
45760,3309,35,3274,3091,69,12,1,0,3
45761,1558,15,1543,1467,8,4,5,0,7
45764,7859,99,7760,7176,223,28,21,0,24
45766,1313,9,1304,1246,2,7,3,0,0
45767,2314,7,2307,2238,3,4,3,1,1
45768,1599,2,1597,1566,3,4,1,0,2
45769,5952,41,5911,5682,40,8,8,0,10
45770,567,8,559,540,0,0,0,0,0
45771,3408,27,3381,3273,10,6,6,0,2
45772,1697,10,1687,1634,6,3,2,0,6
45773,305,0,305,301,0,0,0,0,0
45775,1361,9,1352,1296,12,3,0,0,8
45776,730,2,728,692,4,3,1,0,1
45778,834,11,823,659,67,8,6,0,6
45779,780,3,777,752,1,0,1,0,0
45780,3328,39,3289,2932,122,9,33,0,18
45782,313,0,313,299,1,0,0,0,0
45783,181,1,180,174,0,0,0,0,2
45784,3313,30,3283,3157,23,2,6,0,4
45786,3160,26,3134,3039,5,2,3,0,3
45788,961,9,952,906,2,0,0,0,1
45789,188,1,187,176,0,1,0,0,2
45801,22819,867,21952,16144,4003,56,208,2,169
45804,14573,489,14084,9031,3879,39,78,2,106
45805,22740,847,21893,16430,3738,69,271,12,102
45806,11238,243,10995,10045,300,35,123,4,51
45807,11856,345,11511,10484,402,7,90,2,50
45808,282,13,269,246,1,0,0,0,0
45809,173,4,169,162,0,0,0,0,0
45810,7840,236,7604,7053,118,16,98,2,26
45812,1835,27,1808,1736,14,5,10,0,3
45813,3579,137,3442,3282,22,2,4,3,7
45814,2646,42,2604,2516,3,1,1,3,10
45815,57,18,39,37,0,0,0,0,0
45816,260,5,255,239,0,0,0,0,3
45817,6420,132,6288,5905,102,5,42,2,35
45819,233,2,231,229,1,0,0,0,0
45820,517,14,503,465,3,1,3,0,0
45821,1252,56,1196,1133,12,3,0,0,6
45822,19945,542,19403,18159,145,33,144,412,43
45826,358,5,353,347,0,0,0,0,4
45827,2223,29,2194,2140,4,1,1,0,1
45828,6495,122,6373,6160,21,13,12,78,12
45830,5797,194,5603,5444,8,4,9,0,10
45831,3023,119,2904,2808,5,4,2,0,2
45832,2854,109,2745,2614,12,1,6,0,3
45833,10682,364,10318,9919,50,16,23,1,18
45835,487,9,478,458,2,1,1,0,0
45836,1332,36,1296,1244,8,2,3,0,1
45838,39,0,39,38,0,0,0,0,0
45840,54901,3274,51627,46949,1160,68,1299,19,164
45841,936,20,916,893,1,0,1,0,4
45843,3768,77,3691,3574,30,3,4,1,7
45844,3251,39,3212,3167,3,2,4,1,0
45845,3270,20,3250,3214,7,0,6,0,2
45846,4461,89,4372,4279,9,9,13,5,3
45848,61,2,59,59,0,0,0,0,0
45849,1154,47,1107,1079,2,1,0,0,3
45850,3617,49,3568,3411,14,1,5,0,4
45851,676,31,645,624,4,4,0,0,2
45853,1451,23,1428,1396,4,1,2,0,15
45854,461,12,449,437,5,0,0,0,0
45855,165,12,153,139,7,0,0,0,1
45856,5094,985,4109,3989,18,7,9,0,17
45858,3038,280,2758,2607,16,6,30,0,5
45859,461,10,451,425,2,0,0,0,1
45860,2444,23,2421,2400,2,1,1,0,6
45861,223,4,219,205,2,5,1,0,0
45862,1408,22,1386,1321,6,1,0,25,3
45863,1135,32,1103,1058,11,1,5,0,3
45864,160,4,156,152,2,0,1,0,0
45865,5251,62,5189,5081,1,2,22,2,9
45866,152,2,150,145,0,0,0,0,0
45867,1138,23,1115,1071,8,1,0,0,0
45868,705,23,682,659,3,1,0,1,2
45869,4567,79,4488,4318,23,2,52,1,1
45870,116,0,116,108,0,0,1,0,0
45871,2019,32,1987,1917,18,2,4,0,5
45872,4120,276,3844,3668,23,18,4,0,7
45873,2235,126,2109,2053,2,3,7,0,4
45874,2079,66,2013,1955,8,3,0,1,2
45875,11273,769,10504,10225,46,8,30,1,13
45876,958,2,956,937,4,0,2,0,1
45877,2239,59,2180,2130,8,2,1,0,4
45879,5963,445,5518,5201,73,16,14,2,31
45880,2390,91,2299,2218,10,6,2,0,3
45881,1485,52,1433,1360,31,0,3,0,5
45882,3005,56,2949,2814,4,5,9,23,6
45883,4026,65,3961,3896,5,0,10,21,2
45884,147,1,146,135,0,0,2,0,0
45885,12863,207,12656,12029,80,21,91,28,20
45886,459,42,417,398,0,0,0,0,2
45887,4688,67,4621,4360,25,20,14,21,22
45888,188,1,187,177,0,0,1,1,0
45889,1481,38,1443,1415,1,0,5,1,1
45890,653,14,639,614,2,0,0,0,0
45891,15633,725,14908,14034,200,23,58,12,55
45893,262,12,250,245,0,0,3,0,0
45894,649,5,644,619,2,0,2,0,4
45895,17974,324,17650,16860,84,33,62,5,29
45896,1990,31,1959,1878,2,3,7,0,0
45897,107,0,107,98,0,0,0,0,3
45898,1251,10,1241,1218,2,3,4,0,1
45899,165,14,151,141,0,0,1,0,2
46001,10676,250,10426,9893,79,11,21,2,21
46011,17078,717,16361,13783,1728,27,69,3,53
46012,19108,738,18370,16041,1202,36,156,7,82
46013,18288,1013,17275,14563,1659,39,138,4,69
46016,17686,2177,15509,10596,3686,70,62,5,104
46017,5930,136,5794,5365,118,7,25,1,27
46030,3161,123,3038,2852,23,9,26,0,10
46031,2211,60,2151,2063,3,3,4,3,7
46032,50477,2707,47770,38475,1713,43,5233,10,274
46033,39002,1415,37587,31842,896,29,3234,8,123
46034,7316,129,7187,6848,39,6,25,0,22
46035,1130,22,1108,1077,3,3,3,0,1
46036,11247,393,10854,10352,15,19,49,12,25
46037,47264,2227,45037,35372,3272,56,4007,24,255
46038,42694,2445,40249,32516,2586,63,3047,9,185
46039,725,25,700,658,1,2,1,1,4
46040,16669,655,16014,13535,903,36,784,10,72
46041,24120,5875,18245,17382,159,47,58,8,29
46044,2912,65,2847,2688,11,0,9,0,4
46045,125,0,125,119,2,0,0,0,0
46047,25,0,25,24,0,0,0,0,1
46048,2035,86,1949,1768,58,7,6,1,9
46049,840,16,824,784,6,1,1,0,0
46050,1672,45,1627,1565,1,3,2,0,1
46051,2811,42,2769,2612,17,11,13,0,7
46052,22783,983,21800,20502,244,60,119,5,60
46055,14969,653,14316,11407,1607,32,489,6,61
46056,2359,53,2306,2209,5,3,7,0,14
46057,999,44,955,907,5,2,0,0,0
46058,2257,78,2179,2077,12,2,4,2,6
46060,45073,3398,41675,35595,2408,66,1308,28,220
46062,38915,1657,37258,34093,911,31,703,21,126
46063,298,20,278,268,0,0,0,0,0
46064,16908,490,16418,14444,1261,24,104,6,56
46065,3422,65,3357,3229,18,4,8,2,9
46068,2583,55,2528,2422,9,3,7,0,14
46069,7012,234,6778,6459,47,9,41,2,16
46070,2211,27,2184,2107,4,2,1,0,4
46071,3373,65,3308,3163,14,4,9,2,10
46072,9095,237,8858,8531,25,8,31,2,32
46074,42598,2744,39854,32581,1555,50,3846,23,161
46075,7728,360,7368,6065,353,14,528,4,40
46076,1534,96,1438,1396,2,1,4,0,4
46077,33969,1224,32745,28027,888,33,2328,7,127
46102,503,1,502,439,2,12,0,0,1
46103,354,6,348,324,2,1,1,0,2
46104,860,10,850,821,4,1,0,0,2
46105,1775,27,1748,1666,4,3,9,0,5
46106,8672,223,8449,7742,95,12,316,0,18
46107,12994,841,12153,10657,606,21,183,3,29
46110,505,5,500,485,5,0,1,0,0
46111,515,15,500,472,2,5,2,0,2
46112,41562,1842,39720,33920,2838,44,1002,28,174
46113,15915,921,14994,12578,1454,44,152,4,85
46115,1952,27,1925,1873,7,5,0,1,1
46117,689,26,663,646,0,0,2,0,0
46118,4903,57,4846,4639,27,8,5,1,8
46120,5891,93,5798,5445,45,17,17,6,23
46121,5090,76,5014,4785,20,6,13,1,17
46122,16448,334,16114,15126,240,27,111,4,26
46123,40788,2326,38462,30556,3787,58,2016,17,170
46124,7891,606,7285,6961,96,13,15,0,19
46125,32,1,31,27,1,0,0,0,0
46126,4613,112,4501,4333,26,8,12,0,15
46127,304,3,301,292,0,1,0,0,0
46128,2111,58,2053,1933,6,3,4,2,3
46130,2491,41,2450,2355,2,4,1,0,9
46131,32869,1166,31703,29437,492,89,313,8,133
46133,794,7,787,768,0,2,0,0,0
46135,19869,532,19337,17349,944,30,317,4,84
46140,41708,1035,40673,38229,477,57,285,19,96
46142,32052,1330,30722,27537,703,49,1026,12,127
46143,62618,2807,59811,49086,2245,83,5458,35,256
46144,207,8,199,195,0,0,1,0,0
46146,144,0,144,134,4,0,0,0,0
46147,2681,52,2629,2531,16,2,10,1,6
46148,4859,56,4803,4615,22,1,13,0,7
46149,1894,14,1880,1803,3,5,2,0,7
46150,750,3,747,730,0,1,1,0,0
46151,32335,552,31783,30335,98,77,131,4,80
46154,126,9,117,111,0,0,0,0,0
46155,81,0,81,79,0,0,0,0,0
46156,1497,19,1478,1438,3,2,0,0,5
46157,4074,80,3994,3758,32,17,18,0,10
46158,23895,419,23476,22299,74,61,111,4,60
46160,6409,111,6298,6007,26,11,16,2,12
46161,2576,55,2521,2429,15,3,5,0,5
46162,516,11,505,476,2,0,1,0,2
46163,13489,271,13218,12575,93,20,69,11,30
46164,4324,54,4270,4091,15,6,18,5,11
46165,1562,13,1549,1488,1,6,5,0,3
46166,2374,12,2362,2260,1,7,4,0,2
46167,7018,168,6850,6375,99,6,73,0,31
46168,37681,1574,36107,30531,2475,76,1300,5,177
46170,39,2,37,35,1,0,0,0,0
46171,1779,12,1767,1687,8,2,5,0,2
46172,2372,27,2345,2278,3,10,1,0,3
46173,10591,169,10422,9969,74,7,52,2,24
46175,549,7,542,523,0,5,0,1,4
46176,28401,2057,26344,24569,465,44,298,3,66
46180,993,18,975,907,3,4,4,2,5
46181,5280,74,5206,4979,12,1,19,3,12
46182,2005,49,1956,1895,6,0,5,0,7
46183,130,17,113,93,3,6,2,0,3
46184,13023,495,12528,11368,200,36,261,8,69
46186,1708,22,1686,1607,2,3,6,0,3
46201,31408,5968,25440,16241,7076,96,165,11,166
46202,22217,1518,20699,12710,5005,32,1910,3,142
46203,38224,5605,32619,24994,4988,128,380,10,225
46204,9086,481,8605,5907,1491,14,813,2,50
46205,27531,1738,25793,12733,11104,47,338,2,221
46206,6,0,6,6,0,0,0,0,0
46208,23996,1759,22237,10263,10469,37,288,15,139
46214,26314,3554,22760,10271,10820,41,331,6,136
46216,2343,176,2167,1146,832,2,65,0,21
46217,34725,1847,32878,22922,1447,51,6937,18,172
46218,30400,4269,26131,4770,19742,78,91,10,211
46219,36556,4842,31714,21465,7997,89,250,11,220
46220,36078,1667,34411,27863,4260,44,610,14,190
46221,27991,3672,24319,19981,2664,58,190,8,116
46222,37185,12766,24419,9898,12608,77,401,8,191
46224,38822,10339,28483,12217,13940,81,850,9,176
46225,6503,1001,5502,4292,672,19,64,5,44
46226,43997,7970,36027,9783,23833,75,308,16,299
46227,62126,6374,55752,36306,5381,92,11142,36,265
46228,15824,1868,13956,5796,6889,13,481,1,106
46229,29252,3242,26010,10537,13422,47,338,36,168
46231,10889,1621,9268,4858,3072,31,689,5,84
46234,27841,2658,25183,17632,5143,51,858,8,169
46235,34569,6780,27789,6168,19818,54,272,21,192
46236,27627,3555,24072,17544,4477,21,574,17,97
46237,44378,3298,41080,32149,2050,67,4751,27,160
46239,33290,2451,30839,21340,6325,48,1350,11,137
46240,20148,1744,18404,14740,2030,23,778,10,99
46241,33568,7052,26516,19201,5323,91,259,8,133
46250,19156,1545,17611,12524,3532,36,545,3,141
46254,40162,7586,32576,7774,22177,46,923,20,292
46256,22598,1390,21208,15829,3526,23,677,5,91
46259,13703,506,13197,11599,335,26,635,3,98
46260,34188,4139,30049,15529,11716,52,1244,10,222
46268,26353,3895,22458,8734,11461,41,928,4,169
46278,8910,727,8183,5082,2306,8,336,5,66
46280,7870,388,7482,6442,314,6,348,1,29
46290,191,9,182,148,9,0,11,0,4
46301,580,18,562,527,8,0,3,0,2
46302,141,15,126,121,0,0,0,0,0
46303,17028,1499,15529,14540,88,22,82,3,35
46304,26835,2379,24456,22352,503,41,405,3,100
46307,69248,8036,61212,52845,4045,75,1539,17,203
46310,14126,1059,13067,12395,68,11,36,1,19
46311,22431,2964,19467,17212,837,15,692,2,58
46312,26370,13864,12506,1600,10375,39,57,7,73
46319,18108,3322,14786,11026,2806,24,146,1,62
46320,14514,5304,9210,1996,6674,27,36,3,75
46321,23894,3722,20172,16343,1456,25,1517,5,56
46322,23984,4469,19515,16411,1793,22,415,2,67
46323,22510,7931,14579,7787,5546,27,320,6,102
46324,22611,8096,14515,7814,5753,32,148,4,67
46327,11078,6817,4261,2682,1290,16,42,8,30
46340,1085,34,1051,1027,4,1,1,0,1
46341,10518,798,9720,9140,115,12,30,0,21
46342,32540,6643,25897,21874,2212,55,285,10,97
46345,97,5,92,88,0,0,0,0,0
46346,1317,72,1245,1027,87,1,2,0,0
46347,4800,209,4591,4375,13,1,8,0,20
46348,1127,51,1076,1023,11,0,2,1,4
46349,3219,147,3072,2874,8,4,6,0,7
46350,44522,3869,40653,37041,1184,90,318,6,190
46356,18668,1369,17299,16266,127,24,57,2,47
46360,44209,3052,41157,28581,9472,118,372,10,211
46365,1037,41,996,927,3,0,0,0,4
46366,5826,272,5554,5306,16,11,11,1,13
46368,39837,7359,32478,25844,4292,98,393,16,101
46371,3680,150,3530,3362,11,7,6,0,4
46373,17839,1980,15859,14416,502,30,303,0,55
46374,1006,38,968,924,1,4,2,0,2
46375,24051,3247,20804,17423,1574,30,897,5,59
46376,367,15,352,332,3,0,0,0,3
46377,194,4,190,177,0,1,0,0,0
46379,295,37,258,240,1,1,2,1,0
46381,287,13,274,244,2,0,0,0,0
46382,2094,67,2027,1919,9,5,6,0,5
46383,41981,3693,38288,34347,1282,65,688,11,189
46385,41832,3773,38059,34744,915,45,579,21,130
46390,2824,95,2729,2580,5,10,10,1,15
46391,9077,578,8499,7075,1080,12,45,0,39
46392,7855,393,7462,7075,19,19,15,5,9
46393,376,34,342,326,3,0,0,0,0
46394,11725,5432,6293,5422,465,10,88,2,26
46402,5502,372,5130,167,4738,7,5,2,34
46403,11649,804,10845,2069,8186,5,42,0,68
46404,15658,679,14979,223,14284,30,11,2,55
46405,11860,3795,8065,6794,604,23,35,1,53
46406,8776,1333,7443,1639,5445,14,11,5,32
46407,9862,361,9501,220,8897,8,14,0,71
46408,15109,1977,13132,4412,7838,56,70,0,130
46409,6975,636,6339,493,5572,7,5,2,27
46410,39471,5694,33777,11504,20036,64,581,6,121
46501,3891,209,3682,3540,7,9,5,0,13
46502,34,2,32,28,0,0,1,0,1
46504,3241,150,3091,2942,17,0,30,0,6
46506,10083,1341,8742,8440,23,13,48,1,13
46507,9371,751,8620,7900,163,30,131,1,24
46508,137,4,133,129,0,2,0,0,0
46510,3393,136,3257,3152,9,7,5,0,1
46511,4008,120,3888,3586,42,9,33,2,26
46513,64,9,55,55,0,0,0,0,0
46514,42048,6252,35796,30002,2546,113,682,10,163
46516,33670,9305,24365,17773,4498,64,295,10,176
46517,24006,6867,17139,13521,2291,51,186,11,79
46524,2376,88,2288,2212,6,4,6,0,5
46526,33170,8859,24311,22075,675,28,482,8,103
46528,27223,5650,21573,20039,373,42,258,7,88
46530,31805,1295,30510,25968,1018,64,2034,25,149
46531,1387,25,1362,1315,1,5,3,0,0
46532,1751,77,1674,1579,13,3,4,2,3
46534,11247,431,10816,10301,23,31,13,1,19
46536,3257,114,3143,2941,43,9,12,0,9
46537,502,37,465,446,2,2,2,0,1
46538,4047,199,3848,3710,13,5,22,3,12
46539,2245,117,2128,2052,3,4,9,0,1
46540,12552,365,12187,11687,51,13,76,4,31
46542,4526,485,4041,3857,25,19,21,0,2
46543,4273,146,4127,4060,6,2,3,0,7
46544,31571,1660,29911,25557,1965,98,350,11,128
46545,26312,1715,24597,19150,2769,94,1030,16,100
46550,12679,680,11999,11607,56,15,41,0,16
46552,6478,203,6275,5892,52,10,20,0,12
46553,3849,279,3570,3462,14,9,13,0,5
46554,4379,165,4214,3994,10,8,17,0,21
46555,2729,72,2657,2524,5,4,17,0,5
46556,8845,875,7970,6591,358,31,612,18,35
46561,14155,652,13503,12029,492,28,222,18,27
46562,4718,295,4423,4137,23,15,31,0,17
46563,22977,3327,19650,18656,119,29,155,3,44
46565,9104,164,8940,8800,10,5,17,0,7
46567,9773,451,9322,8886,43,17,54,4,24
46570,1090,27,1063,1023,1,3,3,0,4
46571,6203,92,6111,6018,7,3,17,0,4
46572,112,5,107,100,0,0,0,0,0
46573,3835,102,3733,3538,40,3,25,1,15
46574,8377,295,8082,7614,43,27,27,1,7
46580,22381,2880,19501,17920,294,51,436,3,83
46582,14151,2081,12070,10774,168,12,666,4,53
46590,5053,449,4604,4296,84,11,56,0,6
46595,94,2,92,84,2,0,0,0,0
46601,5947,637,5310,2300,2598,17,45,1,35
46613,11427,3028,8399,4595,2821,35,75,10,80
46614,29917,2412,27505,22601,2946,71,295,19,192
46615,14777,1298,13479,9468,2573,65,268,11,87
46616,6167,656,5511,3354,1585,20,71,1,40
46617,9813,785,9028,6654,1462,11,352,7,70
46619,20527,7083,13444,8077,4368,56,107,5,73
46624,38,0,38,37,0,0,0,0,0
46628,27011,2908,24103,13792,8404,73,347,15,126
46635,6420,411,6009,4815,661,6,184,0,28
46637,15887,985,14902,11714,1607,65,584,4,151
46701,7687,226,7461,7126,53,14,25,0,20
46702,2172,72,2100,1988,4,7,7,1,1
46703,18837,1015,17822,16809,188,38,149,1,57
46704,119,5,114,98,1,1,1,0,0
46705,1716,56,1660,1559,13,6,3,1,2
46706,19995,564,19431,18572,96,22,160,9,41
46710,4649,121,4528,4304,21,10,15,0,19
46711,8022,281,7741,7538,9,6,45,0,19
46714,15411,631,14780,14040,179,30,92,5,23
46721,4907,162,4745,4578,19,12,12,0,6
46723,7383,187,7196,6901,21,19,19,0,14
46725,23917,606,23311,22232,115,56,143,3,54
46730,1316,31,1285,1230,3,2,1,2,2
46731,578,12,566,558,0,3,0,0,0
46732,2949,523,2426,2337,6,7,9,2,2
46733,18669,1149,17520,16738,156,53,73,5,25
46737,6898,168,6730,6497,20,7,27,0,21
46738,8183,251,7932,7529,30,12,29,24,11
46740,4608,144,4464,4417,5,9,8,0,0
46741,4657,90,4567,4425,21,4,8,0,4
46742,3259,54,3205,3101,11,3,4,1,2
46743,2309,43,2266,2185,14,2,8,0,6
46745,1792,29,1763,1678,13,4,7,1,2
46746,4003,465,3538,3390,21,10,10,0,2
46747,2743,45,2698,2610,5,2,5,1,13
46748,7203,238,6965,6221,146,11,276,1,24
46750,26580,816,25764,24432,181,116,132,6,59
46755,15721,744,14977,14059,90,26,104,0,46
46759,508,6,502,483,1,1,3,0,1
46760,1264,137,1127,1091,3,1,9,0,1
46761,12902,876,12026,11716,38,21,19,0,7
46763,1702,21,1681,1638,6,2,1,0,4
46764,1379,34,1345,1265,6,2,8,0,6
46765,5580,172,5408,5139,60,9,21,1,17
46766,545,12,533,522,0,1,0,0,0
46767,8599,3419,5180,4950,33,8,40,1,4
46770,2734,38,2696,2595,12,3,10,0,3
46771,54,4,50,48,0,0,0,0,0
46772,3929,49,3880,3827,2,12,6,0,6
46773,3685,79,3606,3484,7,1,10,2,9
46774,17341,662,16679,15293,534,36,101,5,42
46776,1528,94,1434,1376,5,9,4,0,1
46777,6348,266,6082,5844,35,6,25,0,12
46778,196,3,193,190,0,0,0,0,1
46779,2006,48,1958,1890,8,1,2,0,2
46781,789,18,771,750,0,0,1,0,0
46783,7521,234,7287,6835,124,21,70,0,24
46784,2211,42,2169,2113,3,6,10,0,0
46785,1650,37,1613,1568,1,0,2,0,0
46786,82,4,78,64,2,0,1,0,0
46787,3902,60,3842,3685,13,18,7,0,8
46788,3396,63,3333,3250,12,3,8,0,6
46789,80,8,72,71,0,0,0,0,0
46791,922,29,893,875,1,2,0,0,0
46792,3673,64,3609,3500,7,4,9,1,8
46793,4043,92,3951,3783,10,13,11,3,11
46794,1406,84,1322,1276,5,0,4,0,6
46795,6190,119,6071,5874,13,11,9,0,15
46796,57,23,34,29,0,3,0,0,1
46797,4008,63,3945,3776,14,6,9,1,16
46798,1290,35,1255,1177,17,2,4,0,2
46799,448,19,429,408,0,2,1,0,1
46802,10664,1789,8875,6239,1775,38,215,5,55
46803,9686,2134,7552,2853,3758,26,191,11,107
46804,28800,1556,27244,23281,1665,48,975,13,121
46805,21138,1639,19499,14606,2384,58,1135,11,111
46806,26083,6516,19567,4756,10375,48,3038,8,163
46807,16489,2914,13575,8970,2563,41,800,7,102
46808,19894,2256,17638,14370,1576,49,382,22,99
46809,8946,745,8201,6586,958,52,83,6,41
46814,16377,746,15631,12900,836,26,1094,7,56
46815,27927,1605,26322,20747,2964,44,949,3,172
46816,19012,1894,17118,6296,5689,31,4218,2,152
46818,22071,1547,20524,17659,967,102,655,9,108
46819,8969,742,8227,6283,1309,32,133,0,38
46825,29062,2142,26920,21027,2468,69,1782,12,165
46835,36653,1990,34663,28905,2761,104,1080,7,193
46845,28380,1053,27327,24569,641,24,953,3,116
46901,38072,1489,36583,30570,3540,105,228,5,175
46902,36038,1375,34663,29053,2815,90,749,9,115
46910,3283,515,2768,2658,11,7,5,0,4
46911,1396,18,1378,1332,12,9,7,0,0
46913,1400,48,1352,1306,3,0,2,0,4
46914,4785,185,4600,3264,1232,13,9,0,26
46915,617,7,610,597,0,0,1,0,1
46917,1734,35,1699,1652,5,6,1,0,0
46919,2202,82,2120,2009,4,2,7,0,0
46920,1131,32,1099,1064,3,0,2,0,6
46922,32,1,31,27,3,0,0,0,0
46923,8162,478,7684,7341,61,19,22,0,30
46926,1639,27,1612,1531,0,16,3,0,0
46928,4557,90,4467,4257,19,5,3,4,10
46929,3210,98,3112,2998,36,0,5,0,6
46930,268,6,262,246,0,0,1,0,0
46931,286,5,281,275,0,0,0,0,0
46932,3254,89,3165,3026,9,15,13,0,16
46933,6617,242,6375,5918,67,31,33,0,21
46936,5800,108,5692,5418,44,10,22,0,12
46937,114,2,112,103,3,0,0,0,1
46938,2824,85,2739,2583,24,4,8,1,6
46939,1917,27,1890,1791,18,4,6,0,10
46940,2538,63,2475,2354,12,6,11,0,2
46941,1123,22,1101,1063,2,10,0,0,1
46943,250,13,237,227,3,0,1,0,0
46945,15,1,14,12,0,0,0,0,0
46946,132,2,130,122,1,0,2,0,1
46947,28295,6281,22014,19962,536,88,537,6,49
46950,615,34,581,570,3,0,1,0,2
46951,2118,37,2081,1978,2,13,5,0,0
46952,18996,1030,17966,15430,1263,43,223,4,56
46953,22781,1670,21111,16318,3111,53,158,12,123
46957,483,2,481,464,1,0,0,0,0
46958,542,14,528,502,2,5,1,0,0
46959,148,2,146,138,0,0,4,0,1
46960,1102,67,1035,937,31,1,6,0,1
46961,97,3,94,86,0,0,2,0,2
46962,8592,373,8219,7841,51,22,54,4,12
46965,111,9,102,82,8,0,1,0,0
46967,73,2,71,62,1,2,0,0,0
46968,132,6,126,124,0,0,0,0,0
46970,23317,815,22502,20570,512,217,94,5,73
46971,0,0,0,0,0,0,0,0,0
46974,1620,51,1569,1501,4,5,6,1,2
46975,14288,521,13767,13063,107,51,66,0,29
46978,2018,49,1969,1891,5,1,7,0,0
46979,4893,119,4774,4493,36,9,34,5,8
46980,53,2,51,48,0,0,1,0,1
46982,2602,110,2492,2414,5,4,8,0,4
46984,61,4,57,56,0,0,1,0,0
46985,1285,19,1266,1219,0,2,5,0,4
46986,1769,46,1723,1648,13,8,6,0,1
46987,1010,37,973,939,8,0,0,0,1
46988,721,50,671,652,0,1,3,0,0
46989,5028,141,4887,4524,51,10,87,1,16
46990,805,10,795,771,0,5,3,0,2
46991,1706,42,1664,1599,12,3,1,0,6
46992,16183,361,15822,15011,88,81,85,3,45
46994,2626,154,2472,2347,6,5,8,1,7
46996,6830,225,6605,6278,36,4,26,1,9
46998,129,9,120,116,0,0,1,0,0
47001,10208,157,10051,9539,57,17,27,1,27
47003,958,11,947,896,5,6,5,1,1
47006,12761,332,12429,11801,40,19,186,0,32
47010,304,3,301,279,0,0,0,0,3
47011,1003,22,981,932,0,4,3,0,0
47012,9994,82,9912,9611,9,9,23,0,12
47016,742,11,731,712,0,1,0,0,4
47017,657,11,646,629,0,0,2,0,1
47018,4273,57,4216,4076,3,6,12,0,6
47020,1004,5,999,974,0,5,1,0,2
47021,12,0,12,9,0,0,0,0,0
47022,3192,31,3161,3029,7,8,1,0,14
47023,1711,18,1693,1648,0,0,2,0,1
47024,2880,17,2863,2781,2,5,2,0,3
47025,23118,368,22750,21339,200,26,124,4,87
47030,1504,10,1494,1433,0,5,0,1,1
47031,5200,55,5145,4905,13,4,25,0,7
47032,3477,46,3431,3272,5,4,15,3,13
47033,6,0,6,5,0,0,0,0,0
47034,172,2,170,167,0,0,1,0,1
47035,272,1,271,259,0,0,0,0,1
47036,1002,6,996,966,2,2,1,0,0
47037,4167,22,4145,4024,8,4,12,0,6
47038,1168,13,1155,1106,4,0,1,0,2
47040,5288,59,5229,5023,16,9,28,0,12
47041,5891,157,5734,5510,11,12,9,0,10
47042,4375,52,4323,4138,12,11,14,0,4
47043,5102,64,5038,4840,10,11,14,0,6
47060,7109,53,7056,6738,18,4,27,1,20
47102,6884,149,6735,6429,30,6,18,3,10
47104,93,0,93,91,0,0,0,0,0
47106,4771,131,4640,4403,21,15,20,2,8
47108,2218,35,2183,2115,7,3,8,0,6
47110,469,17,452,421,4,3,1,0,0
47111,16972,865,16107,14645,430,23,122,6,59
47112,17404,568,16836,15859,114,34,109,7,58
47114,422,8,414,385,2,1,3,0,0
47115,2579,67,2512,2404,2,12,7,0,3
47116,698,9,689,638,0,1,1,0,0
47117,4304,62,4242,4022,10,4,9,1,13
47118,3253,34,3219,3085,6,9,11,1,2
47119,12173,326,11847,11131,94,16,175,1,37
47120,938,16,922,881,3,0,0,0,7
47122,11185,218,10967,10369,61,18,100,1,23
47123,131,1,130,123,2,0,0,0,0
47124,4981,74,4907,4646,47,5,37,0,14
47125,1714,30,1684,1616,3,2,4,0,3
47126,4555,76,4479,4235,31,4,5,5,12
47129,19739,2601,17138,14263,1530,51,154,6,68
47130,48481,2968,45513,34497,6837,106,713,95,269
47135,1271,32,1239,1153,6,9,4,1,4
47136,4699,73,4626,4453,14,3,35,1,7
47137,1300,32,1268,1240,1,3,1,0,0
47138,4398,90,4308,4157,21,7,8,4,4
47140,2811,38,2773,2645,7,3,3,0,7
47141,1563,37,1526,1432,13,3,8,2,1
47142,861,9,852,805,1,1,1,7,3
47143,3800,106,3694,3463,28,4,29,1,6
47145,1908,19,1889,1809,10,4,1,0,1
47147,1022,25,997,970,1,0,1,0,0
47150,49395,2395,47000,39248,4036,133,624,15,167
47160,138,6,132,124,0,0,1,0,1
47161,3764,52,3712,3543,21,11,9,0,7
47162,906,15,891,864,5,0,0,0,0
47163,1551,48,1503,1423,7,4,4,0,12
47164,3609,70,3539,3390,22,5,10,2,7
47165,6208,102,6106,5825,24,24,14,3,13
47166,1276,14,1262,1223,0,6,5,0,1
47167,15683,198,15485,14823,65,35,62,6,39
47170,14877,329,14548,13930,56,21,64,4,26
47172,19821,1058,18763,17167,393,38,279,13,64
47174,124,0,124,123,0,1,0,0,0
47175,870,8,862,835,0,0,3,0,0
47177,1462,26,1436,1369,9,0,7,0,5
47201,45969,4120,41849,34603,1135,90,4068,28,159
47203,27006,2555,24451,21579,578,29,1279,16,94
47220,5737,116,5621,5422,20,6,13,0,1
47223,1437,24,1413,1349,9,4,2,0,3
47224,606,10,596,583,0,1,0,0,2
47225,65,0,65,63,1,0,0,0,0
47226,205,9,196,179,8,1,2,0,0
47227,1545,23,1522,1496,2,2,0,0,1
47229,3186,75,3111,3005,2,4,11,0,3
47230,2057,39,2018,1931,3,8,4,0,2
47231,1091,15,1076,1022,5,4,4,1,1
47232,2460,82,2378,2261,28,6,9,0,9
47234,1428,20,1408,1346,11,0,0,0,7
47235,1780,32,1748,1700,4,1,1,0,1
47236,131,3,128,116,0,0,0,0,0
47240,21940,560,21380,20442,80,24,153,7,33
47243,6037,261,5776,5374,135,17,30,4,35
47244,688,17,671,647,2,0,1,0,2
47246,4343,84,4259,4069,10,5,17,0,14
47247,178,6,172,163,0,1,0,1,2
47250,22596,751,21845,20412,355,42,253,5,63
47260,1733,31,1702,1624,9,1,3,0,3
47263,174,0,174,169,0,0,0,0,0
47264,1302,18,1284,1223,4,4,7,0,3
47265,20074,735,19339,18487,147,30,40,2,35
47270,758,16,742,727,2,0,0,0,2
47272,1852,24,1828,1752,4,0,2,0,16
47273,1917,40,1877,1820,5,0,2,0,4
47274,33035,5988,27047,25152,449,54,440,5,86
47280,867,57,810,766,10,3,7,0,1
47281,1543,20,1523,1473,0,4,3,0,0
47282,236,4,232,211,1,1,0,0,0
47283,3526,45,3481,3362,7,11,7,1,1
47302,25704,629,25075,20903,2536,71,52,6,106
47303,24069,968,23101,18992,2568,53,204,14,114
47304,30366,1084,29282,25326,1707,30,834,21,102
47305,3629,130,3499,2630,571,11,20,4,38
47306,4628,335,4293,3562,518,1,105,1,7
47320,3978,45,3933,3766,23,14,14,0,8
47324,150,3,147,138,0,0,0,0,1
47325,571,5,566,543,3,0,0,0,2
47326,2321,52,2269,2241,0,0,1,2,2
47327,4345,64,4281,4085,21,8,13,0,11
47330,5523,99,5424,5131,30,8,34,2,21
47331,22782,269,22513,21425,275,31,57,2,47
47334,3171,63,3108,2933,45,1,17,0,4
47335,610,7,603,576,1,0,1,0,2
47336,3455,65,3390,3244,18,6,5,4,2
47337,182,8,174,154,1,0,2,0,0
47338,2680,34,2646,2565,10,12,3,0,2
47339,641,8,633,612,3,0,0,0,4
47340,2744,39,2705,2605,6,6,0,0,4
47341,2191,9,2182,2106,16,0,4,0,5
47342,2533,54,2479,2400,7,5,3,2,2
47344,123,1,122,120,1,0,1,0,0
47345,1378,14,1364,1296,5,5,8,0,1
47346,3865,50,3815,3649,13,8,23,0,4
47348,9507,199,9308,8852,42,29,19,0,28
47351,429,11,418,408,0,0,0,0,0
47352,902,19,883,862,2,0,4,0,3
47353,5576,56,5520,5338,14,16,28,7,7
47354,1072,18,1054,996,5,4,12,0,2
47355,2546,47,2499,2408,11,4,2,0,11
47356,5831,95,5736,5497,33,12,22,1,7
47357,1107,16,1091,1050,8,0,2,0,4
47358,919,19,900,855,2,3,3,0,2
47359,2744,48,2696,2565,10,13,5,0,2
47360,1451,13,1438,1377,5,1,3,0,1
47361,134,6,128,122,0,0,1,0,0
47362,30184,723,29461,27290,1000,47,137,4,85
47366,57,2,55,52,0,0,0,0,0
47367,98,3,95,95,0,0,0,0,0
47368,2637,37,2600,2518,16,1,10,0,1
47369,1216,16,1200,1174,3,3,0,0,0
47370,158,4,154,149,3,0,0,0,0
47371,12143,789,11354,10965,31,14,49,6,22
47373,2015,28,1987,1925,5,2,9,0,0
47374,45304,2208,43096,36693,2921,108,621,10,275
47380,1917,30,1887,1816,1,1,4,1,3
47381,139,2,137,132,0,1,0,0,0
47382,136,1,135,125,5,2,0,0,0
47383,2724,25,2699,2593,20,5,1,1,3
47384,1936,27,1909,1850,2,1,12,0,0
47385,1581,13,1568,1523,5,6,2,1,1
47386,1085,12,1073,1037,3,1,0,0,5
47387,726,11,715,698,0,0,0,0,0
47388,292,1,291,284,0,0,1,0,0
47390,5061,746,4315,4104,44,16,3,0,17
47392,100,4,96,85,1,0,0,0,0
47393,1745,16,1729,1667,4,5,0,0,9
47394,8064,230,7834,7435,39,14,43,0,15
47396,7446,148,7298,6777,115,14,121,8,30
47401,41225,1786,39439,32514,1289,57,3480,9,163
47403,33066,1569,31497,26978,1533,74,1008,7,133
47404,23799,1241,22558,19479,910,30,777,12,115
47405,305,14,291,230,14,6,27,0,6
47406,7924,482,7442,6044,400,5,737,4,27
47408,22917,1033,21884,17602,787,27,2260,2,72
47420,176,3,173,165,0,0,3,0,0
47421,27798,510,27288,26010,147,78,143,4,55
47424,8893,127,8766,8370,22,22,39,0,17
47427,1082,4,1078,1045,4,1,3,0,2
47429,7485,147,7338,6878,66,14,56,2,14
47431,1316,18,1298,1231,2,5,1,0,4
47432,4429,97,4332,3957,111,18,26,4,12
47433,3974,74,3900,3696,22,8,3,2,7
47434,19,0,19,19,0,0,0,0,0
47435,7,0,7,7,0,0,0,0,0
47436,1440,32,1408,1342,6,3,4,0,4
47437,91,0,91,86,0,1,0,0,0
47438,4032,60,3972,3849,4,6,4,0,9
47441,8972,174,8798,8493,11,14,33,4,1
47443,1134,33,1101,1040,3,6,9,0,2
47445,90,0,90,89,0,0,0,0,0
47446,9425,153,9272,8911,19,22,34,0,11
47448,7816,141,7675,7238,31,9,41,1,29
47449,482,13,469,443,0,1,7,0,1
47451,1177,8,1169,1108,10,3,1,0,2
47452,5285,62,5223,5074,18,10,4,0,3
47453,366,9,357,338,0,0,0,0,0
47454,7684,115,7569,7199,39,6,26,5,16
47455,55,0,55,49,0,2,0,0,0
47456,1302,12,1290,1216,5,0,4,0,3
47457,25,0,25,25,0,0,0,0,0
47458,34,3,31,22,1,0,0,0,1
47459,3346,36,3310,3147,8,9,4,0,17
47460,11560,177,11383,10755,36,21,40,0,29
47462,4850,92,4758,4517,16,17,21,0,14
47464,198,4,194,188,0,1,0,0,0
47465,666,10,656,639,2,0,3,0,1
47467,34,0,34,33,0,0,0,0,0
47468,1180,16,1164,1125,6,9,1,1,1
47469,1782,19,1763,1641,32,2,6,1,1
47470,1516,22,1494,1412,1,8,8,0,10
47471,2567,69,2498,2428,1,12,0,0,1
47501,18003,1991,16012,14694,595,22,101,6,48
47512,4002,91,3911,3739,19,11,9,1,16
47513,2057,60,1997,1956,0,3,5,0,2
47514,1647,26,1621,1271,332,0,0,0,3
47515,819,11,808,761,0,3,0,0,0
47516,1246,22,1224,1185,3,0,5,1,1
47519,556,2,554,548,0,0,2,0,0
47520,3230,24,3206,3055,15,3,8,0,19
47521,972,9,963,945,0,0,1,0,2
47522,250,9,241,221,0,4,4,0,1
47523,3433,398,3035,2956,15,6,7,0,0
47524,494,5,489,467,1,0,1,0,1
47525,337,2,335,327,1,0,0,0,0
47527,1918,34,1884,1843,3,0,5,1,7
47528,519,9,510,499,0,0,2,0,0
47529,1004,11,993,962,3,1,4,0,5
47531,906,9,897,878,0,1,2,1,1
47532,4507,70,4437,4369,4,5,14,1,4
47535,582,3,579,572,1,0,0,0,0
47537,782,20,762,735,3,0,0,0,2
47541,1228,36,1192,1138,5,3,3,0,2
47542,9992,1794,8198,7848,56,12,34,0,23
47546,22445,2121,20324,19546,123,33,183,4,48
47550,797,9,788,772,1,0,3,0,1
47551,592,1,591,574,0,0,2,0,2
47552,174,3,171,158,0,0,1,0,0
47553,8625,42,8583,8376,12,9,19,3,1
47557,1329,12,1317,1276,2,0,3,1,0
47558,5021,23,4998,4940,11,0,8,0,4
47561,1514,39,1475,1410,7,3,1,0,5
47562,4994,39,4955,4849,7,14,13,2,7
47564,1375,29,1346,1329,0,2,2,0,0
47567,5804,73,5731,5555,19,22,10,0,5
47568,848,29,819,791,1,1,1,0,12
47573,31,0,31,31,0,0,0,0,0
47574,148,2,146,144,0,0,0,1,0
47575,1015,19,996,977,0,0,0,0,1
47576,378,1,377,359,1,0,4,0,0
47577,1222,17,1205,1107,23,3,26,0,3
47578,649,11,638,620,2,0,1,0,2
47579,2715,70,2645,2561,13,6,13,0,3
47580,252,3,249,243,0,0,0,0,0
47581,3534,45,3489,3331,8,7,9,3,9
47584,154,2,152,138,0,2,0,0,0
47585,429,16,413,393,2,0,1,0,0
47586,11027,131,10896,10460,49,25,81,2,19
47588,591,16,575,540,0,2,0,0,2
47590,779,9,770,745,3,0,0,0,3
47591,24984,798,24186,22347,659,53,262,9,79
47596,191,1,190,190,0,0,0,0,0
47597,961,15,946,904,2,0,0,1,0
47598,3107,36,3071,2954,6,11,2,0,3
47601,14088,199,13889,13283,95,24,53,2,23
47610,5442,127,5315,4957,43,9,37,3,17
47611,1157,11,1146,1107,3,6,3,0,0
47612,868,32,836,781,5,3,7,1,3
47613,2694,33,2661,2553,5,4,4,0,5
47615,1477,26,1451,1380,16,2,5,0,1
47616,305,6,299,279,0,0,3,0,3
47619,1535,19,1516,1449,3,5,2,0,3
47620,12989,266,12723,11924,167,23,63,1,39
47630,38309,988,37321,33334,889,52,1534,6,132
47631,1908,15,1893,1842,7,4,5,0,2
47633,2455,29,2426,2337,12,8,12,1,3
47634,2193,32,2161,2064,7,7,2,0,7
47635,5178,84,5094,4869,47,12,11,0,10
47637,1396,10,1386,1346,2,1,6,0,3
47638,3620,22,3598,3494,3,4,6,0,3
47639,4549,45,4504,4407,12,8,7,0,1
47640,950,16,934,897,1,4,2,0,4
47648,4510,81,4429,4177,26,10,32,8,22
47649,1374,12,1362,1293,10,5,7,0,3
47654,41,2,39,35,0,0,0,0,0
47660,4762,90,4672,4453,54,11,10,1,20
47665,3798,90,3708,3491,39,2,17,0,5
47666,1332,18,1314,1227,25,3,7,0,6
47670,11934,322,11612,10417,471,18,131,7,54
47683,83,1,82,76,0,0,0,0,0
47708,501,10,491,388,64,5,14,0,0
47710,18470,599,17871,15037,1542,31,93,36,70
47711,31266,1047,30219,26255,1906,55,382,73,67
47712,24895,531,24364,22435,654,32,254,14,71
47713,9916,547,9369,4398,4073,28,47,62,87
47714,32827,1685,31142,22662,5576,88,289,340,179
47715,28959,1313,27646,21916,3148,66,807,122,147
47720,17188,328,16860,15913,159,8,80,15,41
47725,19220,278,18942,17419,355,21,459,15,51
47802,34229,1317,32912,27309,2804,139,992,5,162
47803,21832,609,21223,18498,986,42,635,4,87
47804,10093,207,9886,8522,634,35,38,2,54
47805,12875,198,12677,11883,208,12,70,4,40
47807,12063,572,11491,8503,1835,41,200,7,112
47809,2360,155,2205,1488,556,0,35,0,124
47831,17,0,17,14,0,0,0,0,0
47832,919,5,914,883,1,1,0,0,0
47833,1043,12,1031,961,4,4,3,0,2
47834,19430,357,19073,18174,118,33,80,6,30
47836,36,1,35,35,0,0,0,0,0
47837,1186,13,1173,1136,1,2,2,0,0
47838,3931,123,3808,2913,837,9,4,3,8
47840,1420,14,1406,1357,4,0,5,0,2
47841,2135,51,2084,2015,1,5,3,0,8
47842,9790,105,9685,9294,31,20,30,11,9
47845,177,3,174,163,0,0,0,0,7
47846,661,3,658,643,0,2,0,0,1
47847,1014,5,1009,985,0,0,0,0,1
47848,1523,12,1511,1467,4,1,4,0,0
47849,407,5,402,392,1,0,1,0,1
47850,2389,30,2359,2269,9,4,2,1,3
47851,14,2,12,10,0,0,0,0,0
47853,184,9,175,163,2,0,3,0,0
47854,850,8,842,818,3,0,1,0,1
47855,680,16,664,637,0,2,0,1,2
47857,443,15,428,415,5,2,0,0,0
47858,628,4,624,599,2,0,0,1,0
47859,1096,9,1087,1058,0,4,0,0,0
47860,243,9,234,230,0,0,0,0,0
47861,556,3,553,528,5,0,0,0,1
47862,1548,53,1495,1436,8,7,4,0,3
47863,146,2,144,138,0,0,0,0,0
47865,25,2,23,21,0,1,0,0,0
47866,443,3,440,422,0,2,5,0,2
47868,2776,27,2749,2599,11,5,8,0,6
47869,116,5,111,100,2,0,2,0,1
47870,6,1,5,5,0,0,0,0,0
47871,235,0,235,219,0,7,0,2,0
47872,8075,98,7977,7633,179,18,16,0,7
47874,3161,36,3125,3027,12,17,9,0,1
47875,6,0,6,6,0,0,0,0,0
47876,348,18,330,282,19,0,7,0,14
47879,2908,26,2882,2778,6,7,0,2,3
47880,61,1,60,60,0,0,0,0,0
47881,332,7,325,308,4,0,1,0,0
47882,8487,124,8363,7922,16,20,21,1,10
47884,214,1,213,204,0,0,1,0,0
47885,9231,107,9124,8737,23,32,15,0,18
47901,3750,298,3452,2604,493,18,116,0,18
47904,16571,2380,14191,11348,1571,53,293,4,100
47905,41787,4836,36951,31162,3007,56,861,1,199
47906,73579,5056,68523,48016,2867,120,11723,26,318
47907,17,0,17,6,0,0,8,0,0
47909,42759,5708,37051,31375,3091,74,584,7,124
47916,66,1,65,59,0,0,0,0,0
47917,436,135,301,294,0,0,2,0,0
47918,5802,146,5656,5405,23,15,9,3,4
47920,2665,76,2589,2436,25,12,5,0,14
47921,1115,246,869,835,7,0,1,2,6
47922,1482,196,1286,1214,1,1,5,0,11
47923,3597,80,3517,3362,15,8,14,2,6
47924,187,2,185,179,0,0,2,0,0
47925,94,8,86,73,1,0,0,0,2
47926,1132,37,1095,1057,3,0,1,2,1
47928,1723,12,1711,1655,2,3,8,0,3
47929,805,18,787,729,2,0,2,0,0
47930,1053,69,984,901,3,11,5,0,11
47932,5271,93,5178,4987,24,6,23,1,4
47933,28092,2033,26059,24571,295,55,207,8,57
47940,1438,30,1408,1341,5,0,3,0,10
47941,1309,114,1195,1124,10,1,1,0,3
47942,668,29,639,618,2,0,0,0,2
47943,914,281,633,604,2,0,1,0,3
47944,3561,121,3440,3305,17,6,7,3,15
47946,1892,101,1791,1694,4,9,3,2,1
47948,1279,72,1207,1135,4,3,4,1,5
47949,1245,28,1217,1161,0,6,1,0,1
47950,878,37,841,807,4,1,2,0,2
47951,2061,182,1879,1794,8,8,7,0,3
47952,2628,45,2583,2478,0,8,3,1,1
47954,2267,51,2216,2154,11,7,5,2,0
47955,993,26,967,910,9,2,3,0,1
47957,1759,88,1671,1590,5,6,4,0,0
47958,172,4,168,162,0,0,0,0,0
47959,2843,1122,1721,1639,10,4,0,0,2
47960,15029,1163,13866,13222,78,31,61,1,18
47963,1937,105,1832,1727,3,2,6,0,5
47964,114,4,110,101,0,1,3,0,0
47965,539,10,529,513,0,0,3,0,0
47966,418,3,415,399,0,0,3,0,0
47967,746,13,733,677,4,0,4,0,5
47968,967,17,950,922,6,3,1,3,0
47969,217,2,215,186,0,0,2,0,0
47970,1955,91,1864,1792,5,5,7,0,6
47971,1819,51,1768,1705,13,5,1,1,0
47974,1106,26,1080,1035,1,3,3,0,4
47975,682,24,658,639,0,0,3,0,2
47977,2235,88,2147,2047,14,2,8,3,4
47978,10815,761,10054,9624,42,26,32,2,12
47980,1103,40,1063,1003,7,2,10,0,2
47981,911,39,872,826,5,0,2,0,2
47982,120,2,118,112,0,0,0,0,0
47983,274,6,268,257,1,0,0,0,1
47986,54,0,54,54,0,0,0,0,0
47987,3802,149,3653,3504,11,9,7,1,14
47989,1277,40,1237,1198,6,4,1,0,2
47990,1629,70,1559,1471,5,2,8,0,0
47991,1051,16,1035,1006,0,3,6,0,2
47992,1425,45,1380,1316,8,2,7,0,3
47993,3983,77,3906,3775,5,2,14,0,3
47994,507,10,497,475,4,1,1,0,1
47995,1651,51,1600,1532,3,8,11,1,2
47997,116,1,115,112,0,0,0,0,0
48001,11721,171,11550,10945,20,50,23,0,51
48002,3115,82,3033,2912,5,7,18,0,2
48003,6506,310,6196,5863,14,16,27,0,32
48005,5318,87,5231,4985,15,12,28,0,0
48006,3895,63,3832,3707,18,4,8,0,3
48009,21817,734,21083,18589,586,29,926,1,94
48014,4323,492,3831,3671,9,10,10,0,4
48015,8552,261,8291,5318,1934,39,469,4,42
48017,11353,353,11000,10000,178,14,244,15,35
48021,34244,812,33432,13251,17937,77,355,6,197
48022,2515,69,2446,2363,7,6,10,0,0
48023,4967,132,4835,4513,65,18,10,2,8
48025,14878,477,14401,12169,1037,19,560,0,63
48026,14726,401,14325,11895,1322,46,313,4,32
48027,3180,52,3128,2942,57,8,6,0,9
48028,921,3,918,890,1,5,2,0,2
48030,14983,654,14329,11087,1810,70,245,1,60
48032,2193,47,2146,2067,7,3,11,0,6
48033,17207,314,16893,3137,12733,51,255,7,100
48034,14480,307,14173,2681,10250,22,685,3,94
48035,34018,1081,32937,22666,7623,68,748,5,118
48036,22517,683,21834,15596,4639,57,301,7,95
48038,44038,1245,42793,34687,5169,69,1122,7,122
48039,7485,151,7334,6947,31,32,22,0,23
48040,9994,302,9692,9184,67,23,75,1,25
48041,4332,74,4258,4028,34,9,22,0,6
48042,33398,852,32546,29567,920,24,819,8,73
48043,15665,601,15064,10137,3772,44,87,2,106
48044,58265,2007,56258,47475,3707,75,2379,11,143
48045,24341,750,23591,19642,2504,60,255,1,86
48047,39775,1019,38756,34814,1597,89,393,12,99
48048,10561,583,9978,7409,1783,53,59,2,36
48049,5523,169,5354,5048,37,14,14,1,15
48050,1553,21,1532,1474,2,1,1,0,1
48051,17718,779,16939,14360,1325,32,190,5,27
48054,7213,127,7086,6776,38,15,27,0,7
48059,15319,500,14819,13790,213,36,145,1,34
48060,39775,2166,37609,31434,2983,232,233,8,152
48062,9375,399,8976,8357,65,12,22,44,37
48063,4112,98,4014,3794,20,16,13,0,15
48064,3993,140,3853,3671,10,13,8,0,17
48065,11228,543,10685,9950,178,25,41,0,26
48066,47789,1325,46464,32321,9944,149,881,12,210
48067,24589,950,23639,21120,604,40,792,4,74
48069,2627,77,2550,2335,41,1,31,0,5
48070,6388,146,6242,5874,45,1,75,0,36
48071,28468,1032,27436,21647,2201,73,1990,1,112
48072,15194,442,14752,13408,341,15,266,0,38
48073,33658,1193,32465,28235,1493,41,1088,9,135
48074,9608,301,9307,8694,100,21,38,0,21
48075,22967,504,22463,4629,16669,24,281,16,186
48076,26062,673,25389,6924,16613,44,602,9,172
48079,12553,260,12293,11584,68,33,103,0,45
48080,22272,730,21542,17690,2476,48,315,3,105
48081,20496,538,19958,18242,627,26,190,5,41
48082,16029,370,15659,14143,634,37,109,6,44
48083,24074,1022,23052,15259,1272,28,5593,0,75
48084,16364,592,15772,8558,637,39,5973,1,53
48085,26507,808,25699,17617,974,29,6020,7,137
48088,23142,522,22620,17810,2616,49,1103,2,76
48089,32012,967,31045,16593,10877,93,1462,8,157
48091,32267,1011,31256,16364,7635,109,5283,16,185
48092,27186,544,26642,18116,3013,50,4347,0,98
48093,24780,519,24261,16985,4038,43,2108,0,113
48094,20340,1257,19083,17780,252,24,281,0,62
48095,5585,102,5483,5182,33,4,81,0,14
48096,3780,105,3675,3515,4,10,18,0,10
48097,5181,135,5046,4860,6,8,12,0,4
48098,20349,532,19817,12359,539,12,6202,1,47
48101,28664,3482,25182,22357,1123,78,350,11,81
48103,55605,3193,52412,40533,2949,66,5103,28,290
48104,41588,2501,39087,28909,1628,53,6146,17,246
48105,38883,1731,37152,22315,1915,38,10580,6,231
48108,26639,1741,24898,15311,3677,61,4116,11,152
48109,8008,411,7597,5738,884,3,460,38,109
48111,44055,1838,42217,27520,11002,125,824,9,175
48114,21222,522,20700,19409,112,59,216,6,89
48116,26942,775,26167,24701,121,63,265,15,60
48117,10154,291,9863,9126,195,30,23,3,33
48118,13309,367,12942,11951,161,26,196,0,48
48120,8338,139,8199,6423,661,3,623,0,73
48122,12825,2481,10344,7969,1323,37,159,0,80
48124,34134,2220,31914,27985,1693,58,620,12,117
48125,22070,1886,20184,15783,2593,117,285,4,118
48126,55863,1007,54856,49225,1763,35,1355,2,313
48127,41222,1255,39967,34163,3498,45,770,3,143
48128,11641,574,11067,10251,229,11,185,2,46
48130,16469,561,15908,14744,103,24,321,2,65
48131,8126,225,7901,7433,70,11,42,1,17
48133,5500,293,5207,4785,69,15,32,1,8
48134,23829,1488,22341,18848,1595,67,528,6,76
48135,27380,1193,26187,22589,1621,96,306,6,90
48137,4957,117,4840,4582,29,11,18,1,7
48138,10788,438,10350,9655,61,14,227,0,34
48139,179,8,171,157,1,0,0,0,0
48140,3082,56,3026,2877,8,1,6,0,4
48141,26088,798,25290,4562,18984,83,197,3,153
48143,74,1,73,71,0,0,0,0,0
48144,10331,355,9976,9445,52,12,99,1,25
48145,3332,114,3218,3016,4,3,14,1,8
48146,40245,10380,29865,23652,3693,136,208,24,200
48150,26573,1000,25573,22447,1074,83,635,4,76
48152,31098,1130,29968,25086,1962,39,1584,3,133
48154,37864,1353,36511,32709,1452,67,792,2,113
48157,1382,51,1331,1204,19,7,2,0,1
48158,7362,217,7145,6773,30,22,41,0,26
48159,2566,55,2511,2248,83,14,11,0,17
48160,14097,670,13427,11322,1222,62,123,0,45
48161,26571,1302,25269,21731,1590,101,176,7,113
48162,29156,1505,27651,24715,1132,81,266,2,82
48164,9676,480,9196,8144,398,25,95,1,48
48165,8832,411,8421,7206,150,10,603,1,33
48166,13170,587,12583,11374,291,52,53,0,70
48167,25071,926,24145,19443,1213,34,2465,8,113
48168,24517,807,23710,17197,606,19,4969,2,71
48169,20336,427,19909,18816,58,45,134,2,54
48170,41069,1387,39682,35677,725,52,1600,2,126
48173,13443,646,12797,11244,559,48,216,3,43
48174,33683,1718,31965,16350,12639,97,697,12,200
48176,22833,1048,21785,19424,368,30,839,5,70
48177,232,2,230,228,0,0,0,0,0
48178,36858,1157,35701,32228,429,77,1347,3,129
48179,3239,109,3130,2912,48,13,14,0,11
48180,63409,5006,58403,40464,12567,220,1351,22,256
48182,21886,798,21088,19855,152,34,141,5,63
48183,42447,2599,39848,34197,2436,144,1070,1,120
48184,17776,872,16904,11017,4147,76,368,3,121
48185,49730,2044,47686,31315,10848,161,2896,8,248
48186,35690,1816,33874,22958,7656,143,786,4,113
48187,52498,1922,50576,34021,4863,86,9058,5,223
48188,46161,1827,44334,26304,5686,84,10090,6,200
48189,14038,447,13591,12398,298,56,117,1,46
48190,163,5,158,148,4,0,1,0,0
48191,3980,132,3848,3239,297,12,26,0,26
48192,25058,1791,23267,21342,467,87,128,7,79
48193,16110,914,15196,12269,1405,52,695,1,60
48195,30014,2743,27271,22544,2283,109,759,6,122
48197,67895,4903,62992,38334,15572,172,4224,62,426
48198,40067,2708,37359,19925,13141,102,1099,14,266
48201,14500,376,14124,3613,8654,38,1212,8,118
48202,17260,448,16812,4147,11174,40,695,7,83
48203,22168,420,21748,1465,19174,72,91,16,130
48204,21738,719,21019,456,19662,40,28,0,126
48205,34056,511,33545,1149,31079,52,284,4,130
48206,15712,323,15389,1104,13534,28,74,3,92
48207,21704,521,21183,3855,16009,45,508,6,83
48208,8090,388,7702,1330,5934,20,62,1,73
48209,27096,20333,6763,3955,2016,87,49,2,58
48210,27155,15790,11365,5895,4527,66,98,1,109
48211,5447,100,5347,2525,2407,12,91,1,19
48212,43192,482,42710,18344,8739,58,13140,7,234
48213,19088,224,18864,483,17699,65,39,4,69
48214,18959,351,18608,2577,15114,41,144,4,98
48215,10520,218,10302,897,8998,23,44,0,43
48216,5031,1344,3687,1545,1809,16,54,3,31
48217,6437,773,5664,205,5171,20,1,3,39
48218,7271,1270,6001,2008,3519,29,11,0,40
48219,46811,665,46146,2198,42042,107,112,3,273
48220,21564,881,20683,15749,3272,36,421,3,117
48221,38204,552,37652,2343,33791,45,134,7,214
48223,22956,450,22506,1421,20161,68,49,2,121
48224,39633,574,39059,2367,35282,59,86,5,154
48225,15862,297,15565,4144,10629,39,138,0,64
48226,6307,415,5892,3282,1907,17,398,5,34
48227,40266,450,39816,605,37810,76,27,12,205
48228,53893,3823,50070,8323,39298,142,158,4,280
48229,9258,1681,7577,2696,4240,35,31,1,61
48230,17559,565,16994,14922,972,38,377,0,49
48233,6,2,4,0,0,0,3,0,0
48234,31442,433,31009,876,29055,65,38,7,121
48235,45188,469,44719,557,42626,93,61,1,216
48236,31286,853,30433,25448,3183,35,668,8,111
48237,29560,648,28912,10721,16328,47,434,10,195
48238,25747,366,25381,379,24106,52,35,2,105
48239,36814,1287,35527,13219,20119,79,326,10,186
48240,17962,790,17172,8786,7020,66,126,6,107
48242,0,0,0,0,0,0,0,0,0
48243,0,0,0,0,0,0,0,0,0
48301,14993,407,14586,12521,636,19,851,6,63
48302,17196,473,16723,12739,1010,23,2183,3,100
48304,17437,514,16923,13477,1161,13,1619,2,87
48306,28455,1174,27281,22304,688,23,3057,5,86
48307,44673,2364,42309,31333,1606,103,7240,9,155
48309,31541,1350,30191,23833,1513,37,3517,4,92
48310,43709,803,42906,33726,2462,63,5088,4,76
48312,34854,818,34036,26717,3313,48,2543,3,104
48313,34169,929,33240,28642,1869,43,1345,5,97
48314,21614,725,20889,17064,1065,46,1959,1,60
48315,28597,745,27852,24369,1172,38,1224,6,50
48316,28192,997,27195,24711,629,41,817,0,79
48317,27864,1058,26806,22536,1353,61,1498,4,116
48320,4328,268,4060,3591,166,14,82,2,10
48322,32188,641,31547,21332,5794,27,3262,15,173
48323,18225,370,17855,14090,1630,23,1317,2,87
48324,16872,510,16362,13330,1325,9,925,2,60
48326,22228,1683,20545,12614,3311,50,3332,16,143
48327,21811,1406,20405,17536,1223,46,503,6,66
48328,24178,2571,21607,18107,1842,62,360,9,100
48329,24391,1574,22817,20483,691,60,377,3,44
48331,22091,664,21427,14615,3217,22,2805,4,74
48334,18731,466,18265,11351,4207,20,1909,8,94
48335,25618,689,24929,11305,3799,51,8816,5,112
48336,26802,1118,25684,17674,4862,44,1719,5,136
48340,26039,7590,18449,7539,8570,83,819,7,130
48341,16980,2168,14812,4203,9466,53,280,5,77
48342,18685,3714,14971,2806,10985,40,312,1,88
48346,23058,1367,21691,19590,570,54,422,8,56
48348,25655,1014,24641,22629,367,56,384,5,118
48350,7581,323,7258,6743,76,15,88,1,29
48353,6422,204,6218,5796,39,21,48,3,22
48356,8380,183,8197,7736,27,20,39,0,11
48357,8459,251,8208,7749,54,19,51,0,16
48359,9939,883,9056,7547,394,10,549,1,43
48360,12480,612,11868,10075,353,10,864,2,36
48362,15001,647,14354,13227,194,30,217,5,40
48363,7361,267,7094,6334,118,12,346,0,13
48367,4567,144,4423,4143,33,14,33,0,14
48370,1741,46,1695,1596,13,6,13,0,8
48371,25272,1047,24225,22258,283,35,346,17,78
48374,18008,658,17350,10044,752,27,5737,0,91
48375,23237,969,22268,12652,1634,27,6988,6,99
48377,19691,904,18787,11432,2252,20,4279,20,85
48380,7373,212,7161,6743,51,22,93,6,16
48381,13794,423,13371,12308,160,38,147,0,66
48382,23334,710,22624,20575,414,41,502,6,85
48383,13171,417,12754,11755,211,37,109,1,50
48386,17904,702,17202,15738,285,48,258,0,46
48390,24273,1048,23225,19793,973,39,1330,8,79
48393,20257,1125,19132,14129,2671,60,1307,2,113
48401,1385,36,1349,1269,8,1,5,0,0
48410,97,6,91,91,0,0,0,0,0
48411,219,13,206,184,1,0,0,0,1
48412,5497,188,5309,5017,15,24,16,1,10
48413,7138,199,6939,6670,37,26,58,1,9
48414,2361,74,2287,2180,1,17,13,0,8
48415,9042,363,8679,8192,63,32,36,0,6
48416,4906,184,4722,4487,11,17,8,0,11
48417,2612,123,2489,2352,28,6,3,0,0
48418,4389,80,4309,4110,0,17,13,2,18
48419,2381,118,2263,2150,2,9,7,0,5
48420,21771,728,21043,19470,400,80,55,3,21
48421,6656,190,6466,6045,19,28,37,1,18
48422,6130,452,5678,5361,18,18,11,0,19
48423,33801,1342,32459,29285,1013,118,204,17,84
48426,895,38,857,825,3,0,0,0,2
48427,2599,127,2472,2371,1,8,9,0,4
48428,4897,115,4782,4553,16,8,15,0,7
48429,8445,185,8260,7771,11,34,26,7,20
48430,39594,1252,38342,35886,324,96,335,11,94
48432,607,18,589,570,0,0,5,0,2
48433,26688,949,25739,22563,1591,96,306,8,83
48434,104,7,97,86,0,1,0,0,0
48435,2075,53,2022,1891,11,7,5,1,8
48436,3758,115,3643,3410,20,15,14,1,6
48437,619,46,573,509,26,3,0,0,7
48438,7074,193,6881,6500,34,14,47,1,21
48439,51719,2035,49684,39451,5715,119,1791,10,184
48440,192,9,183,171,0,0,4,0,0
48441,3837,51,3786,3619,0,21,42,3,0
48442,21803,848,20955,19049,453,57,211,3,48
48444,9420,1612,7808,7356,45,17,42,5,44
48445,1355,12,1343,1286,3,1,4,0,3
48446,30788,1041,29747,27265,778,118,174,1,81
48449,2945,68,2877,2721,18,5,8,0,3
48450,4199,142,4057,3936,12,4,11,0,1
48451,16033,443,15590,14590,108,43,78,0,46
48453,4956,199,4757,4518,19,17,9,0,20
48454,1263,33,1230,1167,2,8,1,0,2
48455,8166,234,7932,7507,25,27,44,0,10
48456,782,15,767,757,1,1,3,0,0
48457,8186,310,7876,7226,128,38,11,2,12
48458,19699,847,18852,12626,4989,90,67,5,47
48460,2341,32,2309,2224,8,8,2,0,6
48461,8302,277,8025,7624,29,23,5,0,28
48462,13080,413,12667,11789,92,25,128,0,50
48463,4423,116,4307,3981,66,17,12,1,11
48464,2077,87,1990,1850,1,7,5,0,1
48465,575,28,547,532,0,1,4,0,0
48466,1514,61,1453,1385,10,5,2,0,3
48467,2228,100,2128,2061,7,1,3,1,1
48468,1234,46,1188,1167,0,0,1,0,1
48469,1198,32,1166,1117,2,4,3,0,3
48470,760,9,751,732,0,1,3,0,0
48471,5668,175,5493,5237,60,7,15,2,22
48472,1691,64,1627,1571,4,8,0,0,9
48473,22035,621,21414,19050,1079,44,144,14,65
48475,2691,48,2643,2584,5,3,3,0,2
48476,706,14,692,673,0,0,0,0,0
48502,1478,122,1356,708,550,1,31,6,7
48503,21743,1045,20698,7800,11245,82,156,4,140
48504,24266,764,23502,5980,15967,68,88,5,114
48505,17685,550,17135,2044,14157,71,29,5,105
48506,25069,1836,23233,18342,3060,114,99,11,100
48507,30149,1448,28701,17928,8435,133,195,7,108
48509,9568,469,9099,7922,495,29,36,0,23
48519,7825,330,7495,6051,1014,30,47,0,23
48529,9560,567,8993,7163,1120,56,40,0,32
48532,19247,642,18605,9591,7508,81,305,8,91
48601,32165,3822,28343,8406,18242,98,69,12,126
48602,27613,4606,23007,13963,7111,94,151,10,202
48603,27492,2262,25230,19496,3152,45,1367,45,117
48604,12386,1243,11143,9339,1100,24,141,4,116
48607,1456,231,1225,356,800,2,21,0,3
48609,12082,645,11437,10835,133,22,97,3,15
48610,3266,67,3199,3022,6,12,6,0,17
48611,6482,162,6320,5999,22,15,30,0,13
48612,9135,219,8916,8521,28,41,26,0,20
48613,1037,20,1017,965,3,5,0,0,0
48614,1226,29,1197,1139,1,6,7,0,4
48615,2917,146,2771,2671,7,5,5,0,6
48616,7458,345,7113,6825,33,12,20,0,16
48617,8902,210,8692,8242,32,68,31,0,32
48618,5299,136,5163,4866,17,58,14,0,12
48619,523,13,510,480,1,2,1,0,0
48620,99,4,95,83,0,0,0,0,1
48621,1282,13,1269,1226,1,1,0,0,0
48622,6364,126,6238,5916,18,46,13,0,24
48623,15105,603,14502,12943,855,45,157,4,34
48624,15739,261,15478,14820,42,48,48,0,29
48625,12993,254,12739,12049,79,82,31,0,27
48626,5962,208,5754,5531,11,3,6,1,14
48627,164,4,160,145,0,0,0,1,0
48628,1864,29,1835,1721,4,9,7,0,5
48629,7420,144,7276,6963,18,29,29,3,5
48630,227,6,221,207,2,3,2,0,0
48631,4260,112,4148,3928,19,20,19,0,13
48632,4987,108,4879,4593,15,29,11,0,6
48633,305,13,292,277,1,2,0,0,0
48634,4152,124,4028,3841,11,11,10,0,9
48635,1471,43,1428,1362,1,3,3,0,6
48636,812,12,800,749,3,8,1,0,6
48637,3120,132,2988,2854,10,10,6,0,13
48638,13199,1380,11819,9419,1588,21,225,3,69
48640,31840,1029,30811,28045,402,85,633,39,128
48642,33457,1188,32269,28952,508,102,1013,44,145
48647,4004,91,3913,3750,3,20,2,0,4
48649,1634,76,1558,1490,4,1,4,0,0
48650,6807,205,6602,6233,31,30,10,0,20
48651,4396,61,4335,4111,6,23,18,0,1
48652,1679,17,1662,1572,1,13,4,0,2
48653,9598,177,9421,8987,30,35,24,6,22
48654,2284,42,2242,2123,3,9,6,1,8
48655,6033,254,5779,5462,28,18,4,2,17
48656,3857,75,3782,3557,8,18,9,1,20
48657,7686,138,7548,7158,16,26,24,0,21
48658,4871,88,4783,4440,15,67,18,1,2
48659,2640,42,2598,2477,7,20,5,0,8
48661,10535,206,10329,9833,34,55,42,4,17
48662,1439,76,1363,1300,12,1,0,0,3
48701,1268,92,1176,1094,9,9,4,0,4
48703,3073,55,3018,2864,5,19,7,0,5
48705,500,4,496,482,0,4,1,0,0
48706,39381,2137,37244,34802,480,122,265,0,80
48708,25860,2481,23379,20857,798,105,113,0,85
48710,0,0,0,0,0,0,0,0,0
48720,1041,31,1010,982,1,3,1,0,5
48721,398,15,383,361,1,1,0,1,0
48722,3137,247,2890,2469,272,4,9,0,13
48723,11953,522,11431,10681,92,44,56,0,21
48724,431,95,336,249,50,0,0,0,1
48725,1983,30,1953,1885,4,10,1,0,0
48726,6206,188,6018,5808,15,17,15,4,10
48727,1168,33,1135,1087,3,2,2,1,0
48728,284,6,278,249,0,2,1,0,0
48729,1521,31,1490,1430,1,4,2,1,5
48730,4443,116,4327,4101,10,14,48,0,6
48731,1568,86,1482,1424,6,0,7,0,5
48732,11177,538,10639,9920,195,31,71,0,14
48733,1657,87,1570,1504,5,2,0,0,6
48734,7350,226,7124,6807,54,22,66,0,9
48735,898,31,867,835,0,1,0,1,2
48737,1104,14,1090,1042,1,7,0,0,0
48738,1163,9,1154,1104,0,7,0,0,2
48739,3636,40,3596,3457,5,16,2,0,7
48740,2378,32,2346,2216,14,24,8,0,10
48741,1941,41,1900,1808,3,8,1,1,3
48742,1701,21,1680,1612,2,6,0,0,7
48743,54,0,54,53,1,0,0,0,0
48744,4525,110,4415,4216,8,13,6,0,17
48745,1170,16,1154,1106,4,9,2,0,4
48746,8163,181,7982,7562,28,29,20,0,7
48747,1453,39,1414,1351,8,7,5,0,4
48748,1678,30,1648,1562,10,10,10,0,0
48749,1118,22,1096,1057,5,5,1,0,0
48750,8978,324,8654,8088,102,34,53,3,33
48754,978,21,957,925,1,2,4,0,0
48755,3077,92,2985,2900,8,3,11,0,11
48756,4057,74,3983,3714,14,30,5,3,17
48757,3511,115,3396,3262,14,10,14,0,6
48759,3266,98,3168,3057,6,8,6,0,2
48760,1285,45,1240,1119,31,5,7,2,5
48761,852,22,830,781,1,7,1,0,0
48762,1080,9,1071,1031,1,2,2,0,1
48763,4949,68,4881,4615,29,23,37,0,12
48765,742,21,721,683,4,3,1,0,1
48766,1158,28,1130,1067,4,11,1,0,1
48767,2008,46,1962,1886,1,6,4,0,1
48768,9648,365,9283,8616,200,25,28,0,44
48770,1848,31,1817,1734,5,18,2,0,1
48801,13006,1422,11584,10629,312,49,112,24,34
48806,1580,61,1519,1473,1,11,2,0,6
48807,779,28,751,718,2,1,1,0,0
48808,5830,268,5562,5048,113,7,66,2,22
48809,11245,537,10708,10107,60,50,34,1,24
48811,8137,615,7522,5505,1857,24,36,1,10
48813,21068,981,20087,18878,214,52,130,1,56
48815,2297,95,2202,2109,4,8,14,0,5
48816,102,2,100,96,0,0,0,0,0
48817,5714,155,5559,5244,17,25,20,0,15
48818,2302,81,2221,2139,4,6,5,1,5
48819,2601,77,2524,2367,1,18,10,0,2
48820,17944,869,17075,15772,265,40,233,5,59
48821,5987,286,5701,5094,186,24,105,1,25
48822,2814,137,2677,2535,25,2,27,1,6
48823,51793,3044,48749,36695,3815,103,5413,29,237
48824,2216,104,2112,1259,582,0,231,6,0
48825,12127,518,11609,7993,2736,59,632,16,29
48827,15889,748,15141,14123,165,32,83,1,41
48829,3426,179,3247,3050,21,21,20,2,5
48831,3320,160,3160,3016,5,6,10,0,12
48832,1386,63,1323,1284,1,3,0,0,7
48834,2284,95,2189,2072,11,4,9,0,3
48835,2573,65,2508,2424,4,6,10,0,5
48836,14183,433,13750,12899,42,59,71,12,53
48837,19189,903,18286,16732,366,44,272,5,60
48838,18801,846,17955,16903,98,59,86,14,53
48840,12665,753,11912,10328,384,35,507,1,66
48841,798,21,777,731,3,3,7,1,3
48842,21548,1370,20178,16610,1553,64,685,7,90
48843,47704,1526,46178,43176,281,107,454,61,125
48845,937,32,905,875,1,2,0,0,7
48846,22470,1531,20939,17127,3024,94,80,3,24
48847,5886,395,5491,5240,24,15,12,2,16
48848,7771,229,7542,7090,31,36,28,0,26
48849,5904,308,5596,5313,32,14,24,0,18
48850,4563,158,4405,4189,28,13,4,0,13
48851,2394,81,2313,2186,10,13,10,0,3
48852,137,4,133,130,0,0,0,0,0
48853,545,7,538,526,2,0,0,0,0
48854,19804,945,18859,17300,358,32,221,8,61
48855,16656,471,16185,15265,56,39,143,7,40
48856,830,82,748,726,0,2,1,0,0
48857,2521,68,2453,2274,17,8,12,0,5
48858,41844,2245,39599,32833,1737,1696,1029,15,138
48859,2424,125,2299,1897,261,8,28,1,10
48860,1309,46,1263,1212,10,3,5,0,3
48861,1544,48,1496,1418,4,3,1,1,3
48862,48,4,44,41,0,2,1,0,0
48864,22804,965,21839,14433,1096,42,5067,2,93
48865,1756,119,1637,1585,0,3,4,0,0
48866,4728,175,4553,4279,37,15,9,1,32
48867,27596,1006,26590,25045,173,70,136,6,58
48870,132,11,121,106,0,1,1,0,0
48871,1994,72,1922,1866,7,8,2,0,0
48872,7390,174,7216,6703,40,25,43,5,39
48873,1535,72,1463,1409,1,2,4,0,1
48874,158,4,154,151,0,0,0,0,0
48875,10582,308,10274,9795,53,31,28,1,24
48876,4419,269,4150,3766,61,10,45,0,17
48877,2300,85,2215,2113,8,10,2,0,3
48878,1586,46,1540,1397,14,66,2,1,3
48879,17980,813,17167,16225,82,60,84,3,35
48880,10495,736,9759,7574,1827,58,30,1,31
48881,5438,158,5280,5021,20,17,22,0,15
48883,6842,273,6569,6193,36,82,21,0,14
48884,4305,143,4162,3984,8,11,14,0,1
48885,960,26,934,894,1,2,5,0,1
48886,2062,62,2000,1898,2,11,3,1,4
48888,6258,212,6046,5794,28,7,23,0,13
48889,1450,70,1380,1310,2,6,0,0,2
48890,2073,92,1981,1877,12,2,6,1,5
48891,2828,73,2755,2630,17,8,4,0,10
48892,4763,114,4649,4343,14,21,26,1,9
48893,5400,152,5248,4879,10,92,24,0,9
48894,2364,48,2316,2258,5,6,4,0,2
48895,11472,405,11067,10343,80,40,91,0,53
48896,152,3,149,137,0,1,0,0,0
48897,1470,57,1413,1345,2,1,5,0,5
48906,25674,3743,21931,15956,3385,147,576,9,202
48910,33702,4492,29210,19381,5799,156,1098,13,216
48911,40566,4927,35639,18346,11798,124,2402,11,211
48912,17155,1928,15227,10859,2463,86,608,8,135
48915,9176,1347,7829,4167,2624,34,274,4,56
48917,32679,3156,29523,21427,4503,92,1637,4,110
48933,2467,305,2162,1303,536,29,104,1,22
49001,21730,3175,18555,11881,4580,89,202,7,115
49002,19553,938,18615,16157,822,67,454,9,107
49004,16358,726,15632,12676,1640,40,169,3,90
49006,25119,1558,23561,16666,4261,73,965,5,161
49007,10353,708,9645,4020,4661,43,173,1,79
49008,18343,1202,17141,13423,2024,47,454,8,202
49009,47188,2038,45150,36215,4331,114,2000,5,202
49010,18183,745,17438,16048,290,91,110,7,84
49011,2147,61,2086,1968,10,26,2,0,5
49012,3477,98,3379,3134,31,5,21,3,9
49013,5175,1089,4086,3546,225,66,18,4,10
49014,21505,1311,20194,16828,1654,111,274,7,87
49015,28008,1762,26246,19614,2331,145,2431,6,111
49017,21377,1259,20118,16028,2440,115,158,0,111
49021,6136,165,5971,5657,37,26,22,0,11
49022,30143,2061,28082,10949,15443,119,122,12,129
49024,30332,1303,29029,23891,1662,89,1791,2,121
49026,2170,148,2022,1888,36,1,1,1,8
49027,171,36,135,116,3,2,0,0,1
49028,6129,699,5430,5126,29,30,27,0,12
49029,1724,30,1694,1608,11,16,6,0,3
49030,2711,167,2544,2396,7,15,8,0,6
49031,7728,235,7493,6088,709,47,75,2,75
49032,3033,72,2961,2764,35,9,18,3,10
49033,1763,49,1714,1634,15,5,5,0,4
49034,2313,98,2215,2071,17,9,10,0,25
49036,24632,1559,23073,20877,1024,61,183,4,55
49037,21427,1453,19974,12283,5349,100,630,7,113
49038,8979,448,8531,7690,185,57,42,4,38
49040,3404,52,3352,3223,12,1,7,1,1
49042,4641,252,4389,4147,31,13,20,0,12
49043,2056,697,1359,789,433,8,13,2,9
49045,5256,663,4593,4168,76,57,20,1,20
49046,7080,213,6867,6451,19,39,13,0,15
49047,14541,1094,13447,10962,990,357,58,7,72
49048,25067,1744,23323,15733,5089,120,380,7,119
49050,1552,32,1520,1456,4,11,4,0,4
49051,2340,55,2285,2162,5,13,12,1,6
49052,1056,55,1001,895,10,50,2,0,6
49053,7371,213,7158,6481,192,23,51,0,40
49055,6211,294,5917,5540,53,24,16,3,13
49056,3913,614,3299,2962,99,16,3,3,17
49057,6226,1829,4397,3913,73,112,12,1,28
49058,19422,666,18756,17727,54,59,76,4,74
49060,1847,63,1784,1673,1,7,5,0,2
49061,1704,33,1671,1542,25,7,12,0,12
49063,52,0,52,48,2,0,0,0,0
49064,3854,673,3181,2907,28,26,4,1,4
49065,6974,540,6434,5990,58,28,30,2,18
49066,710,12,698,664,6,5,2,0,1
49067,4440,144,4296,4009,40,16,5,0,14
49068,14325,524,13801,13003,134,47,80,1,47
49070,2510,87,2423,2308,6,7,10,0,3
49071,10748,377,10371,9453,149,32,124,2,49
49072,3124,63,3061,2908,28,9,5,0,8
49073,4874,109,4765,4524,10,27,5,0,19
49074,185,1,184,159,21,0,2,0,0
49075,68,4,64,60,1,0,1,0,0
49076,4445,154,4291,3893,190,28,18,0,4
49078,9483,310,9173,8584,70,31,81,1,39
49079,13766,830,12936,11827,195,82,92,5,59
49080,15994,608,15386,14257,153,73,92,5,47
49082,6471,157,6314,6080,26,7,23,1,25
49083,8022,264,7758,7132,102,23,128,0,28
49084,87,3,84,69,2,1,1,0,3
49085,24047,1000,23047,20094,683,55,1115,6,108
49087,6403,164,6239,5857,43,15,39,3,15
49088,3704,99,3605,3416,17,6,11,1,10
49089,1672,41,1631,1505,14,2,2,0,10
49090,13286,1339,11947,9986,1037,90,106,1,56
49091,19901,3694,16207,14713,227,29,165,1,57
49092,2024,37,1987,1891,13,3,9,0,7
49093,18215,850,17365,15232,966,56,170,4,57
49094,4091,94,3997,3663,32,30,18,4,11
49095,2036,48,1988,1663,163,21,31,0,7
49096,3161,100,3061,2916,14,13,11,0,17
49097,11353,310,11043,10216,131,46,83,4,26
49098,5739,493,5246,4670,109,79,28,4,12
49099,5623,252,5371,5027,35,19,20,0,21
49101,3132,161,2971,2772,21,7,15,2,10
49102,1282,122,1160,995,55,8,31,1,4
49103,11508,1316,10192,6670,1752,42,930,63,80
49104,380,51,329,125,146,2,41,0,4
49106,4822,152,4670,4286,67,11,69,1,12
49107,10066,346,9720,8633,335,73,43,2,36
49111,3506,413,3093,2755,92,32,19,1,20
49112,10506,326,10180,9463,90,48,66,0,25
49113,1864,39,1825,1728,8,17,5,0,5
49115,217,10,207,182,3,1,3,0,1
49116,278,5,273,254,6,0,2,0,0
49117,3710,228,3482,3255,41,7,24,3,17
49119,257,10,247,231,3,1,0,0,0
49120,37076,2131,34945,30029,2132,212,297,11,166
49125,1743,37,1706,1600,10,12,7,0,7
49126,1202,113,1089,978,31,5,9,0,0
49127,10811,475,10336,9166,253,33,403,2,32
49128,3448,132,3316,3125,24,16,17,0,12
49129,736,20,716,632,53,1,3,0,4
49130,1627,31,1596,1532,13,4,4,0,0
49201,47747,1696,46051,37936,4988,206,560,7,131
49202,19359,1176,18183,14944,1670,35,204,7,59
49203,37269,1819,35450,27064,5224,93,494,5,148
49220,2390,94,2296,2174,9,6,1,0,2
49221,41315,5865,35450,30878,2186,169,277,2,135
49224,13199,836,12363,9086,2362,40,116,1,64
49227,1241,31,1210,1170,4,1,2,0,0
49228,5432,310,5122,4910,22,17,20,0,5
49229,3261,104,3157,2944,14,16,16,0,5
49230,10364,218,10146,9578,60,30,42,5,19
49232,2857,49,2808,2684,3,8,3,0,7
49233,2776,92,2684,2549,4,3,14,0,5
49234,2580,73,2507,2340,6,7,10,3,9
49235,1899,118,1781,1683,14,11,1,0,7
49236,4831,160,4671,4346,17,5,21,0,16
49237,3027,78,2949,2773,33,5,10,0,10
49238,1674,51,1623,1523,2,8,4,0,2
49240,9213,218,8995,8458,55,25,39,2,23
49241,2359,63,2296,2207,10,2,2,0,3
49242,14812,363,14449,13572,79,40,81,3,73
49245,4672,92,4580,4384,19,11,5,4,5
49246,3247,70,3177,3014,16,3,14,1,5
49247,5720,317,5403,5098,29,11,13,1,27
49248,858,55,803,745,7,5,2,0,1
49249,3269,92,3177,2997,16,10,13,0,6
49250,5994,173,5821,5486,21,30,19,0,13
49251,6136,247,5889,5570,27,16,18,0,24
49252,2666,76,2590,2471,3,15,22,0,2
49253,3095,91,3004,2847,8,5,8,1,6
49254,3163,95,3068,2834,47,11,11,0,5
49255,2098,23,2075,1984,2,3,8,1,21
49256,3909,193,3716,3518,25,7,4,0,14
49258,38,1,37,37,0,0,0,0,0
49259,2594,66,2528,2383,11,11,4,0,10
49261,356,11,345,320,1,1,1,0,3
49262,1211,17,1194,1146,5,4,1,0,0
49263,72,2,70,60,2,0,1,0,0
49264,1909,79,1830,1738,19,4,8,1,4
49265,5055,135,4920,4712,9,18,11,0,10
49266,2954,77,2877,2692,17,14,13,1,8
49267,3920,97,3823,3613,55,8,15,2,7
49268,1047,102,945,877,4,8,4,2,0
49269,5874,170,5704,5323,73,20,31,0,3
49270,5822,142,5680,5384,15,14,21,2,7
49271,2230,41,2189,2090,11,10,0,0,7
49272,2413,46,2367,2265,9,3,1,0,3
49274,3699,67,3632,3469,20,7,4,2,8
49276,971,58,913,861,2,2,5,0,2
49277,3170,101,3069,2873,30,15,7,0,22
49279,832,51,781,730,7,3,1,0,5
49282,210,3,207,196,0,1,1,0,0
49283,4401,200,4201,3915,66,20,26,2,8
49284,2985,60,2925,2785,11,24,7,0,2
49285,5866,220,5646,5285,20,16,17,3,24
49286,14991,764,14227,13255,87,47,84,1,61
49287,1949,75,1874,1753,2,3,11,0,6
49288,1305,30,1275,1204,6,3,1,0,7
49289,104,10,94,89,0,0,0,0,0
49301,20665,607,20058,17998,190,22,938,0,75
49302,8845,260,8585,8064,49,32,91,0,16
49303,1085,83,1002,949,1,3,3,0,2
49304,4979,1049,3930,3105,455,21,35,7,10
49305,2267,70,2197,2051,9,21,14,1,7
49306,10419,352,10067,9420,59,20,134,2,30
49307,16914,571,16343,14519,600,66,241,10,48
49309,1839,58,1781,1564,90,16,3,0,9
49310,3072,62,3010,2874,8,18,5,0,2
49312,295,4,291,262,5,0,0,0,0
49315,26148,1066,25082,22854,315,53,862,3,71
49316,24742,1042,23700,20381,987,73,1243,6,98
49318,1530,139,1391,1311,9,9,5,0,2
49319,17391,663,16728,15615,149,58,92,7,42
49320,270,2,268,258,0,2,0,0,0
49321,16764,1930,14834,12733,998,49,222,0,57
49322,1164,23,1141,1074,6,7,3,0,1
49323,10235,315,9920,9431,39,41,31,2,29
49325,2090,117,1973,1856,6,6,5,2,16
49326,3830,99,3731,3538,6,10,25,4,7
49327,8322,1029,7293,6916,13,31,19,2,23
49328,4006,165,3841,3601,13,37,5,0,17
49329,8707,221,8486,7951,52,30,19,2,14
49330,5664,696,4968,4772,21,11,10,0,13
49331,18023,585,17438,16396,135,41,120,0,37
49332,2757,48,2709,2453,59,25,5,1,10
49333,13427,519,12908,12090,117,44,81,3,46
49335,188,13,175,150,4,0,1,0,0
49336,4382,90,4292,4072,33,15,18,1,10
49337,12854,722,12132,11415,47,79,48,3,35
49338,1810,40,1770,1654,8,10,2,0,6
49339,2376,73,2303,2171,7,9,14,0,5
49340,2846,87,2759,2529,27,26,10,0,10
49341,38250,1255,36995,34660,239,59,376,7,109
49342,1527,22,1505,1429,8,11,6,1,8
49343,5669,195,5474,5088,32,23,18,0,21
49344,3847,190,3657,3402,23,38,24,0,5
49345,13734,930,12804,12059,61,48,54,1,44
49346,5877,96,5781,5481,28,16,20,1,21
49347,1317,27,1290,1221,3,2,3,2,6
49348,14989,609,14380,13304,140,110,78,1,57
49349,8361,285,8076,7266,215,62,34,7,12
49401,29598,1925,27673,24731,1275,92,459,3,112
49402,1425,60,1365,1313,7,10,3,0,0
49403,2491,140,2351,2242,18,6,9,0,6
49404,8913,407,8506,7992,81,32,37,4,23
49405,1587,49,1538,1436,8,18,7,1,2
49406,1031,30,1001,972,4,3,9,0,0
49408,9830,2358,7472,6876,89,31,41,2,59
49409,180,14,166,135,1,2,4,0,1
49410,1956,49,1907,1793,8,19,1,0,5
49411,1592,50,1542,1439,3,13,3,0,4
49412,11703,585,11118,10516,34,44,66,2,31
49415,6618,215,6403,6022,45,35,36,1,6
49417,32406,1219,31187,28868,263,148,484,3,94
49418,30520,2117,28403,25143,952,81,946,8,67
49419,8720,283,8437,8030,45,21,67,0,16
49420,6295,1321,4974,4621,42,54,19,3,17
49421,5756,395,5361,5071,26,32,13,0,15
49423,46870,9208,37662,33222,1394,87,1138,32,131
49424,47963,11438,36525,30036,1060,89,3453,34,143
49425,3655,167,3488,3244,18,34,10,0,13
49426,40467,1529,38938,36537,348,52,526,14,86
49428,27162,1250,25912,24198,251,52,306,4,82
49430,177,6,171,158,0,0,1,2,2
49431,17044,828,16216,15112,112,116,114,7,55
49434,72,9,63,46,0,0,6,0,0
49435,3568,100,3468,3291,19,4,9,2,21
49436,1604,120,1484,1413,1,10,0,0,0
49437,6928,349,6579,6167,24,49,18,0,39
49440,1320,104,1216,884,239,7,1,0,10
49441,36886,2275,34611,28638,3516,192,346,6,132
49442,45342,3691,41651,27530,10820,339,166,11,156
49443,88,1,87,70,17,0,0,0,0
49444,26281,1346,24935,15050,8097,154,256,4,52
49445,21245,846,20399,18403,503,133,120,6,55
49446,2311,350,1961,1861,16,9,7,1,2
49448,4027,132,3895,3642,32,10,26,0,1
49449,2776,136,2640,2538,8,18,4,0,0
49450,3159,1066,2093,1777,112,25,8,0,9
49451,6091,322,5769,5446,33,30,20,0,11
49452,2081,222,1859,1710,10,20,7,0,9
49453,2950,160,2790,2654,13,7,30,0,6
49454,4642,223,4419,4133,32,26,24,0,14
49455,5197,1419,3778,3544,15,33,12,0,20
49456,19727,618,19109,17863,170,86,224,1,62
49457,10833,452,10381,9390,195,80,56,2,34
49458,155,5,150,140,1,0,2,0,0
49459,1451,199,1252,1164,6,14,4,0,7
49460,9025,823,8202,7541,87,31,168,1,33
49461,9295,368,8927,8303,85,55,34,1,25
49464,29654,2433,27221,24774,313,24,1098,2,79
49503,39344,8359,30985,22233,6135,126,630,31,162
49504,41249,6654,34595,28347,3269,214,450,16,187
49505,31444,2273,29171,22669,4021,106,678,6,129
49506,33050,1760,31290,25183,3792,67,570,3,159
49507,38137,11811,26326,10875,13064,97,363,8,190
49508,41851,3875,37976,21624,10169,124,4006,10,155
49509,28340,10035,18305,13603,2524,74,799,2,105
49512,18558,1600,16958,10217,3567,41,2200,3,75
49519,28025,5632,22393,17693,2510,99,774,12,81
49525,30275,1368,28907,25211,1061,48,1081,8,75
49534,23996,1137,22859,20783,561,70,436,3,74
49544,9514,867,8647,7311,485,42,345,1,25
49546,35536,1511,34025,27459,2647,57,2393,8,165
49548,34741,7205,27536,18588,4564,147,2177,27,109
49601,21564,523,21041,19747,128,89,156,0,66
49611,208,1,207,195,0,5,0,0,0
49612,1163,14,1149,1085,3,11,1,2,5
49613,706,11,695,669,2,5,1,0,2
49614,2985,128,2857,2685,11,35,6,0,11
49615,4161,78,4083,3885,12,25,14,1,14
49616,2068,53,2015,1843,5,69,9,0,6
49617,3285,75,3210,3040,14,22,16,0,10
49618,776,7,769,732,0,6,2,0,5
49619,1043,25,1018,928,2,18,0,0,4
49620,2827,34,2793,2629,12,20,11,0,7
49621,3157,88,3069,2934,7,12,15,0,1
49622,2473,47,2426,2293,1,25,9,1,7
49623,1186,25,1161,1066,26,1,3,0,7
49625,1454,50,1404,1316,5,10,2,0,0
49626,325,9,316,289,0,10,0,0,2
49627,176,6,170,159,0,3,2,0,0
49628,329,16,313,304,0,1,0,0,0
49629,1997,37,1960,1871,0,20,17,7,1
49630,1331,16,1315,1267,2,0,5,0,1
49631,5702,132,5570,5236,37,25,4,1,10
49632,1134,60,1074,1039,0,4,3,0,2
49633,4026,88,3938,3697,16,39,6,0,15
49634,136,2,134,125,0,0,0,0,1
49635,3331,65,3266,3133,2,12,15,0,9
49636,575,10,565,549,1,0,2,0,4
49637,3466,118,3348,3096,11,49,21,3,20
49638,829,18,811,748,2,8,4,0,4
49639,2552,56,2496,2363,18,17,2,1,1
49640,1501,21,1480,1390,5,11,7,0,8
49642,840,23,817,441,289,9,4,0,2
49643,7379,270,7109,6609,56,50,31,0,23
49644,1891,23,1868,1781,6,7,2,0,0
49645,1742,86,1656,1529,5,17,3,0,3
49646,8582,167,8415,7914,18,64,36,0,19
49648,2362,84,2278,2177,2,27,5,1,5
49649,6919,165,6754,6334,32,58,17,1,3
49650,3215,69,3146,2975,9,14,10,0,20
49651,7881,199,7682,7298,29,33,24,1,14
49653,2020,123,1897,1805,6,14,11,0,1
49654,689,34,655,624,5,3,4,0,2
49655,3180,41,3139,3012,8,23,5,1,6
49656,1535,32,1503,1428,7,13,0,0,3
49657,3607,149,3458,3368,3,3,8,0,0
49659,6670,113,6557,6128,14,40,21,0,20
49660,14134,457,13677,11951,573,368,59,2,26
49663,6199,164,6035,5707,21,25,12,1,15
49664,2139,43,2096,1992,9,10,10,3,8
49665,4169,88,4081,3894,10,26,2,0,10
49667,546,10,536,509,0,0,2,0,2
49668,3758,101,3657,3346,19,27,14,0,23
49670,1819,63,1756,1662,9,40,3,0,3
49674,184,5,179,175,0,0,0,0,0
49675,964,19,945,910,0,9,2,0,6
49676,3527,83,3444,3234,5,46,5,1,9
49677,6787,106,6681,6221,65,37,15,4,38
49679,1458,41,1417,1307,29,20,1,0,1
49680,1949,38,1911,1773,6,10,8,0,13
49682,4272,310,3962,3244,13,449,30,0,19
49683,2114,36,2078,1957,8,25,4,0,6
49684,22025,720,21305,19863,101,164,172,6,74
49685,20856,695,20161,18654,113,197,219,14,52
49686,25859,927,24932,23016,222,259,269,13,75
49688,2685,25,2660,2527,11,17,6,0,3
49689,1540,40,1500,1410,8,22,6,0,3
49690,6494,156,6338,5921,28,92,34,3,26
49696,9528,234,9294,8681,41,57,79,5,37
49701,1050,24,1026,912,21,36,9,1,5
49705,823,6,817,739,0,23,6,0,1
49706,5062,71,4991,4428,20,167,14,2,17
49707,22243,350,21893,20715,94,95,104,10,55
49709,3407,54,3353,3183,6,21,16,0,11
49710,368,7,361,315,0,20,1,1,1
49712,8113,111,8002,7487,16,77,57,2,42
49713,2135,34,2101,1950,4,37,9,1,10
49715,3117,48,3069,1643,7,1079,8,0,5
49716,775,9,766,696,2,32,3,1,3
49717,170,2,168,151,0,5,0,0,0
49718,691,5,686,598,6,43,1,0,2
49719,1305,21,1284,1081,2,95,5,0,11
49720,9127,148,8979,8337,39,141,49,5,37
49721,14058,191,13867,12342,67,458,50,1,40
49722,93,2,91,79,0,6,0,0,0
49724,1173,18,1155,904,1,135,3,0,11
49725,640,9,631,532,0,42,2,0,4
49726,973,10,963,860,0,41,2,0,0
49727,6887,129,6758,6308,15,125,6,4,23
49728,293,8,285,242,0,14,1,0,0
49729,1527,45,1482,1390,3,7,3,0,1
49730,2248,26,2222,2083,4,18,10,0,2
49733,1722,30,1692,1591,6,9,2,2,2
49735,20568,381,20187,18949,89,123,77,0,57
49736,557,12,545,466,0,38,0,0,3
49738,9498,230,9268,8764,47,63,46,1,25
49740,7511,129,7382,6851,19,211,29,3,20
49743,725,17,708,687,1,7,1,0,1
49744,854,7,847,807,0,7,1,1,0
49745,1016,17,999,729,2,173,2,0,7
49746,3320,35,3285,3103,4,26,7,0,17
49747,1701,17,1684,1631,0,1,3,0,1
49748,198,4,194,165,3,8,0,0,0
49749,4087,47,4040,3774,5,77,11,0,10
49751,2014,20,1994,1916,6,5,2,0,1
49752,484,12,472,385,3,39,3,0,0
49753,1973,18,1955,1854,2,13,2,0,4
49755,1847,25,1822,1661,6,56,7,1,1
49756,3822,59,3763,3566,1,24,1,0,8
49757,583,22,561,435,13,75,1,0,3
49759,1505,18,1487,1401,7,6,9,0,0
49760,673,11,662,494,0,116,0,0,1
49762,602,7,595,457,3,81,1,0,3
49764,72,5,67,61,0,2,0,0,0
49765,3898,45,3853,3627,5,32,9,0,14
49766,2461,23,2438,2350,4,4,5,1,5
49768,403,0,403,368,0,12,1,0,0
49769,1642,12,1630,1399,7,99,3,2,4
49770,17643,346,17297,15749,91,465,117,12,54
49774,3011,58,2953,1961,718,133,9,0,6
49775,100,0,100,91,4,4,0,0,0
49776,1779,19,1760,1701,3,3,1,0,5
49777,1672,17,1655,1621,3,2,0,0,1
49779,4611,57,4554,4354,8,25,33,0,8
49780,1795,49,1746,1504,2,126,1,0,5
49781,3901,53,3848,2409,25,1007,14,0,4
49782,525,7,518,487,0,6,0,0,3
49783,18690,389,18301,13046,137,3234,144,7,49
49784,2320,56,2264,708,1521,25,2,2,0
49788,2904,82,2822,1566,221,674,14,2,3
49791,243,3,240,216,1,8,0,0,0
49793,304,3,301,248,0,21,1,0,0
49795,2087,30,2057,1911,7,18,3,0,5
49796,300,7,293,288,0,1,3,0,0
49799,2514,35,2479,2279,2,53,5,0,3
49801,11479,229,11250,10646,25,46,89,2,17
49802,6197,112,6085,5731,29,24,34,0,8
49805,325,8,317,305,0,0,0,0,1
49806,480,6,474,419,0,21,1,0,2
49807,3307,50,3257,2969,3,101,14,0,12
49808,349,8,341,317,0,2,1,0,2
49812,888,26,862,831,0,9,2,0,0
49814,1296,6,1290,1238,1,9,2,0,3
49815,428,5,423,401,0,2,2,0,0
49816,775,3,772,694,1,22,2,0,4
49817,567,6,561,505,0,26,0,0,1
49818,966,6,960,910,0,17,2,2,1
49820,304,9,295,271,2,9,0,0,2
49821,1210,20,1190,1149,1,15,5,1,1
49822,227,6,221,203,0,6,2,0,2
49825,347,4,343,327,0,4,1,0,1
49826,88,1,87,78,0,1,0,0,1
49827,963,11,952,819,3,60,3,0,2
49829,17009,300,16709,15301,74,412,98,4,20
49831,713,7,706,683,2,2,0,1,1
49833,213,2,211,196,0,5,0,0,0
49834,449,2,447,416,0,4,3,0,12
49835,784,14,770,639,0,45,2,0,4
49836,921,5,916,838,0,36,0,0,1
49837,10086,114,9972,9272,9,149,37,1,34
49838,478,10,468,415,0,21,3,0,0
49839,373,6,367,351,1,4,1,0,1
49840,747,6,741,659,1,54,0,0,0
49841,7193,165,7028,6303,72,139,39,2,22
49847,986,16,970,923,2,4,1,0,0
49848,146,2,144,137,1,3,0,1,0
49849,11819,151,11668,10946,31,145,16,7,38
49852,130,1,129,119,0,1,0,0,0
49853,1282,9,1273,1158,2,43,0,0,1
49854,6211,79,6132,5125,9,576,15,1,5
49855,32929,847,32082,28783,653,557,293,5,78
49858,11939,314,11625,10995,90,74,60,1,26
49861,565,11,554,528,0,4,0,0,0
49862,4602,65,4537,3557,583,161,9,1,12
49863,125,1,124,122,0,0,0,1,0
49864,32,1,31,25,0,0,0,0,0
49866,8259,125,8134,7586,28,102,39,0,27
49868,4108,63,4045,3404,10,321,2,0,9
49870,3343,55,3288,3150,6,24,6,0,2
49871,476,10,466,445,0,4,2,0,0
49872,230,1,229,211,0,4,0,0,0
49873,158,4,154,135,0,6,2,0,0
49874,1043,11,1032,1003,1,6,0,0,0
49876,1153,9,1144,1087,1,9,7,1,0
49877,57,0,57,56,0,0,0,0,0
49878,3566,49,3517,3258,6,82,4,1,7
49879,997,6,991,939,0,7,1,0,3
49880,971,2,969,916,0,9,3,0,3
49881,356,1,355,345,0,0,0,0,1
49883,143,4,139,121,0,10,0,0,0
49884,515,8,507,414,0,27,5,0,2
49885,1937,23,1914,1756,3,38,4,3,5
49886,423,2,421,412,0,0,0,0,0
49887,2353,37,2316,2220,0,10,12,0,1
49891,515,9,506,471,0,18,0,0,0
49892,1935,21,1914,1846,1,7,6,0,2
49893,1640,10,1630,1569,2,14,4,1,2
49894,686,5,681,628,1,18,1,0,0
49895,784,10,774,641,0,77,1,0,0
49896,1855,36,1819,1177,0,550,3,0,3
49901,300,5,295,290,0,1,0,0,0
49902,126,8,118,113,0,0,2,0,1
49903,219,3,216,203,0,1,0,0,0
49905,2234,21,2213,2102,10,7,8,2,19
49908,3046,43,3003,1525,592,652,2,0,15
49910,297,2,295,274,1,12,0,0,0
49911,2626,40,2586,2445,5,21,7,1,8
49912,844,10,834,790,2,7,5,0,1
49913,7218,75,7143,6785,16,37,21,2,18
49915,789,5,784,708,7,23,3,0,4
49916,2855,14,2841,2690,12,15,14,2,12
49917,212,1,211,205,1,1,1,0,0
49918,141,0,141,136,0,0,0,0,0
49919,147,2,145,136,1,2,0,0,0
49920,4046,60,3986,3817,3,16,15,0,12
49921,343,4,339,317,4,1,0,1,3
49922,907,7,900,878,0,3,6,1,0
49925,485,2,483,463,0,9,1,1,0
49927,437,6,431,413,4,3,1,0,1
49929,182,2,180,174,1,0,1,0,1
49930,7135,156,6979,6484,67,43,87,6,23
49931,10307,325,9982,8581,152,32,703,5,46
49934,862,14,848,822,2,1,1,0,4
49935,5952,123,5829,5511,10,50,20,0,16
49938,7340,133,7207,6755,55,82,22,2,14
49942,93,0,93,93,0,0,0,0,0
49945,2650,25,2625,2496,8,3,4,1,22
49946,3784,31,3753,3010,3,418,12,2,6
49947,609,4,605,579,1,7,0,0,2
49948,494,6,488,473,0,4,0,0,2
49950,1056,13,1043,1001,4,0,0,0,3
49952,138,1,137,130,2,0,0,0,0
49953,2541,37,2504,2358,3,15,11,1,6
49955,383,3,380,374,2,0,0,0,0
49958,1118,17,1101,1043,2,12,5,0,2
49959,434,10,424,394,1,2,2,0,0
49960,191,2,189,168,1,0,2,0,0
49961,104,0,104,98,0,0,3,0,0
49962,264,1,263,246,0,0,0,1,1
49963,864,4,860,810,3,10,3,1,3
49965,465,14,451,422,1,6,0,0,0
49967,434,4,430,412,0,7,0,0,0
49968,2069,16,2053,1974,2,14,4,0,1
49969,1445,20,1425,975,1,385,0,0,11
49970,231,3,228,220,0,0,0,0,0
49971,339,2,337,313,0,4,0,0,0
50001,695,17,678,643,0,1,2,0,0
50002,1274,29,1245,1199,7,2,5,0,0
50003,9428,227,9201,8805,52,10,38,0,39
50005,679,23,656,636,4,2,2,0,0
50006,1502,60,1442,1401,2,0,3,2,2
50007,497,9,488,480,3,0,1,0,0
50008,809,9,800,777,0,1,8,0,0
50009,21230,1009,20221,18190,777,38,346,25,39
50010,32552,1803,30749,24929,1329,81,2538,10,130
50012,2249,156,2093,1791,87,15,5,0,0
50013,4260,327,3933,3417,156,15,16,2,6
50014,31587,1804,29783,24346,1198,48,2721,15,83
50020,1375,9,1366,1322,2,2,2,5,0
50021,28807,1282,27525,24796,759,49,726,9,107
50022,8052,213,7839,7510,24,7,26,69,12
50023,43603,1686,41917,38168,952,68,943,28,193
50025,3027,72,2955,2860,13,1,2,1,3
50026,526,21,505,489,1,2,0,0,3
50027,266,5,261,251,2,1,0,0,0
50028,1608,17,1591,1539,1,2,5,0,4
50029,614,12,602,570,0,2,2,2,1
50031,46,0,46,40,1,1,0,0,0
50032,395,17,378,356,6,2,2,0,0
50033,52,1,51,49,0,0,0,0,1
50034,390,6,384,364,2,0,0,1,0
50035,8968,310,8658,8129,121,19,104,1,13
50036,16203,401,15802,14976,173,30,74,2,30
50038,221,14,207,179,2,1,12,0,1
50039,352,4,348,322,0,0,2,0,2
50040,181,0,181,169,2,2,0,0,2
50041,71,0,71,71,0,0,0,0,0
50042,298,2,296,293,0,0,0,0,0
50044,854,17,837,804,2,2,7,0,4
50046,1586,48,1538,1446,13,4,2,0,12
50047,6021,205,5816,5520,47,5,35,1,15
50048,821,21,800,760,1,3,3,6,1
50049,6433,172,6261,6040,19,6,28,0,4
50050,640,12,628,601,5,0,1,0,0
50051,278,9,269,262,0,1,0,0,0
50052,145,0,145,142,0,0,1,0,0
50054,3471,77,3394,3227,13,1,18,12,17
50055,1026,18,1008,953,2,1,2,0,9
50056,1388,23,1365,1318,1,0,1,0,7
50057,208,3,205,203,0,0,0,1,0
50058,1897,59,1838,1795,3,0,0,0,0
50060,2581,24,2557,2482,7,7,5,1,6
50061,1973,51,1922,1791,9,2,23,0,5
50062,778,14,764,735,6,2,0,0,1
50063,2900,53,2847,2744,14,2,11,0,6
50064,105,4,101,95,0,0,1,0,1
50065,553,3,550,531,1,0,1,0,3
50066,238,14,224,210,0,0,1,0,0
50067,318,3,315,307,2,0,1,0,0
50068,352,10,342,335,0,0,0,0,1
50069,999,16,983,912,6,5,17,2,6
50070,1536,37,1499,1422,18,1,15,2,2
50071,919,156,763,730,5,3,4,1,0
50072,2688,45,2643,2535,13,5,1,0,22
50073,1405,80,1325,1255,8,1,5,0,8
50074,342,3,339,331,0,0,0,0,1
50075,833,52,781,734,4,2,0,0,2
50076,1436,8,1428,1399,2,3,1,0,0
50078,97,6,91,86,0,1,0,0,0
50101,68,9,59,56,1,0,1,0,0
50102,89,3,86,84,1,0,1,0,0
50103,412,1,411,401,2,0,1,0,0
50104,133,4,129,125,0,0,0,0,2
50105,1326,44,1282,1190,17,4,11,0,2
50106,1044,39,1005,957,2,4,7,0,7
50107,933,15,918,881,0,5,4,0,1
50108,451,8,443,426,0,1,3,1,0
50109,3348,84,3264,3143,9,5,20,2,8
50110,58,2,56,51,1,0,0,0,0
50111,16025,713,15312,13866,435,25,390,7,35
50112,11849,380,11469,10524,310,31,205,21,26
50115,2571,85,2486,2380,11,10,18,3,12
50116,263,0,263,250,0,0,4,0,0
50117,190,0,190,190,0,0,0,0,0
50118,931,32,899,851,3,1,5,0,8
50119,464,8,456,444,0,0,1,0,0
50120,338,8,330,320,1,0,1,0,0
50122,1409,45,1364,1313,6,2,3,0,1
50123,775,8,767,742,0,1,0,0,3
50124,4697,106,4591,4345,51,14,25,0,17
50125,20906,564,20342,19278,171,27,143,8,46
50126,6576,369,6207,5904,57,14,47,0,10
50127,66,0,66,60,0,0,0,0,0
50128,316,34,282,272,0,0,0,0,1
50129,5040,169,4871,4674,15,5,33,1,6
50130,1611,85,1526,1455,9,4,9,0,1
50131,24434,935,23499,19757,1398,27,1505,11,55
50132,349,10,339,325,2,1,0,0,0
50133,478,16,462,436,1,1,1,0,0
50134,687,22,665,617,5,0,9,0,7
50135,1544,27,1517,1453,0,4,9,1,7
50136,418,9,409,398,1,0,0,0,0
50137,70,1,69,66,0,0,0,0,0
50138,11631,226,11405,10765,123,38,50,2,23
50139,1172,20,1152,1122,5,3,1,0,1
50140,2503,148,2355,2122,71,15,28,18,12
50141,518,8,510,493,0,0,4,0,0
50142,905,58,847,806,7,3,0,0,1
50143,568,7,561,553,0,1,3,0,1
50144,2766,45,2721,2617,17,1,5,2,9
50145,76,1,75,70,0,0,0,0,0
50146,505,21,484,471,0,0,1,0,2
50147,373,9,364,342,3,3,5,0,0
50148,420,11,409,400,3,2,1,0,0
50149,1084,11,1073,1042,2,1,3,0,2
50150,816,6,810,761,0,5,2,1,3
50151,679,9,670,639,0,0,0,0,1
50152,142,1,141,137,0,0,0,0,0
50153,734,13,721,710,0,0,0,0,0
50154,527,13,514,488,2,0,1,0,1
50155,213,0,213,206,0,0,0,0,0
50156,4662,95,4567,4394,15,4,12,0,1
50157,699,19,680,649,0,0,1,0,2
50158,31466,8789,22677,19438,759,139,1487,32,54
50160,421,6,415,393,1,0,0,0,0
50161,2017,74,1943,1837,3,3,5,0,4
50162,1236,44,1192,1145,4,0,4,0,2
50163,758,9,749,717,5,0,1,0,0
50164,609,17,592,553,0,3,1,0,6
50165,36,0,36,34,0,0,0,0,0
50166,1511,33,1478,1394,12,2,7,0,4
50167,745,18,727,703,0,1,0,1,6
50168,909,7,902,846,5,1,3,0,7
50169,3372,131,3241,2976,121,41,14,3,10
50170,2854,48,2806,2716,4,5,12,3,7
50171,2703,41,2662,2596,2,7,5,0,0
50173,678,28,650,411,4,198,2,0,1
50174,1440,33,1407,1367,6,0,5,3,11
50201,8427,473,7954,7447,89,14,73,1,37
50206,497,11,486,474,3,0,0,0,5
50207,2495,28,2467,2380,11,5,7,0,0
50208,20918,792,20126,18486,652,71,148,14,49
50210,1752,42,1710,1639,1,1,3,0,4
50211,15158,524,14634,13694,192,28,155,6,68
50212,3152,50,3102,3015,8,7,4,1,2
50213,7298,1476,5822,5510,37,7,71,36,16
50214,818,13,805,746,3,0,27,0,5
50216,2722,46,2676,2608,8,1,1,0,20
50217,547,11,536,524,0,1,1,0,3
50218,176,2,174,168,0,0,2,0,0
50219,14390,317,14073,13233,122,16,300,18,50
50220,9045,2960,6085,5452,260,14,86,4,26
50222,490,9,481,463,0,0,1,0,2
50223,331,2,329,319,2,2,0,0,0
50225,3026,61,2965,2843,15,3,5,0,1
50226,6879,126,6753,6410,40,8,43,5,14
50227,75,4,71,71,0,0,0,0,0
50228,2509,69,2440,2339,8,0,18,0,6
50229,1029,23,1006,964,0,1,5,1,2
50230,1099,34,1065,1020,4,3,0,0,3
50231,157,2,155,154,0,0,1,0,0
50232,527,5,522,510,0,1,0,0,0
50233,1291,35,1256,1207,5,1,2,0,2
50234,556,26,530,511,2,0,1,0,0
50235,408,21,387,372,1,2,1,0,1
50236,1634,44,1590,1518,4,3,7,1,12
50237,3153,90,3063,2927,12,8,24,2,14
50238,1071,7,1064,1036,0,0,1,0,0
50239,191,13,178,167,0,0,2,0,0
50240,2399,42,2357,2211,5,3,11,1,13
50241,108,3,105,104,0,0,0,0,0
50242,411,8,403,384,0,1,4,0,1
50243,297,3,294,271,2,1,2,0,3
50244,1825,32,1793,1727,5,7,7,0,2
50246,638,32,606,590,3,2,0,0,0
50247,2365,106,2259,2202,3,1,5,1,1
50248,4439,131,4308,4099,31,20,28,0,17
50249,1235,39,1196,1150,3,2,0,0,1
50250,2415,78,2337,2234,19,4,8,3,6
50251,1339,12,1327,1289,0,6,4,0,0
50252,324,11,313,293,2,0,0,0,1
50254,254,4,250,242,0,0,4,0,0
50255,45,0,45,44,1,0,0,0,0
50256,488,18,470,461,0,1,0,0,2
50257,1039,15,1024,997,2,0,4,0,1
50258,768,18,750,724,3,0,4,0,0
50261,3019,64,2955,2776,15,11,20,4,22
50262,360,3,357,342,3,0,0,0,1
50263,24817,1263,23554,20371,897,36,1275,15,85
50264,510,0,510,495,1,0,2,0,1
50265,32187,2403,29784,24997,1773,34,1483,21,121
50266,36486,2152,34334,27522,1889,61,3298,10,162
50268,917,9,908,874,0,0,6,0,1
50269,100,4,96,94,0,0,1,0,1
50271,549,24,525,507,3,0,0,0,0
50272,118,3,115,114,0,0,0,0,0
50273,8570,199,8371,8010,12,10,51,6,19
50274,367,5,362,356,0,2,0,0,0
50275,476,13,463,451,0,0,3,1,1
50276,2454,116,2338,2135,83,7,14,0,7
50277,505,9,496,484,0,0,0,0,1
50278,780,11,769,738,2,0,3,0,0
50309,9532,777,8755,6701,1078,24,509,3,52
50310,30754,2369,28385,20396,3445,75,3059,20,99
50311,14782,1418,13364,10140,1835,21,574,1,67
50312,15485,863,14622,12749,679,66,347,12,58
50313,17723,2829,14894,11094,1753,48,1201,9,56
50314,11764,2459,9305,3326,4280,44,1164,17,42
50315,36693,6419,30274,23140,3146,105,1924,23,140
50316,16785,4692,12093,7502,2493,52,1227,19,83
50317,37221,5895,31326,25137,2749,104,1447,21,132
50319,0,0,0,0,0,0,0,0,0
50320,23369,5250,18119,12092,2220,83,2665,4,72
50321,7783,964,6819,5182,1000,20,256,1,28
50322,31652,2068,29584,24631,1795,50,1826,14,100
50323,16616,486,16130,14503,263,12,789,0,37
50324,5252,353,4899,4090,239,6,260,3,17
50325,18619,1376,17243,14386,756,25,1356,11,64
50327,11807,714,11093,9887,358,20,323,7,28
50401,28981,1850,27131,24699,737,83,410,131,66
50420,392,41,351,343,0,0,6,0,0
50421,3043,484,2559,2448,26,3,11,0,9
50423,2806,196,2610,2525,28,2,6,0,0
50424,1424,61,1363,1324,4,0,4,0,1
50426,87,1,86,86,0,0,0,0,0
50427,36,2,34,30,0,0,0,0,0
50428,9290,268,9022,8556,90,7,110,5,6
50430,425,41,384,371,5,2,0,0,0
50431,208,49,159,154,0,0,0,0,0
50432,259,20,239,232,1,0,2,0,0
50433,238,6,232,224,2,0,0,0,1
50434,435,19,416,401,1,0,1,0,0
50435,732,20,712,688,3,5,0,1,0
50436,5816,300,5516,5071,166,11,78,3,18
50438,4033,139,3894,3736,31,7,9,0,1
50439,263,32,231,228,0,0,0,0,0
50440,373,8,365,355,0,0,3,0,1
50441,5529,1281,4248,4061,23,12,33,0,12
50444,353,16,337,311,4,0,8,0,0
50446,526,23,503,484,5,0,2,0,1
50447,1047,105,942,911,2,3,3,0,1
50448,713,18,695,670,7,1,2,0,1
50449,666,39,627,604,1,4,0,0,0
50450,2827,189,2638,2535,22,2,8,0,15
50451,492,24,468,449,3,0,1,0,0
50452,741,186,555,537,0,3,0,0,0
50453,543,17,526,500,4,0,3,0,2
50454,134,4,130,126,0,0,0,0,1
50455,366,4,362,357,0,0,2,0,0
50456,1695,36,1659,1582,12,4,5,0,5
50457,361,28,333,315,2,0,0,0,2
50458,2034,71,1963,1877,24,2,6,1,7
50459,3087,84,3003,2893,28,2,7,1,5
50460,348,2,346,341,1,0,0,0,2
50461,5605,91,5514,5332,28,2,26,3,12
50464,651,13,638,601,7,3,0,0,2
50465,201,12,189,174,11,0,0,0,0
50466,1845,47,1798,1760,0,4,5,2,2
50467,107,2,105,103,1,0,0,0,0
50468,1497,18,1479,1414,10,2,4,1,1
50469,1629,34,1595,1565,3,1,2,0,3
50470,205,20,185,179,0,0,0,0,1
50471,621,22,599,570,1,2,4,0,0
50472,2402,43,2359,2288,14,0,12,1,5
50473,273,18,255,251,0,1,1,0,1
50475,1621,29,1592,1516,9,4,9,0,4
50476,745,10,735,730,0,0,1,0,1
50477,257,0,257,251,1,0,2,0,0
50478,761,34,727,705,5,0,5,0,3
50479,667,18,649,621,4,1,2,0,1
50480,879,20,859,838,1,1,7,0,0
50482,768,15,753,727,3,0,4,1,0
50483,719,16,703,686,3,1,1,1,1
50484,384,20,364,357,0,2,0,0,0
50501,28492,1827,26665,23413,1734,100,270,16,59
50510,1069,92,977,937,3,2,4,0,2
50511,7061,370,6691,6436,46,4,52,0,4
50514,1337,10,1327,1303,0,3,2,0,1
50515,253,9,244,240,2,0,0,0,0
50516,690,24,666,634,0,0,5,0,1
50517,956,38,918,888,6,0,1,0,0
50518,342,13,329,317,1,1,0,0,0
50519,614,26,588,575,0,3,0,0,7
50520,156,5,151,145,0,0,0,0,1
50521,103,0,103,103,0,0,0,0,0
50522,715,17,698,673,2,0,4,0,0
50523,622,18,604,580,3,0,1,0,1
50524,524,13,511,487,2,2,3,0,2
50525,3494,760,2734,2618,6,3,36,2,2
50527,180,2,178,166,0,0,0,0,2
50528,348,9,339,323,1,1,2,0,0
50529,759,28,731,711,2,3,1,0,0
50530,1164,23,1141,1100,5,0,3,0,5
50531,224,1,223,220,2,1,0,0,0
50532,952,31,921,884,8,4,5,0,2
50533,4041,906,3135,2971,35,4,9,1,1
50535,866,34,832,786,11,5,0,1,4
50536,4351,132,4219,4018,36,11,23,4,12
50538,565,5,560,512,9,5,1,6,0
50539,501,10,491,475,4,0,0,1,0
50540,1053,133,920,862,6,2,2,23,0
50541,839,11,828,797,4,2,0,0,2
50542,899,61,838,809,2,2,3,1,0
50543,1359,62,1297,1248,8,1,6,0,5
50544,478,19,459,445,2,0,0,0,0
50545,221,4,217,206,2,1,1,0,0
50546,284,18,266,247,2,0,0,0,2
50548,5921,325,5596,5425,40,7,16,0,5
50551,115,1,114,113,0,0,0,0,1
50552,53,0,53,53,0,0,0,0,0
50554,1649,101,1548,1426,24,4,16,0,9
50556,248,4,244,241,0,0,1,0,0
50557,675,5,670,647,0,0,0,0,0
50558,624,14,610,583,2,0,2,6,0
50559,283,14,269,257,0,0,0,0,0
50560,531,14,517,492,3,0,1,1,2
50561,523,14,509,490,2,0,2,1,3
50562,474,6,468,457,0,1,0,1,0
50563,2471,49,2422,2364,10,3,6,0,2
50565,410,23,387,374,4,0,0,0,0
50566,431,7,424,400,8,1,1,0,2
50567,213,14,199,185,2,0,7,0,0
50568,1331,111,1220,1141,0,5,6,31,7
50569,727,16,711,692,2,2,0,0,1
50570,236,7,229,222,0,0,0,0,3
50571,310,6,304,298,0,0,1,0,3
50573,42,0,42,38,0,0,2,0,2
50574,2264,30,2234,2153,14,4,5,0,4
50575,810,29,781,753,3,4,3,0,1
50576,402,80,322,312,2,0,0,0,1
50577,394,9,385,348,2,0,1,0,9
50578,523,20,503,486,1,0,1,0,2
50579,2895,113,2782,2587,124,8,7,1,9
50581,833,39,794,766,12,0,1,0,1
50582,190,3,187,185,0,0,0,0,0
50583,2642,73,2569,2488,15,1,8,0,7
50585,1118,96,1022,986,5,3,1,0,1
50586,273,5,268,255,0,1,1,0,0
50588,13331,4975,8356,5207,514,16,1846,516,64
50590,860,37,823,793,2,3,1,0,5
50591,311,9,302,289,1,0,1,0,0
50592,69,5,64,53,0,0,7,0,0
50593,67,11,56,52,0,0,0,0,0
50594,259,3,256,250,0,0,0,0,0
50595,8887,1206,7681,7048,62,15,304,0,22
50597,1275,55,1220,1197,3,2,3,0,1
50598,940,30,910,895,2,0,0,0,0
50599,346,7,339,332,1,0,0,2,0
50601,2451,176,2275,2191,6,0,7,0,12
50602,1538,16,1522,1488,3,3,2,0,0
50603,553,8,545,523,9,1,0,0,2
50604,1701,15,1686,1648,6,1,2,0,1
50605,133,5,128,121,0,0,1,0,0
50606,777,9,768,746,4,0,2,0,1
50607,477,13,464,452,0,0,0,0,1
50608,38,0,38,36,0,0,0,0,0
50609,384,6,378,371,0,1,0,0,1
50611,340,4,336,320,2,0,2,0,0
50612,340,6,334,331,0,1,0,0,0
50613,43667,1218,42449,38065,1258,53,1330,109,124
50616,10009,422,9587,8637,375,18,282,4,7
50619,2152,22,2130,2069,0,1,10,0,2
50620,54,0,54,54,0,0,0,0,0
50621,1450,21,1429,1388,2,1,2,0,0
50622,3452,48,3404,3313,1,0,11,0,0
50623,146,1,145,138,0,0,0,0,0
50624,1835,23,1812,1755,6,1,6,0,1
50625,964,32,932,910,1,0,0,0,0
50626,1652,23,1629,1574,2,0,3,0,1
50627,3367,115,3252,3009,66,6,21,0,9
50628,1296,28,1268,1246,0,1,0,2,1
50629,2288,28,2260,2216,1,0,4,0,3
50630,1680,53,1627,1578,10,1,4,0,0
50631,178,1,177,173,0,0,0,0,0
50632,1032,27,1005,968,6,9,4,0,0
50633,326,7,319,304,0,0,1,0,3
50634,795,14,781,756,6,1,2,0,1
50635,1375,24,1351,1302,5,6,4,0,4
50636,1783,13,1770,1726,4,3,3,3,4
50638,3411,47,3364,3254,18,5,11,0,3
50641,1906,29,1877,1829,4,1,0,0,2
50642,544,1,543,521,5,0,1,0,1
50643,2819,56,2763,2665,18,2,14,1,0
50644,8795,155,8640,8303,44,13,40,3,7
50645,1124,15,1109,1096,1,2,0,0,1
50647,1989,30,1959,1900,5,1,7,0,0
50648,3992,59,3933,3817,11,3,8,2,7
50649,45,0,45,45,0,0,0,0,0
50650,681,12,669,655,0,0,0,0,0
50651,3579,52,3527,3449,16,2,3,0,1
50652,121,11,110,107,0,0,0,0,0
50653,605,6,599,594,0,0,1,0,0
50654,468,8,460,451,0,0,0,2,0
50655,743,17,726,700,2,1,1,0,2
50657,94,2,92,90,0,0,0,0,0
50658,2394,16,2378,2287,9,1,1,2,2
50659,5402,350,5052,4887,45,1,16,0,1
50660,1294,14,1280,1238,1,3,1,0,3
50662,6693,265,6428,5997,86,17,24,1,6
50664,97,0,97,95,0,0,0,0,0
50665,2893,28,2865,2772,5,3,5,0,7
50666,893,10,883,852,3,3,3,0,0
50667,759,18,741,709,11,0,1,0,0
50668,1234,19,1215,1200,0,0,0,0,2
50669,2335,27,2308,2215,9,2,1,0,4
50670,1959,35,1924,1865,2,2,6,0,2
50671,206,5,201,193,0,0,1,0,0
50672,532,13,519,506,0,0,2,0,0
50673,185,3,182,179,0,0,0,0,1
50674,3480,62,3418,3321,4,4,10,0,2
50675,2372,36,2336,2231,16,10,8,1,7
50676,1815,25,1790,1743,0,0,0,0,6
50677,12789,315,12474,11725,230,18,165,2,24
50680,1128,12,1116,1089,1,0,1,0,1
50681,432,5,427,417,0,1,0,0,1
50682,1558,18,1540,1485,6,1,1,2,2
50701,29806,1218,28588,23612,2682,67,656,225,111
50702,20447,1465,18982,13881,2853,37,1079,248,66
50703,18913,1935,16978,9223,6148,40,284,227,52
50707,7708,438,7270,6260,532,17,39,38,17
50801,9245,330,8915,8480,111,22,50,7,9
50830,1667,46,1621,1580,1,2,6,0,0
50831,38,0,38,34,0,0,0,0,0
50833,2338,27,2311,2218,1,3,4,0,12
50835,82,0,82,81,0,0,0,0,0
50836,322,4,318,310,0,0,0,0,0
50837,304,9,295,290,0,0,0,0,0
50839,36,2,34,30,1,1,1,0,0
50840,437,11,426,414,0,0,1,0,1
50841,2652,26,2626,2515,9,10,12,0,11
50842,105,2,103,99,0,0,1,0,0
50843,537,6,531,504,1,3,2,1,4
50845,787,7,780,753,0,2,1,0,2
50846,1084,12,1072,1027,7,6,4,0,0
50847,83,0,83,80,0,0,0,0,0
50848,342,2,340,322,0,9,0,0,3
50849,2784,61,2723,2660,11,3,10,1,1
50851,1958,346,1612,1575,0,1,3,1,3
50853,688,3,685,656,0,1,3,1,3
50854,2223,37,2186,2119,1,4,5,0,0
50857,180,2,178,171,2,0,1,0,1
50858,738,13,725,713,2,0,1,0,2
50859,491,6,485,467,0,3,0,0,3
50860,267,0,267,258,0,0,1,0,0
50861,238,9,229,223,0,0,1,0,0
50862,132,11,121,117,0,1,0,0,0
50863,207,4,203,201,0,0,0,0,0
50864,1872,32,1840,1780,4,4,1,0,1
51001,2615,88,2527,2440,2,3,0,1,10
51002,2909,524,2385,2207,33,3,26,67,1
51003,1719,91,1628,1552,26,5,6,5,0
51004,956,31,925,894,2,6,1,1,0
51005,1474,76,1398,1356,0,1,2,6,5
51006,1038,20,1018,993,0,0,0,5,4
51007,678,23,655,616,4,3,1,0,0
51008,129,9,120,117,1,0,0,0,0
51009,146,3,143,136,2,0,0,0,0
51010,421,5,416,393,2,3,0,0,6
51011,75,1,74,62,1,4,0,0,0
51012,6592,380,6212,5923,67,18,49,7,15
51014,546,14,532,522,1,1,1,0,0
51015,97,1,96,91,1,1,0,0,0
51016,1361,24,1337,1282,2,8,6,1,0
51018,385,9,376,366,1,1,0,0,0
51019,715,10,705,692,5,0,0,0,0
51020,637,54,583,561,2,0,5,0,4
51022,751,90,661,651,3,1,0,0,0
51023,3392,735,2657,2560,5,24,2,0,5
51024,1981,52,1929,1861,6,6,6,2,0
51025,2009,105,1904,1831,20,0,9,2,0
51026,741,23,718,689,9,1,2,2,0
51027,1302,79,1223,1189,3,1,2,0,4
51028,2058,46,2012,1952,10,2,4,2,0
51029,252,7,245,232,2,0,2,0,1
51030,1780,56,1724,1674,8,2,5,0,1
51031,12960,1098,11862,11041,311,22,88,83,27
51033,428,34,394,387,1,0,0,0,0
51034,1698,39,1659,1608,8,4,0,0,5
51035,1535,43,1492,1423,13,4,3,1,4
51036,676,46,630,611,2,0,1,0,1
51037,349,1,348,341,1,0,0,0,0
51038,1562,48,1514,1427,13,3,5,14,9
51039,2576,75,2501,2395,12,4,6,0,2
51040,3537,65,3472,3189,11,114,16,2,7
51041,7195,653,6542,6293,50,23,80,0,8
51044,209,8,201,193,0,1,0,0,1
51045,79,4,75,72,0,0,0,0,0
51046,1497,43,1454,1412,9,2,0,0,7
51047,588,19,569,557,0,1,0,0,1
51048,571,12,559,540,0,3,1,0,0
51049,425,9,416,405,0,0,0,0,2
51050,2625,55,2570,2482,13,4,5,10,3
51051,59,0,59,57,0,0,0,0,0
51052,956,38,918,883,5,2,3,2,1
51053,1069,158,911,865,5,0,13,4,3
51054,5737,342,5395,4903,82,52,150,9,14
51055,1381,43,1338,1262,1,23,7,2,5
51056,404,7,397,388,0,4,3,0,0
51058,972,12,960,936,4,0,1,0,2
51060,546,6,540,530,0,0,2,0,1
51061,419,4,415,396,0,0,0,0,1
51062,469,41,428,412,0,4,1,0,0
51063,1032,104,928,874,3,21,3,0,2
51101,1146,163,983,637,170,104,33,4,5
51103,16827,5069,11758,8422,902,649,750,197,37
51104,23080,4469,18611,14668,1606,359,951,111,95
51105,10565,3827,6738,4273,1124,320,492,96,31
51106,28655,3370,25285,22042,992,302,435,218,144
51108,5967,813,5154,4721,89,23,74,11,17
51109,3109,373,2736,2482,55,31,36,2,10
51111,97,19,78,61,7,0,6,0,0
51201,6408,670,5738,5442,77,17,57,11,7
51230,451,25,426,412,3,0,2,0,0
51231,232,7,225,220,0,1,1,0,0
51232,781,25,756,740,3,3,0,0,0
51234,1167,83,1084,1071,2,1,2,0,0
51235,1122,35,1087,1064,3,2,0,0,1
51237,1654,26,1628,1534,3,4,4,40,0
51238,1251,52,1199,1160,4,3,4,0,0
51239,3343,346,2997,2908,6,3,19,0,11
51240,1816,85,1731,1698,5,0,6,0,4
51241,1916,45,1871,1819,6,4,4,0,0
51242,344,29,315,311,1,0,0,0,0
51243,742,35,707,685,2,1,0,3,0
51244,74,0,74,73,0,0,0,0,0
51245,1306,48,1258,1207,13,4,6,0,6
51246,3834,130,3704,3589,17,9,8,0,0
51247,5432,929,4503,4408,19,10,8,0,3
51248,1828,87,1741,1656,30,10,10,0,0
51249,3558,474,3084,2917,21,12,17,36,4
51250,9427,1792,7635,7335,60,14,91,0,12
51301,12606,612,11994,11431,90,28,97,2,12
51331,1102,17,1085,1064,1,0,2,0,0
51333,440,7,433,420,2,0,0,0,0
51334,7105,831,6274,5951,86,27,29,3,8
51338,950,18,932,905,4,3,7,0,0
51340,90,5,85,77,2,0,0,0,0
51341,34,0,34,33,0,0,0,0,0
51342,1227,34,1193,1163,1,0,1,1,0
51343,263,3,260,255,0,0,0,0,0
51345,414,23,391,372,0,2,0,0,2
51346,2343,151,2192,2097,27,4,8,0,4
51347,1489,16,1473,1425,5,2,3,0,2
51350,384,38,346,336,1,0,0,0,0
51351,4844,158,4686,4502,27,2,30,1,8
51354,974,27,947,916,1,2,4,0,5
51355,847,15,832,822,2,0,4,0,0
51357,611,15,596,578,1,3,0,0,0
51358,1274,28,1246,1205,8,2,9,0,7
51360,8553,176,8377,8079,38,9,39,0,15
51363,132,3,129,126,0,0,2,0,0
51364,616,18,598,576,3,1,0,0,0
51365,327,27,300,298,0,1,0,0,0
51366,377,9,368,362,0,0,0,0,0
51401,12248,461,11787,11211,252,8,56,0,10
51430,788,6,782,762,4,0,0,0,0
51431,404,6,398,385,0,0,0,0,6
51432,35,0,35,35,0,0,0,0,0
51433,643,11,632,607,4,1,1,0,3
51436,929,9,920,898,1,0,2,0,0
51439,881,49,832,807,5,0,1,2,1
51440,357,3,354,352,0,0,0,0,0
51441,344,78,266,258,1,0,1,0,1
51442,9763,4371,5392,4586,350,24,284,0,18
51443,1751,31,1720,1700,0,3,1,0,5
51444,284,1,283,278,1,1,0,0,0
51445,2717,66,2651,2591,5,0,3,4,2
51446,520,11,509,490,3,0,0,0,0
51447,198,22,176,173,0,0,2,0,0
51448,545,25,520,502,10,0,3,0,0
51449,2098,28,2070,2009,5,2,5,0,0
51450,1475,19,1456,1433,2,1,0,0,3
51451,112,2,110,103,0,0,0,0,3
51452,166,2,164,162,0,0,1,0,0
51453,631,10,621,598,2,0,2,0,6
51454,1291,73,1218,1179,2,0,3,1,0
51455,2185,20,2165,2109,0,5,13,0,0
51458,1451,19,1432,1396,5,3,2,1,2
51459,75,0,75,74,0,0,0,0,0
51460,110,11,99,94,1,0,0,0,1
51461,1095,112,983,947,4,5,9,1,0
51462,1033,25,1008,977,1,1,7,0,0
51463,515,3,512,500,2,1,1,0,0
51465,696,96,600,578,6,0,0,0,3
51466,1071,14,1057,1039,1,0,0,0,0
51467,567,14,553,545,3,0,2,0,0
51501,34906,4736,30170,26929,916,176,398,32,129
51503,37330,2031,35299,32669,790,143,284,41,88
51510,3791,409,3382,3055,86,25,23,0,15
51520,185,9,176,171,0,0,0,0,2
51521,2202,67,2135,2035,11,8,14,0,4
51523,358,11,347,335,1,1,1,0,1
51525,1151,27,1124,1074,6,2,2,0,1
51526,1629,29,1600,1545,1,2,6,1,3
51527,475,27,448,437,1,2,1,0,0
51528,829,73,756,740,1,1,0,0,1
51529,1665,13,1652,1605,2,7,5,0,2
51530,728,9,719,698,0,3,1,0,0
51531,806,20,786,773,2,0,0,0,0
51532,604,4,600,588,0,0,1,0,0
51533,816,12,804,780,2,1,0,1,4
51534,9342,305,9037,8615,56,15,26,6,9
51535,1764,43,1721,1662,4,1,1,2,6
51536,458,14,444,413,0,6,0,0,2
51537,6509,273,6236,5932,42,19,44,3,8
51540,469,5,464,447,3,0,2,0,0
51541,360,3,357,340,1,2,0,0,0
51542,1018,19,999,964,5,2,5,0,0
51543,381,1,380,370,0,0,0,0,1
51544,648,34,614,604,0,1,2,0,2
51545,345,18,327,320,2,0,1,0,1
51546,2815,42,2773,2696,5,3,5,0,0
51548,486,6,480,459,0,3,1,0,4
51549,498,11,487,470,2,2,3,0,0
51550,190,3,187,170,0,0,0,0,2
51551,1783,55,1728,1647,7,1,4,2,8
51552,265,2,263,247,0,2,0,0,0
51553,992,16,976,951,3,0,1,0,2
51554,172,6,166,154,1,0,0,0,2
51555,5099,138,4961,4779,7,12,18,0,9
51556,428,4,424,403,3,0,4,0,0
51557,779,12,767,751,1,1,0,0,4
51558,518,4,514,503,1,2,0,0,1
51559,1911,41,1870,1805,4,4,5,0,6
51560,1998,160,1838,1762,6,9,13,1,8
51561,907,45,862,802,5,2,9,0,6
51562,463,4,459,450,0,0,0,0,1
51563,681,19,662,635,2,0,4,0,1
51564,501,2,499,483,0,1,1,0,2
51565,464,9,455,432,1,3,1,0,0
51566,6772,328,6444,6186,19,13,20,2,7
51570,1146,31,1115,1084,4,1,1,0,0
51571,635,9,626,592,0,0,2,0,7
51572,360,1,359,349,2,0,3,0,0
51573,1075,9,1066,1033,2,1,0,0,0
51575,1738,21,1717,1667,2,0,3,1,2
51576,2058,56,2002,1941,1,7,13,0,5
51577,1101,22,1079,1045,1,2,5,0,4
51578,116,1,115,113,0,0,0,0,0
51579,2437,50,2387,2316,5,1,10,0,3
51601,5681,231,5450,5178,19,14,49,0,9
51630,180,1,179,176,0,0,0,0,2
51631,297,8,289,281,1,0,0,0,0
51632,7024,197,6827,6147,339,35,63,0,3
51636,356,3,353,329,2,1,0,0,0
51637,173,4,169,162,0,0,0,0,1
51638,1189,11,1178,1130,4,10,5,0,0
51639,873,12,861,826,4,0,2,0,1
51640,1290,36,1254,1208,2,3,2,1,1
51645,219,2,217,208,0,0,0,0,4
51646,730,4,726,701,0,0,5,0,2
51647,173,6,167,157,0,0,0,0,0
51648,166,8,158,150,0,1,0,0,1
51649,355,6,349,342,2,0,1,0,0
51650,322,6,316,306,0,0,0,0,0
51651,147,1,146,143,0,0,0,0,0
51652,1629,89,1540,1467,0,9,2,1,11
51653,1357,29,1328,1275,4,0,3,3,2
51654,421,7,414,375,0,6,0,1,0
51656,60,2,58,53,0,0,0,0,0
52001,43572,1681,41891,35878,3281,81,404,570,134
52002,17177,424,16753,15251,428,14,359,213,38
52003,14060,350,13710,13133,83,23,90,17,38
52030,380,3,377,348,19,0,0,0,3
52031,5143,48,5095,4963,19,4,9,0,6
52032,1424,32,1392,1352,5,2,0,0,5
52033,3478,98,3380,3310,7,0,7,4,1
52035,915,10,905,879,3,1,1,0,0
52036,137,6,131,126,0,0,0,0,0
52037,1216,19,1197,1131,26,3,1,0,2
52038,478,6,472,468,0,0,2,0,0
52039,1195,12,1183,1123,1,2,15,0,2
52040,5911,175,5736,5501,105,4,14,9,15
52041,1490,24,1466,1431,1,1,6,0,2
52042,1828,21,1807,1761,3,1,5,0,4
52043,2047,30,2017,1983,7,1,1,1,0
52044,158,0,158,157,0,0,0,0,0
52045,2739,43,2696,2523,47,2,89,0,11
52046,2391,79,2312,2287,4,0,4,0,4
52047,570,13,557,537,2,1,2,0,0
52048,327,1,326,320,0,0,1,0,0
52049,1339,44,1295,1263,7,4,1,1,0
52050,490,10,480,472,0,1,0,0,0
52052,2955,31,2924,2822,11,9,9,1,11
52053,1120,14,1106,1089,0,0,1,0,0
52054,920,10,910,884,7,1,0,0,0
52056,245,3,242,236,0,0,3,0,0
52057,8064,127,7937,7599,95,16,28,0,16
52060,8494,130,8364,7798,84,19,36,190,19
52064,752,3,749,727,3,1,0,0,1
52065,802,18,784,777,5,0,0,0,0
52066,86,0,86,85,1,0,0,0,0
52068,4835,59,4776,4572,63,4,27,0,7
52069,1512,23,1489,1464,6,1,0,0,6
52070,1006,13,993,970,2,9,0,0,0
52071,120,0,120,116,0,0,0,0,0
52072,384,6,378,361,0,0,1,0,0
52073,1590,26,1564,1531,4,0,6,0,0
52074,328,5,323,311,0,1,0,0,0
52075,143,0,143,138,1,0,0,0,2
52076,2123,42,2081,1996,5,7,3,2,3
52077,362,2,360,353,0,0,2,1,0
52078,847,5,842,830,0,0,0,0,1
52079,753,3,750,728,4,0,0,0,12
52101,13186,362,12824,12203,108,13,162,12,25
52132,1832,56,1776,1714,7,2,7,0,4
52133,473,24,449,436,0,0,1,0,0
52134,252,13,239,233,0,1,0,0,2
52135,793,10,783,775,0,2,2,0,0
52136,6009,136,5873,5638,23,22,23,1,6
52140,553,10,543,537,0,1,0,0,3
52141,1386,22,1364,1333,2,2,5,0,0
52142,1797,59,1738,1606,56,7,25,0,5
52144,1186,17,1169,1151,2,0,1,0,0
52146,867,5,862,849,0,0,3,0,2
52147,947,21,926,888,0,0,0,0,4
52151,2057,22,2035,1965,7,2,8,1,2
52154,981,34,947,918,2,1,3,0,1
52155,1244,55,1189,1144,0,2,5,2,5
52156,739,29,710,693,8,0,3,0,0
52157,1645,16,1629,1583,3,11,6,0,3
52158,273,2,271,253,2,1,0,0,0
52159,2232,29,2203,2138,6,0,13,0,2
52160,808,8,800,782,0,2,0,1,2
52161,1409,61,1348,1327,2,4,3,0,0
52162,3481,1114,2367,2063,217,2,21,1,10
52163,273,23,250,241,0,4,0,0,0
52164,193,0,193,183,1,0,0,0,0
52165,876,58,818,805,0,1,0,0,0
52166,127,0,127,125,0,0,0,0,2
52168,379,1,378,370,1,0,1,0,0
52169,417,4,413,395,1,2,0,0,2
52170,499,11,488,481,0,0,0,0,0
52171,926,11,915,883,1,0,0,0,2
52172,6097,131,5966,5833,25,7,10,2,6
52175,3412,97,3315,3158,46,7,17,0,4
52201,1177,129,1048,995,2,0,4,0,8
52202,1112,11,1101,1051,4,2,4,0,5
52203,1911,35,1876,1802,5,0,10,0,11
52205,8782,269,8513,7819,358,31,36,2,25
52206,2635,18,2617,2518,8,3,5,0,2
52207,343,3,340,326,0,0,0,0,2
52208,2951,50,2901,2768,13,2,17,0,5
52209,1106,75,1031,1004,2,0,0,0,4
52210,746,19,727,705,4,0,1,0,0
52211,2592,59,2533,2461,5,8,6,0,2
52212,274,4,270,253,1,2,0,0,3
52213,4408,53,4355,4154,17,5,16,1,10
52214,3001,39,2962,2848,8,0,7,0,7
52215,692,75,617,593,3,2,5,0,0
52216,1461,17,1444,1403,7,3,3,0,1
52217,505,6,499,474,1,0,5,0,2
52218,1726,12,1714,1658,4,4,0,1,5
52219,160,2,158,148,0,0,0,0,2
52220,252,7,245,237,3,0,0,0,0
52221,224,4,220,218,0,1,0,0,0
52222,635,14,621,618,0,0,0,0,0
52223,1389,11,1378,1356,7,0,0,0,4
52224,1890,28,1862,1806,5,0,7,0,1
52225,427,5,422,412,0,0,1,0,0
52227,3089,68,3021,2880,18,5,21,0,13
52228,3402,84,3318,3126,45,4,32,1,2
52229,730,26,704,681,1,0,1,0,1
52231,316,3,313,304,0,0,0,0,0
52232,181,5,176,173,0,1,0,0,1
52233,7091,267,6824,5629,480,5,311,14,32
52235,858,47,811,735,40,0,6,0,1
52236,570,15,555,536,2,1,2,0,2
52237,1593,19,1574,1526,12,3,1,0,0
52240,34224,3534,30690,23706,3666,57,1715,5,157
52241,22319,1555,20764,14714,3088,36,1940,3,69
52242,5657,343,5314,4786,89,0,293,0,3
52245,21874,1272,20602,17451,1117,22,995,3,100
52246,22829,1550,21279,14363,3049,22,2751,10,96
52247,5976,189,5787,5582,47,1,18,0,14
52248,1674,37,1637,1579,8,2,1,0,3
52249,912,20,892,864,3,4,1,0,4
52251,501,11,490,476,3,0,1,0,0
52252,50,5,45,45,0,0,0,0,0
52253,3356,56,3300,3186,24,3,7,0,5
52254,878,10,868,830,7,0,4,0,2
52255,1189,17,1172,1134,2,3,3,0,0
52257,259,6,253,244,2,0,0,0,0
52301,3745,129,3616,3448,8,3,10,0,24
52302,43130,1335,41795,37629,1266,54,923,13,110
52305,663,23,640,615,1,0,0,0,0
52306,1653,38,1615,1540,9,7,8,1,5
52307,145,0,145,139,1,0,3,0,0
52308,135,14,121,120,0,0,0,0,0
52309,419,3,416,405,0,0,1,0,1
52310,6417,138,6279,6027,48,6,24,0,31
52312,96,2,94,87,1,0,0,0,0
52313,391,9,382,374,0,2,2,0,0
52314,5937,192,5745,5351,72,11,98,2,15
52315,1171,17,1154,1099,4,1,3,1,2
52316,1622,62,1560,1489,11,4,3,0,4
52317,22096,1281,20815,17756,1293,22,637,13,64
52318,908,11,897,857,5,0,5,0,1
52320,1087,7,1080,1044,12,1,1,0,2
52321,451,8,443,409,10,0,0,0,0
52322,2260,50,2210,2107,10,3,12,2,5
52323,738,9,729,705,0,5,0,0,1
52324,2476,48,2428,2291,33,0,16,0,2
52325,815,11,804,755,6,1,6,0,1
52326,565,3,562,545,0,0,0,0,0
52327,3333,91,3242,3129,18,3,6,1,7
52328,2889,57,2832,2661,23,0,54,0,9
52329,722,14,708,689,1,0,0,1,0
52330,848,6,842,829,3,0,0,0,0
52332,1995,35,1960,1828,10,0,8,0,6
52333,7312,105,7207,6898,22,4,43,3,8
52334,355,4,351,331,3,0,0,0,1
52335,605,17,588,560,8,0,3,0,0
52336,2310,48,2262,2156,4,9,12,3,0
52337,828,13,815,776,7,3,0,0,2
52338,3457,40,3417,3257,19,5,25,0,8
52339,4717,1088,3629,2456,47,884,24,0,5
52340,4810,256,4554,3945,222,13,111,2,17
52341,1045,11,1034,994,2,0,7,0,3
52342,3192,475,2717,2382,41,152,20,1,4
52344,22,0,22,22,0,0,0,0,0
52345,1572,18,1554,1490,8,0,6,1,1
52346,1094,25,1069,1022,10,0,1,0,3
52347,1392,23,1369,1324,11,3,1,0,0
52348,48,2,46,44,0,0,0,0,0
52349,7405,114,7291,6997,42,15,24,0,30
52351,1380,25,1355,1291,5,0,4,0,7
52352,1815,10,1805,1741,2,0,4,1,5
52353,9416,1106,8310,7813,104,8,80,2,37
52354,355,7,348,339,0,0,0,0,0
52355,267,7,260,254,0,0,1,0,0
52356,2833,80,2753,2650,12,5,1,0,12
52358,3839,172,3667,3492,19,3,18,1,6
52359,270,5,265,251,0,0,0,0,0
52361,5018,195,4823,4518,59,18,53,1,14
52362,920,7,913,879,5,7,0,0,1
52401,2320,128,2192,1460,496,3,50,4,4
52402,42072,2147,39925,32113,3208,71,2251,99,124
52403,23012,818,22194,18534,1969,60,249,24,65
52404,43385,2417,40968,31528,6027,89,716,302,151
52405,26382,985,25397,21187,2429,54,385,53,71
52411,7954,129,7825,7309,78,5,190,5,13
52501,30313,4199,26114,22509,1431,63,605,515,77
52530,1028,42,986,952,4,1,3,1,2
52531,5817,107,5710,5509,18,5,13,1,23
52533,1157,27,1130,1075,4,1,2,3,2
52534,366,6,360,334,0,0,7,0,0
52535,798,14,784,757,2,2,0,0,0
52536,990,20,970,931,1,0,4,0,0
52537,7248,122,7126,6941,4,6,15,0,7
52540,1408,29,1379,1328,0,4,3,0,9
52542,462,5,457,448,0,0,4,0,0
52543,287,2,285,274,0,0,0,1,2
52544,7481,183,7298,6940,74,12,55,0,14
52548,76,4,72,67,0,0,0,1,0
52549,646,2,644,620,0,2,1,0,0
52550,486,12,474,460,1,0,0,0,0
52551,638,12,626,604,0,1,1,0,1
52552,894,6,888,867,0,1,2,0,0
52553,1639,30,1609,1549,7,1,14,0,6
52554,1222,31,1191,1145,0,0,0,1,1
52555,311,3,308,301,0,0,3,0,0
52556,11736,522,11214,10008,222,34,403,2,68
52557,537,26,511,220,179,5,94,4,3
52560,408,6,402,388,1,1,0,0,2
52561,901,23,878,848,4,1,0,0,4
52562,41,0,41,41,0,0,0,0,0
52563,1423,30,1393,1355,5,0,0,0,1
52565,1940,33,1907,1852,7,2,13,0,0
52566,164,2,162,147,0,0,1,0,7
52567,562,12,550,535,1,0,0,0,0
52568,97,4,93,92,0,0,0,0,0
52569,609,6,603,590,0,2,1,0,3
52570,961,24,937,913,5,1,3,0,1
52571,1499,6,1493,1461,0,1,2,0,0
52572,1206,16,1190,1141,0,0,2,0,0
52573,158,0,158,156,1,0,1,0,0
52574,699,6,693,681,0,4,0,0,0
52576,556,12,544,529,4,0,1,0,0
52577,14974,398,14576,13378,361,28,224,14,20
52580,441,9,432,420,2,0,0,0,1
52581,277,5,272,262,1,0,3,0,0
52583,312,0,312,308,0,0,0,0,0
52584,505,4,501,490,1,2,0,0,0
52585,940,24,916,886,0,0,0,0,0
52586,496,2,494,481,2,0,0,0,3
52588,141,0,141,137,1,0,0,0,0
52590,1503,14,1489,1429,0,5,5,0,1
52591,2993,49,2944,2827,20,3,6,0,1
52593,110,1,109,107,0,0,2,0,0
52594,371,4,367,361,0,0,1,0,0
52595,428,6,422,382,2,3,2,0,3
52601,27899,980,26919,22812,2286,59,244,12,93
52619,553,9,544,528,2,1,0,1,3
52620,878,10,868,849,2,0,1,0,1
52621,681,24,657,620,7,1,3,0,2
52623,1989,22,1967,1869,6,1,8,2,16
52624,354,7,347,332,7,1,0,0,0
52625,2498,37,2461,2382,8,0,3,0,3
52626,1222,20,1202,1158,1,1,0,0,1
52627,12350,702,11648,10513,476,27,64,2,36
52630,375,4,371,354,0,0,1,1,2
52631,75,3,72,69,0,0,0,0,0
52632,12006,247,11759,10650,368,14,66,5,20
52635,634,13,621,595,1,2,0,0,3
52637,2651,43,2608,2484,25,0,5,0,6
52638,546,6,540,514,5,0,5,0,1
52639,1847,40,1807,1717,25,3,4,0,0
52640,1331,73,1258,1220,2,0,4,0,0
52641,12920,883,12037,10666,455,45,414,6,48
52644,373,8,365,343,1,1,3,0,0
52645,3211,57,3154,2991,28,7,11,2,5
52646,415,9,406,380,4,0,2,0,1
52647,192,9,183,167,7,1,1,0,0
52649,883,14,869,840,2,0,3,0,8
52650,813,5,808,795,1,0,3,0,0
52651,613,7,606,575,9,2,1,0,1
52652,55,0,55,52,0,0,2,0,0
52653,3427,247,3180,3031,22,5,10,0,3
52654,1630,44,1586,1527,0,1,11,0,8
52655,4438,180,4258,3729,174,7,128,6,10
52656,2351,25,2326,2247,6,1,1,0,4
52657,109,0,109,105,1,0,0,0,0
52658,957,36,921,903,4,1,1,0,0
52659,1499,78,1421,1343,8,5,8,0,4
52660,214,4,210,199,0,0,4,0,2
52701,113,0,113,106,0,0,1,0,0
52720,842,36,806,771,3,0,1,0,5
52721,727,7,720,695,0,0,7,0,0
52722,40629,2095,38534,32878,1429,66,2430,13,130
52726,4585,148,4437,4263,23,6,18,0,11
52727,372,2,370,361,0,0,0,0,0
52728,1037,70,967,908,1,1,5,0,2
52729,775,14,761,738,2,1,1,0,0
52730,5009,116,4893,4630,34,11,21,1,12
52731,835,36,799,770,0,0,1,0,5
52732,25808,1072,24736,21955,1210,69,190,9,69
52737,392,220,172,153,4,2,7,0,3
52738,3404,1053,2351,2016,38,1,236,0,6
52739,679,207,472,419,18,0,12,0,3
52742,7651,210,7441,7098,106,10,27,0,12
52745,561,13,548,496,3,0,1,0,2
52746,933,18,915,868,2,3,0,0,6
52747,2178,48,2130,2040,11,10,2,1,10
52748,9942,365,9577,8896,256,13,61,4,25
52749,958,58,900,873,2,0,0,0,4
52750,593,4,589,576,2,1,0,0,0
52751,1066,23,1043,1001,3,1,3,0,0
52752,405,45,360,344,6,0,0,0,0
52753,6176,199,5977,5532,104,9,67,0,22
52754,1318,34,1284,1247,3,1,3,0,1
52755,1996,100,1896,1814,9,2,9,0,3
52756,2178,47,2131,2070,11,0,1,1,5
52757,247,5,242,236,0,0,0,0,0
52758,231,3,228,219,0,0,0,0,0
52759,132,8,124,118,0,0,1,0,1
52760,579,10,569,543,4,0,3,0,0
52761,30530,4906,25624,23318,1014,48,285,0,76
52765,436,16,420,399,0,1,0,0,2
52766,735,53,682,654,4,2,6,0,1
52767,397,8,389,375,0,0,5,0,2
52768,1394,40,1354,1295,10,2,1,1,6
52769,679,18,661,639,4,2,1,1,1
52771,46,0,46,45,0,0,0,0,0
52772,5129,125,5004,4823,19,11,12,0,17
52773,2301,65,2236,2138,11,1,7,0,13
52774,118,0,118,114,0,0,1,0,1
52776,5128,2350,2778,2569,22,5,82,0,13
52777,1322,30,1292,1231,1,5,2,0,1
52778,4088,153,3935,3745,16,4,19,0,10
52801,1446,74,1372,957,319,4,21,0,4
52802,9967,1373,8594,6711,1061,50,77,2,24
52803,22896,2269,20627,15859,2978,44,250,5,53
52804,25836,2270,23566,18832,2538,53,585,18,64
52806,28191,2167,26024,20035,3385,61,777,9,86
52807,15851,895,14956,12108,1568,12,522,2,68
53001,1857,52,1805,1728,4,4,10,0,6
53002,2436,102,2334,2245,0,8,21,1,9
53003,181,12,169,162,1,0,0,0,1
53004,3469,201,3268,3086,24,7,46,0,7
53005,21433,831,20602,17363,396,35,1918,6,73
53006,1767,72,1695,1641,6,0,4,0,0
53007,1787,79,1708,1439,117,12,54,1,5
53010,7497,137,7360,7145,18,11,24,1,10
53011,2259,80,2179,2113,4,2,6,0,8
53012,19027,438,18589,17590,144,21,242,3,48
53013,3338,145,3193,3059,9,4,25,0,11
53014,8073,557,7516,7203,24,27,25,18,20
53015,2625,234,2391,2277,5,4,44,0,0
53016,405,28,377,352,5,5,7,0,0
53017,5496,90,5406,5145,44,5,59,0,10
53018,7396,199,7197,6828,41,9,97,2,14
53019,1942,127,1815,1740,2,5,5,0,5
53020,3474,55,3419,3319,3,5,17,0,4
53021,4715,203,4512,4338,43,9,11,1,12
53022,19935,638,19297,17040,611,47,886,2,41
53023,1409,52,1357,1316,1,4,5,0,4
53024,18291,536,17755,16505,177,36,481,5,55
53027,23254,1102,22152,20990,175,45,190,5,95
53029,21239,671,20568,19298,122,43,377,11,41
53031,74,12,62,61,0,0,0,0,0
53032,4933,236,4697,4471,33,18,19,2,5
53033,5502,84,5418,5222,21,5,62,1,23
53034,1733,40,1693,1583,7,23,7,0,6
53035,2282,42,2240,2152,5,5,5,0,0
53036,3540,104,3436,3316,11,2,22,1,11
53037,10072,234,9838,9326,89,8,106,5,31
53038,4372,415,3957,3694,26,3,51,1,23
53039,4582,325,4257,4046,69,16,11,0,15
53040,8358,231,8127,7757,67,16,46,3,16
53042,6886,191,6695,6465,30,17,35,1,9
53044,2404,58,2346,2125,11,1,121,0,11
53045,23651,783,22868,18307,462,29,3203,3,91
53046,1355,39,1316,1175,15,4,58,0,0
53047,164,1,163,161,1,0,0,0,0
53048,3542,185,3357,3210,32,12,17,0,7
53049,2536,75,2461,2390,6,5,9,0,2
53050,7071,299,6772,6481,29,15,34,2,17
53051,38562,1251,37311,32022,1432,79,2349,9,113
53057,1552,33,1519,1478,5,2,5,0,1
53058,3340,100,3240,3077,20,0,40,2,6
53059,1774,63,1711,1614,3,4,5,3,10
53061,5055,145,4910,4723,28,26,11,9,13
53063,1501,37,1464,1390,8,6,12,1,7
53065,2128,47,2081,1991,9,6,15,0,0
53066,36595,1207,35388,33657,212,60,334,9,98
53069,732,14,718,677,4,1,2,2,1
53070,4893,183,4710,4502,21,8,37,0,29
53072,26687,901,25786,23265,327,44,1273,5,68
53073,16286,678,15608,14260,622,93,176,2,50
53074,13379,500,12879,12018,246,34,132,2,31
53075,3219,111,3108,3028,6,6,19,0,6
53076,3760,70,3690,3484,32,10,69,1,11
53078,1858,24,1834,1779,3,5,6,0,5
53079,1534,36,1498,1478,3,2,0,1,0
53080,5457,233,5224,4932,50,18,58,2,15
53081,43465,5315,38150,30275,1358,166,4650,13,121
53083,21768,1406,20362,17660,315,46,1571,3,79
53085,11671,467,11204,10588,82,20,215,3,27
53086,9209,299,8910,8473,52,14,81,0,23
53088,279,2,277,271,0,2,0,0,1
53089,19657,597,19060,17631,218,33,542,8,62
53090,21478,890,20588,19602,232,50,130,2,42
53091,2013,57,1956,1905,11,4,4,0,5
53092,21052,735,20317,18134,570,22,876,0,43
53093,1937,49,1888,1816,3,3,19,0,5
53094,18510,1732,16778,15723,251,51,136,6,44
53095,27269,1090,26179,24541,347,68,301,8,97
53097,7380,275,7105,6052,230,17,428,1,137
53098,11562,701,10861,10383,63,28,95,3,26
53099,38,1,37,37,0,0,0,0,0
53103,3833,108,3725,3522,18,11,15,0,24
53104,5950,332,5618,5241,45,17,51,0,21
53105,29654,1920,27734,26310,204,42,207,11,51
53108,3317,279,3038,2837,27,17,36,0,21
53110,18204,2798,15406,13367,755,132,288,4,53
53114,2491,470,2021,1874,21,3,13,0,11
53115,15884,3604,12280,11507,140,40,119,2,32
53118,7085,220,6865,6583,16,21,34,0,7
53119,5751,192,5559,5330,32,13,26,0,20
53120,10024,338,9686,9298,65,20,39,0,33
53121,19222,1794,17428,16444,122,34,161,0,50
53122,6578,221,6357,5881,51,5,157,3,20
53125,3405,257,3148,2943,91,6,63,2,2
53126,6889,419,6470,6028,77,14,76,2,31
53127,152,9,143,132,3,1,1,0,0
53128,9064,901,8163,7712,39,36,28,3,31
53129,14793,1151,13642,12203,225,48,632,7,37
53130,7743,602,7141,6549,154,14,137,0,20
53132,36166,2418,33748,27982,1814,98,2700,2,108
53137,1702,67,1635,1594,3,3,14,1,1
53139,2909,114,2795,2677,10,0,9,0,5
53140,30571,6418,24153,18674,3542,80,309,10,109
53142,33146,4490,28656,24101,1769,59,1091,9,97
53143,22702,4804,17898,13678,2674,58,198,24,67
53144,26702,5162,21540,16982,2806,60,510,12,73
53146,7677,387,7290,6843,49,21,163,3,27
53147,17859,2295,15564,14572,108,32,224,0,56
53149,19644,769,18875,17853,90,35,164,2,55
53150,25804,909,24895,23603,75,51,305,5,66
53151,32535,1431,31104,27868,444,76,1730,10,78
53153,2559,73,2486,2366,4,13,16,0,12
53154,36497,3448,33049,27799,1228,155,2508,7,89
53156,2972,220,2752,2657,8,10,2,1,7
53157,80,10,70,68,1,0,0,0,0
53158,17559,1557,16002,14187,495,36,454,4,68
53167,383,18,365,344,0,0,1,1,0
53168,8687,502,8185,7738,33,15,54,3,17
53170,2362,114,2248,2113,16,9,8,0,8
53172,20795,2704,18091,16062,684,131,318,1,73
53176,137,20,117,109,0,0,0,0,1
53177,8482,853,7629,5904,1172,55,142,4,38
53178,2703,72,2631,2510,13,6,7,0,16
53179,6206,385,5821,5416,31,16,49,5,26
53181,7696,415,7281,6936,27,15,33,0,21
53182,9422,439,8983,8306,208,51,71,0,36
53183,3110,132,2978,2839,9,5,43,0,9
53184,4096,580,3516,3299,31,7,32,0,10
53185,18761,705,18056,17290,55,36,122,2,48
53186,32332,4673,27659,24109,979,94,1257,16,99
53188,35552,3900,31652,28465,885,77,913,15,88
53189,26846,2271,24575,22386,640,46,556,12,79
53190,19459,2480,16979,15340,645,56,391,6,33
53191,3257,188,3069,2937,15,15,30,0,10
53192,211,17,194,189,1,0,0,0,0
53195,120,13,107,96,0,1,2,0,0
53202,27897,1780,26117,21352,2018,51,1493,4,189
53203,2180,162,2018,1454,274,8,125,0,28
53204,39728,27327,12401,5825,3961,265,1301,14,147
53205,9397,607,8790,591,7243,27,578,2,38
53206,22816,754,22062,437,20717,54,127,2,87
53207,34292,6023,28269,24824,1000,183,604,14,131
53208,29644,2727,26917,8623,13628,181,2960,12,122
53209,44586,2107,42479,9432,30217,95,864,9,189
53210,25588,1433,24155,4187,18293,49,516,5,143
53211,36327,2121,34206,28703,1547,65,1861,11,468
53212,28702,2962,25740,10436,13371,95,304,5,192
53213,26469,1380,25089,21868,1261,73,660,6,111
53214,34297,6931,27366,21973,2576,304,678,8,157
53215,59359,40777,18582,10530,3288,382,2841,22,190
53216,30109,1171,28938,2646,24447,73,664,7,144
53217,30559,1362,29197,24579,1636,39,1561,18,133
53218,38488,1750,36738,3524,27716,123,3935,8,192
53219,34925,8936,25989,21293,1811,295,1057,14,116
53220,26869,5269,21600,17522,1225,158,1466,6,87
53221,39560,9951,29609,21026,2463,221,4338,7,171
53222,25422,1452,23970,14014,7382,64,1055,18,132
53223,28884,1490,27394,7796,15341,72,2896,13,122
53224,20786,1713,19073,4190,12228,33,1713,4,121
53225,25138,1364,23774,6337,14019,68,2140,9,108
53226,19921,1053,18868,15916,1182,37,823,6,72
53227,23310,2875,20435,17034,1330,119,817,3,116
53228,15341,1623,13718,11863,542,50,666,1,40
53233,15531,1645,13886,7544,4505,55,1189,11,64
53235,9175,1144,8031,7062,312,63,176,2,40
53295,114,17,97,68,25,0,1,0,0
53402,33621,4673,28948,23377,3296,86,453,9,145
53403,26269,6609,19660,11579,6438,49,206,10,109
53404,15532,4852,10680,5499,4152,53,68,2,93
53405,25561,4764,20797,15385,3690,72,253,3,112
53406,27078,2813,24265,18957,3286,66,667,3,125
53501,144,4,140,129,1,0,0,0,0
53502,2615,48,2567,2453,12,7,11,0,1
53503,1923,31,1892,1804,7,2,7,0,12
53504,1977,37,1940,1870,0,3,6,0,6
53505,398,20,378,371,0,0,2,0,0
53506,999,19,980,920,5,1,8,0,0
53507,2313,37,2276,2198,7,0,6,1,2
53508,5477,152,5325,5066,32,3,33,0,6
53510,1426,105,1321,1298,3,1,1,1,0
53511,48659,8736,39923,30641,5625,148,679,23,238
53515,2496,49,2447,2323,13,9,16,0,8
53516,2200,36,2164,2090,10,0,4,1,6
53517,1892,46,1846,1776,4,4,4,0,1
53518,1411,37,1374,1300,6,3,6,0,3
53520,6684,254,6430,6135,33,15,13,1,16
53521,3857,120,3737,3535,57,3,19,2,4
53522,1025,23,1002,939,4,3,5,0,4
53523,5277,126,5151,4907,41,3,34,1,13
53525,4028,420,3608,3419,48,9,12,3,7
53526,571,24,547,536,1,0,3,1,4
53527,10994,437,10557,9624,208,26,307,1,25
53528,6245,201,6044,5681,53,14,66,1,16
53529,2263,134,2129,2006,13,0,33,1,2
53530,4683,664,4019,3861,13,13,17,1,7
53531,4558,192,4366,4051,98,11,55,1,22
53532,15962,720,15242,13910,273,43,400,4,29
53533,7306,134,7172,6753,41,14,117,0,7
53534,12752,632,12120,11531,69,22,70,4,28
53536,9051,406,8645,8161,64,15,58,4,21
53537,707,6,701,681,2,0,0,0,0
53538,18643,1519,17124,16158,152,43,152,0,34
53540,125,5,120,107,0,0,1,0,2
53541,894,25,869,850,2,1,1,0,0
53543,1639,26,1613,1536,8,2,0,0,1
53544,838,10,828,805,2,2,0,4,4
53545,23318,1530,21788,19612,710,65,355,6,58
53546,31190,2191,28999,26464,720,49,406,2,81
53548,19233,1283,17950,15841,747,44,308,11,51
53549,10199,1037,9162,8547,109,26,40,0,19
53550,1213,25,1188,1155,0,0,2,0,3
53551,8920,462,8458,8079,38,24,59,1,15
53553,561,7,554,520,7,2,3,0,2
53554,1093,10,1083,1063,7,0,3,0,0
53555,8529,204,8325,7981,26,34,43,5,15
53556,2680,94,2586,2470,9,9,19,0,10
53557,395,11,384,369,0,0,0,0,0
53558,12666,376,12290,11251,155,30,321,6,21
53559,6104,684,5420,4919,139,23,80,3,18
53560,3714,92,3622,3416,31,6,33,0,14
53561,2016,50,1966,1886,11,8,2,1,7
53562,29092,1723,27369,22732,820,47,2417,12,100
53563,11503,367,11136,10568,48,28,139,1,34
53565,4899,77,4822,4670,17,0,20,6,4
53566,14970,894,14076,13432,88,17,90,1,23
53569,1147,66,1081,1043,1,2,6,0,2
53570,2643,78,2565,2451,11,3,6,0,7
53571,336,8,328,315,2,0,1,0,0
53572,10549,327,10222,9645,85,18,81,0,43
53573,3018,52,2966,2860,7,10,4,1,3
53574,4113,94,4019,3856,18,5,19,0,7
53575,17320,686,16634,15220,525,59,201,3,46
53576,2284,72,2212,2096,19,2,3,0,5
53577,1385,33,1352,1316,5,0,10,0,0
53578,6556,364,6192,5908,32,10,41,4,2
53579,1799,104,1695,1623,11,5,3,0,6
53580,507,8,499,482,0,1,0,0,0
53581,10024,362,9662,9176,82,22,70,0,8
53582,1068,34,1034,973,17,0,10,0,9
53583,5787,310,5477,5231,19,16,22,1,25
53584,53,0,53,51,0,0,0,0,2
53585,2130,296,1834,1686,17,0,8,0,6
53586,2101,137,1964,1918,1,1,5,0,4
53587,1169,34,1135,1107,5,1,2,0,1
53588,4139,99,4040,3898,10,11,17,0,5
53589,19888,708,19180,17854,289,33,258,5,50
53590,43684,2457,41227,33260,2707,96,2878,9,206
53593,28232,1191,27041,23647,395,39,1808,4,100
53594,5324,681,4643,4399,61,11,25,2,14
53597,20729,885,19844,18256,244,18,489,3,66
53598,4033,197,3836,3382,145,4,100,2,18
53599,71,0,71,69,1,0,0,0,0
53703,38512,2378,36134,28774,1441,105,3918,32,156
53704,47066,4747,42319,31646,5338,155,2483,18,177
53705,24695,1405,23290,17317,799,40,3812,6,127
53706,4337,249,4088,2998,66,14,765,2,15
53711,51448,6007,45441,36549,3465,113,2844,17,181
53713,23291,6373,16918,9580,4476,63,1544,10,99
53714,16289,1686,14603,11313,1807,37,541,5,92
53715,16517,871,15646,11578,702,62,2497,13,62
53716,19105,1336,17769,15527,848,55,409,10,91
53717,12798,698,12100,8835,785,15,1952,5,50
53718,17034,1151,15883,12361,1307,62,1268,12,87
53719,32151,3314,28837,21481,2364,66,3406,20,122
53726,5286,205,5081,4206,59,2,527,2,46
53792,0,0,0,0,0,0,0,0,0
53801,842,34,808,775,5,4,1,0,0
53802,64,0,64,64,0,0,0,0,0
53803,1258,15,1243,1212,1,0,2,0,2
53804,1353,25,1328,1304,3,1,4,0,0
53805,5395,132,5263,4819,272,20,19,1,8
53806,1577,13,1564,1523,2,2,5,0,3
53807,4565,76,4489,4368,7,11,17,1,2
53808,1041,11,1030,1004,10,1,6,0,0
53809,4409,139,4270,4119,14,4,20,0,6
53810,424,23,401,391,0,0,2,0,0
53811,3213,56,3157,3096,5,4,4,0,4
53812,406,3,403,398,1,0,1,0,0
53813,6267,120,6147,5935,46,4,27,3,9
53816,815,18,797,770,1,1,5,0,0
53817,201,18,183,166,8,5,0,0,0
53818,15786,454,15332,14328,271,24,276,4,26
53820,2421,28,2393,2333,13,1,11,0,1
53821,7838,178,7660,7112,237,32,47,1,17
53825,495,7,488,483,1,0,1,0,0
53826,1268,14,1254,1208,1,3,4,0,3
53827,291,12,279,268,3,0,0,0,0
53901,14924,710,14214,12857,586,118,133,2,36
53910,3264,129,3135,2977,18,10,12,0,4
53911,1383,51,1332,1287,7,0,8,0,1
53913,21046,1196,19850,18212,249,429,175,6,50
53916,23057,2385,20672,19408,300,43,190,0,49
53919,2334,125,2209,2141,9,3,3,5,1
53920,413,7,406,395,0,3,1,0,0
53922,961,18,943,909,1,1,1,1,6
53923,2160,123,2037,1967,5,2,3,0,9
53924,1333,15,1318,1274,0,7,1,0,0
53925,8523,358,8165,7705,82,14,64,3,14
53926,1785,32,1753,1706,2,1,2,0,2
53928,143,0,143,138,0,0,3,0,0
53929,2545,57,2488,2388,8,17,16,0,7
53930,1235,94,1141,1101,3,5,5,1,1
53931,346,10,336,330,3,0,0,0,0
53932,2716,111,2605,2446,14,10,13,0,2
53933,4278,240,4038,3299,607,28,29,0,0
53934,4214,135,4079,3888,28,16,20,3,13
53935,320,22,298,287,0,1,5,0,0
53936,1547,105,1442,1346,11,5,7,1,13
53937,1172,13,1159,1140,1,0,1,0,0
53939,248,7,241,234,0,0,0,0,1
53940,18,2,16,15,0,0,0,0,0
53941,3044,42,3002,2906,14,6,5,0,11
53942,121,0,121,119,1,0,0,0,0
53943,1067,16,1051,1023,4,2,0,0,0
53944,2370,82,2288,2140,17,38,8,0,1
53946,4239,169,4070,3948,18,7,15,0,10
53947,169,0,169,163,2,1,0,0,0
53948,8151,213,7938,7422,123,62,47,0,18
53949,6084,142,5942,5689,17,25,21,3,19
53950,5608,164,5444,4766,368,79,40,0,13
53951,2291,258,2033,1942,6,6,9,0,2
53952,4276,224,4052,3341,469,100,22,1,12
53953,207,10,197,181,0,0,1,0,2
53954,6907,122,6785,6513,24,19,36,0,10
53955,5951,105,5846,5596,34,30,27,0,7
53956,3416,178,3238,3118,22,9,20,0,12
53959,14298,858,13440,12693,141,111,71,2,36
53960,3370,73,3297,3160,19,5,14,0,12
53961,793,3,790,746,4,7,1,0,0
53962,51,1,50,42,0,0,0,0,0
53963,14078,608,13470,11404,1511,154,79,2,36
53964,3514,124,3390,3241,9,17,14,1,11
53965,11361,1226,10135,9135,209,333,80,2,28
53968,2326,32,2294,2200,11,6,8,0,6
53969,397,14,383,363,4,7,5,0,1
54001,8256,168,8088,7730,43,38,35,3,20
54002,6741,253,6488,6125,47,16,39,0,25
54003,1050,16,1034,1002,5,2,2,0,2
54004,2249,25,2224,2108,6,20,7,0,7
54005,3176,77,3099,2954,8,8,13,2,12
54006,824,12,812,784,2,2,5,0,6
54007,1276,26,1250,1193,3,3,11,0,3
54009,2746,95,2651,2470,11,16,19,1,7
54011,6881,165,6716,6390,27,20,26,0,17
54013,3482,97,3385,3212,16,8,19,5,12
54014,2368,40,2328,2226,4,6,7,0,3
54015,3936,142,3794,3628,7,4,32,0,4
54016,33198,1003,32195,30077,262,73,488,20,121
54017,19816,520,19296,18021,201,54,165,4,99
54020,7463,155,7308,7027,26,17,37,1,19
54021,6934,195,6739,6403,29,36,41,2,16
54022,23612,806,22806,21144,337,146,233,8,77
54023,4456,94,4362,4114,17,10,75,3,10
54024,4916,75,4841,4618,20,7,26,0,11
54025,7336,229,7107,6701,28,28,61,1,11
54026,2050,30,2020,1918,1,6,14,0,3
54027,1160,20,1140,1100,2,4,9,0,5
54028,2632,56,2576,2465,10,7,16,0,2
54082,1787,61,1726,1617,10,4,8,0,10
54101,2773,35,2738,2656,4,14,6,0,5
54102,809,8,801,776,0,1,2,0,2
54103,481,9,472,441,1,7,1,1,0
54104,1159,17,1142,1085,3,10,3,0,2
54106,4674,95,4579,4312,8,30,64,0,10
54107,3691,66,3625,3469,14,53,10,0,8
54110,5542,309,5233,5007,18,30,21,2,10
54111,2164,98,2066,1961,1,39,3,0,3
54112,2227,76,2151,2055,4,14,2,0,9
54113,3631,107,3524,3352,30,11,28,1,3
54114,5913,141,5772,5549,7,33,8,0,9
54115,48710,1689,47021,42052,587,1303,1272,39,87
54119,613,14,599,563,12,3,2,0,1
54120,204,3,201,183,0,5,0,1,1
54121,3149,52,3097,2969,7,19,1,1,8
54123,248,20,228,227,0,0,0,0,0
54124,3619,158,3461,3089,4,197,5,0,13
54125,499,4,495,473,0,0,2,0,2
54126,4120,306,3814,3647,13,20,10,0,5
54127,110,10,100,89,0,8,0,0,0
54128,1718,46,1672,1083,6,436,2,0,1
54129,3525,268,3257,3114,11,26,13,0,4
54130,27473,863,26610,24914,214,181,272,6,60
54135,3016,115,2901,413,2,2419,2,1,0
54136,6703,262,6441,5889,86,23,184,0,13
54137,1098,21,1077,1042,3,6,3,0,3
54138,831,13,818,788,0,13,0,0,3
54139,3244,111,3133,2997,9,30,5,0,5
54140,8396,421,7975,7468,70,52,114,3,15
54141,2731,55,2676,2499,1,31,14,0,8
54143,15265,484,14781,13852,130,81,106,8,37
54149,1201,10,1191,1151,0,9,7,0,1
54150,1116,16,1100,24,0,1065,0,0,0
54151,3515,66,3449,3293,9,5,7,1,3
54152,249,35,214,191,2,6,0,0,2
54153,7323,197,7126,6692,30,106,24,0,5
54154,5432,130,5302,5014,35,61,16,0,10
54155,7853,313,7540,5420,53,1590,154,2,14
54156,1544,37,1507,1441,4,10,1,0,3
54157,5846,103,5743,5492,7,21,40,0,15
54159,1460,13,1447,1399,4,3,2,0,2
54160,244,8,236,233,0,0,0,0,0
54161,2789,122,2667,2546,7,26,6,0,6
54162,9570,206,9364,8899,20,78,61,0,18
54165,7877,184,7693,6931,30,359,51,0,20
54166,16892,548,16344,13732,72,1657,81,6,36
54169,3325,48,3277,3133,18,3,23,0,5
54170,3863,191,3672,3542,8,15,23,0,5
54171,4109,39,4070,3911,4,19,16,0,2
54173,4086,49,4037,3826,17,18,30,0,7
54174,3021,42,2979,2616,1,241,4,1,6
54175,1113,9,1104,1056,1,17,2,0,0
54177,2903,40,2863,2762,5,11,7,0,5
54180,3268,187,3081,2896,31,14,41,0,8
54201,5281,173,5108,4859,26,25,15,2,13
54202,1588,74,1514,1455,4,7,7,0,3
54204,1851,35,1816,1753,5,3,6,0,2
54205,2116,148,1968,1913,4,1,7,0,1
54207,174,3,171,167,1,1,0,0,0
54208,6363,144,6219,5997,17,14,22,0,14
54209,1480,43,1437,1407,1,0,3,0,6
54210,1050,11,1039,1006,0,2,4,0,2
54211,332,4,328,317,0,0,0,0,0
54212,1189,54,1135,1094,1,1,1,0,2
54213,1367,72,1295,1222,3,6,3,0,3
54214,442,7,435,427,1,2,0,0,0
54215,200,4,196,192,0,0,0,0,0
54216,6164,260,5904,5668,15,16,26,0,10
54217,7713,260,7453,7222,7,18,34,0,16
54220,40737,2599,38138,33819,807,204,1788,6,111
54227,1555,27,1528,1462,6,8,8,0,14
54228,2739,68,2671,2597,5,9,10,0,7
54229,4405,98,4307,4110,31,16,28,9,1
54230,4623,176,4447,4293,2,20,12,0,9
54232,714,56,658,632,0,0,2,0,3
54234,2072,49,2023,1966,3,0,10,0,4
54235,17829,763,17066,16091,118,98,88,0,54
54241,14258,469,13789,12646,156,83,318,5,39
54245,2184,143,2041,1976,1,10,10,0,5
54246,777,18,759,718,5,3,9,0,0
54247,2154,45,2109,2030,5,6,19,1,2
54301,22875,2530,20345,17199,949,488,568,2,111
54302,31327,10895,20432,15438,1544,558,1642,17,67
54303,27478,3069,24409,18505,1921,1019,1342,26,90
54304,27679,2091,25588,20896,926,1254,1045,8,63
54307,1062,80,982,294,645,41,2,0,0
54311,37532,3617,33915,29492,1113,384,1573,9,99
54313,39911,1204,38707,35180,331,967,683,5,70
54401,31727,1078,30649,25220,362,144,3683,8,110
54403,24712,871,23841,20522,332,130,1754,10,51
54405,2947,910,2037,1964,13,5,19,0,6
54406,3647,57,3590,3458,9,4,15,0,9
54407,1559,34,1525,1460,2,9,6,0,5
54408,1046,8,1038,978,3,11,4,0,6
54409,12827,320,12507,11729,78,182,55,3,16
54410,2321,30,2291,2213,2,8,10,5,2
54411,5025,145,4880,4762,17,12,8,0,8
54412,2046,71,1975,1926,6,6,2,0,1
54413,213,3,210,199,1,0,2,0,2
54414,3240,77,3163,3008,4,25,16,0,3
54416,1655,64,1591,774,4,644,0,0,1
54417,55,4,51,44,0,0,5,0,0
54418,1015,41,974,931,3,4,1,1,6
54420,1299,39,1260,1219,1,1,3,0,3
54421,3651,467,3184,3057,11,11,13,0,4
54422,1344,248,1096,1067,0,5,4,0,3
54423,2349,47,2302,2241,5,6,5,0,3
54424,1574,34,1540,1483,4,17,2,0,6
54425,1941,235,1706,1660,3,5,1,0,2
54426,4352,72,4280,4143,10,14,16,0,5
54427,1128,45,1083,1040,2,11,2,0,0
54428,1016,12,1004,952,0,11,2,0,3
54430,157,1,156,138,2,3,1,0,0
54433,1819,26,1793,1709,1,4,5,0,0
54435,2125,28,2097,2040,10,4,5,0,2
54436,2202,66,2136,2082,4,2,2,0,4
54437,3265,65,3200,3143,6,7,6,0,1
54440,2992,52,2940,2796,8,13,31,0,3
54441,816,7,809,792,0,0,2,0,1
54442,1104,20,1084,979,60,2,11,0,0
54443,2279,60,2219,2144,6,3,22,0,2
54446,2990,84,2906,2854,3,7,5,1,8
54447,569,8,561,546,3,0,0,0,0
54448,4280,89,4191,4021,4,3,68,0,7
54449,26417,784,25633,23995,236,59,555,13,68
54450,357,78,279,262,0,5,0,0,1
54451,11514,344,11170,10827,36,25,43,0,10
54452,18851,347,18504,17734,91,75,90,2,30
54454,1234,18,1216,1191,0,4,0,0,8
54455,18897,343,18554,17353,66,56,497,0,45
54456,5904,183,5721,5493,32,37,27,0,17
54457,8478,332,8146,7664,27,171,37,1,19
54458,94,2,92,92,0,0,0,0,0
54459,1199,13,1186,1159,2,3,1,0,7
54460,2532,104,2428,2346,5,9,5,0,13
54462,339,4,335,329,0,3,0,0,0
54463,714,2,712,686,1,10,0,0,3
54464,31,0,31,29,0,0,0,0,0
54465,617,5,612,592,0,8,1,0,1
54466,2710,47,2663,2597,6,14,2,0,1
54467,14850,771,14079,12759,164,32,698,5,20
54469,1734,43,1691,1559,15,13,39,0,8
54470,2022,79,1943,1846,15,2,9,0,3
54471,1856,31,1825,1712,11,13,48,0,2
54473,2582,61,2521,2450,3,4,1,0,3
54474,4134,83,4051,3620,37,14,222,1,12
54475,1498,40,1458,1407,3,3,2,0,2
54476,19668,601,19067,16125,204,91,1949,7,52
54479,3838,122,3716,3625,10,5,6,0,4
54480,1275,50,1225,1178,6,2,7,5,0
54481,28100,1045,27055,23990,660,138,1264,9,64
54482,9108,213,8895,8335,43,24,223,1,11
54484,4968,145,4823,4672,14,15,22,3,3
54485,412,1,411,393,0,2,1,0,3
54486,2157,29,2128,2034,4,19,3,0,3
54487,9750,178,9572,9186,14,38,36,0,16
54488,1192,82,1110,1077,0,0,0,2,3
54489,1491,24,1467,1377,0,35,12,2,4
54490,891,26,865,837,0,1,0,0,1
54491,1591,38,1553,1478,15,8,5,0,0
54493,660,9,651,632,0,5,0,0,0
54494,27420,832,26588,24755,225,185,594,8,79
54495,7638,349,7289,6572,80,84,215,1,26
54498,2440,57,2383,2329,6,9,4,0,1
54499,3005,135,2870,2598,11,123,7,0,8
54501,20591,346,20245,19108,137,236,109,9,33
54511,1335,18,1317,1246,3,29,5,0,2
54512,1007,10,997,956,1,13,5,0,3
54513,441,0,441,432,1,1,1,0,0
54514,1673,20,1653,1578,4,13,5,2,3
54515,479,7,472,447,3,7,0,1,1
54517,166,5,161,151,2,2,0,0,0
54519,1285,31,1254,1217,0,5,3,0,3
54520,4063,88,3975,2880,27,849,0,0,1
54521,8317,190,8127,7703,36,86,17,1,23
54524,596,2,594,560,0,16,1,1,0
54525,276,10,266,257,0,3,0,0,1
54526,840,8,832,798,2,3,0,1,4
54527,957,14,943,904,4,6,4,0,0
54529,1220,15,1205,1172,1,3,1,0,4
54530,717,2,715,689,0,0,1,1,2
54531,1479,20,1459,1406,1,6,3,2,11
54534,2481,21,2460,2333,8,32,7,0,13
54536,184,3,181,175,0,1,0,0,0
54537,576,9,567,548,0,0,3,1,0
54538,3133,88,3045,1008,5,1900,0,0,8
54539,1525,29,1496,1385,42,20,7,0,4
54540,1048,16,1032,996,0,14,5,0,2
54541,1325,12,1313,1197,0,56,8,5,0
54542,539,8,531,501,2,7,1,1,2
54545,852,11,841,826,0,2,0,0,4
54546,1213,13,1200,1142,2,20,4,0,0
54547,1639,19,1620,1557,2,16,4,0,11
54548,5406,86,5320,4901,9,187,50,3,36
54550,674,8,666,637,0,8,2,0,1
54552,4381,55,4326,4014,10,28,32,100,5
54554,1042,12,1030,983,1,4,1,0,4
54555,4887,75,4812,4586,15,24,23,18,23
54556,1200,15,1185,1139,0,4,3,1,2
54557,1210,19,1191,1154,0,2,5,0,8
54558,2215,37,2178,2114,3,8,7,1,1
54559,759,21,738,427,1,287,0,0,0
54560,648,9,639,628,0,3,1,0,0
54561,101,1,100,96,0,1,0,0,2
54562,2093,16,2077,2012,3,5,8,0,8
54563,689,14,675,659,2,2,0,0,2
54564,505,12,493,475,1,4,2,0,2
54565,54,1,53,53,0,0,0,0,0
54566,1429,17,1412,1087,1,242,2,1,0
54568,5175,82,5093,4753,6,108,26,2,14
54601,51090,1470,49620,44549,1059,198,1843,7,200
54603,14203,442,13761,11497,509,96,1005,2,45
54610,1521,40,1481,1428,6,15,1,2,1
54611,1162,86,1076,1027,4,8,1,0,4
54612,5816,2623,3193,3100,14,7,16,0,10
54613,1768,32,1736,1672,4,2,0,1,5
54614,2850,71,2779,2664,5,11,16,0,15
54615,11032,346,10686,8667,397,1182,47,0,22
54616,2729,139,2590,2497,6,12,3,0,5
54618,2247,33,2214,2116,10,12,18,0,7
54619,4024,214,3810,3692,11,2,14,0,8
54621,1137,13,1124,1101,2,4,4,0,0
54622,2133,41,2092,2045,6,1,0,1,3
54623,1848,14,1834,1769,3,1,11,0,2
54624,1433,16,1417,1361,7,5,3,0,2
54625,247,8,239,231,3,0,0,0,0
54626,1273,5,1268,1241,1,0,3,0,2
54627,1910,34,1876,1824,0,8,4,0,2
54628,1035,7,1028,976,0,0,4,0,6
54629,2574,59,2515,2434,7,6,2,3,1
54630,4090,90,4000,3802,13,8,44,0,4
54631,1753,26,1727,1654,13,3,5,0,1
54632,1198,11,1187,1141,7,3,1,2,2
54634,4198,71,4127,4002,18,5,6,0,12
54635,1792,41,1751,1658,5,30,6,0,5
54636,16338,241,16097,14617,83,26,937,5,29
54637,152,6,146,135,1,0,3,0,0
54638,1627,25,1602,1534,6,7,5,1,8
54639,2468,48,2420,2343,2,3,4,0,17
54642,2256,43,2213,2114,6,11,14,0,4
54643,2,0,2,1,0,0,1,0,0
54644,1471,17,1454,1376,6,7,32,0,3
54645,120,0,120,117,0,0,0,0,1
54646,4115,103,4012,3792,11,23,16,1,7
54648,1702,204,1498,1429,5,0,6,0,14
54650,24523,575,23948,21055,226,69,1635,2,73
54651,1393,37,1356,1321,2,0,7,1,1
54652,959,15,944,908,5,2,2,0,6
54653,1199,49,1150,1098,2,5,12,0,5
54654,169,0,169,168,0,0,0,0,1
54655,1828,22,1806,1742,6,1,3,0,2
54656,18411,1381,17030,15896,245,96,150,34,20
54657,425,8,417,406,0,2,1,0,1
54658,2490,27,2463,2375,10,3,3,0,13
54659,1428,24,1404,1363,3,4,2,0,1
54660,16073,627,15446,13930,324,353,162,27,48
54661,3852,66,3786,3629,8,10,16,0,4
54664,1634,29,1605,1527,6,8,4,0,8
54665,8925,142,8783,8391,64,6,32,3,24
54666,2587,54,2533,2396,20,32,10,0,6
54667,4870,81,4789,4650,6,5,16,3,8
54669,8094,186,7908,7485,33,26,103,0,14
54670,1897,48,1849,1806,7,3,4,1,6
54701,41346,1413,39933,35685,528,145,1874,33,99
54703,44593,1215,43378,38222,566,246,2529,49,93
54720,8580,266,8314,7620,117,27,186,1,23
54721,1274,24,1250,1201,2,1,2,0,5
54722,4312,91,4221,4081,11,11,12,0,12
54723,1177,14,1163,1115,8,3,2,0,1
54724,7525,81,7444,7206,26,20,27,1,11
54725,2964,50,2914,2795,6,3,5,0,10
54726,1807,48,1759,1702,11,0,3,0,4
54727,5228,90,5138,4929,14,17,13,2,10
54728,6166,87,6079,5839,9,32,16,1,3
54729,33980,686,33294,30875,352,179,488,6,81
54730,5078,107,4971,4660,29,34,52,3,14
54731,781,8,773,749,0,1,3,0,0
54732,2820,36,2784,2676,6,9,9,1,3
54733,1226,36,1190,1115,2,4,12,0,4
54734,804,21,783,745,2,6,0,0,3
54736,4087,113,3974,3818,10,24,17,0,0
54737,455,13,442,429,1,0,0,1,0
54738,3611,132,3479,3285,10,4,58,0,10
54739,5287,114,5173,4783,25,12,192,0,8
54740,2000,78,1922,1864,8,5,2,0,7
54741,1799,35,1764,1689,1,21,3,0,3
54742,4848,86,4762,4505,17,3,30,0,24
54745,2198,21,2177,2112,1,7,3,2,3
54746,670,56,614,588,0,3,5,0,2
54747,2634,567,2067,2007,6,2,6,0,4
54748,1169,11,1158,1118,4,0,11,0,5
54749,1208,20,1188,1118,2,2,7,1,4
54750,1036,27,1009,967,6,3,8,0,5
54751,26738,609,26129,23659,309,95,1186,6,53
54754,1750,94,1656,1484,24,72,7,0,5
54755,7342,172,7170,6883,26,12,35,5,5
54756,886,14,872,848,3,0,0,1,0
54757,3523,46,3477,3317,6,10,14,1,6
54758,4759,78,4681,4543,3,16,17,0,12
54759,1442,21,1421,1361,6,3,2,0,2
54760,239,3,236,235,0,0,0,0,0
54761,1203,34,1169,1137,1,4,1,0,10
54762,1422,32,1390,1319,6,4,2,1,6
54763,1100,13,1087,1051,9,2,2,0,3
54766,1628,27,1601,1547,4,6,4,0,3
54767,3295,38,3257,3115,9,3,22,0,9
54768,6290,199,6091,5275,584,76,46,1,7
54769,571,9,562,540,0,5,1,0,1
54770,2098,86,2012,1951,4,12,8,0,3
54771,4421,113,4308,4165,19,8,21,1,11
54772,1090,17,1073,1020,7,2,5,1,7
54773,3312,262,3050,2918,17,14,1,0,11
54801,6661,123,6538,6159,7,70,26,4,20
54805,1444,74,1370,1293,3,18,3,0,1
54806,11492,297,11195,8981,93,1383,70,9,20
54810,2461,46,2415,2289,7,46,6,0,5
54812,5845,218,5627,4653,665,38,70,1,9
54813,598,7,591,556,1,15,1,0,2
54814,2985,94,2891,1411,11,1287,6,0,6
54817,2455,39,2416,2305,4,23,5,0,2
54819,2430,36,2394,2271,2,13,9,1,6
54820,864,21,843,783,4,8,0,0,1
54821,1413,9,1404,1351,3,9,3,0,2
54822,4665,91,4574,4333,19,14,40,0,10
54824,2271,48,2223,2116,3,19,8,0,1
54826,724,15,709,688,1,2,3,0,1
54827,280,6,274,259,0,3,1,0,2
54828,609,7,602,269,4,284,1,2,1
54829,5326,190,5136,4736,13,188,28,0,20
54830,3207,30,3177,2891,11,145,7,0,5
54832,491,12,479,453,0,5,0,1,0
54835,951,22,929,852,2,8,6,0,2
54836,1105,11,1094,1025,3,22,5,0,8
54837,3864,104,3760,3569,19,27,14,0,20
54838,1481,25,1456,1348,37,18,3,0,9
54839,281,1,280,259,0,11,0,0,0
54840,4702,98,4604,4284,19,47,27,3,11
54841,265,9,256,241,0,5,1,0,0
54842,141,3,138,128,1,0,0,0,0
54843,12664,252,12412,9447,50,2255,47,0,44
54844,337,3,334,319,0,3,0,0,3
54845,132,2,130,111,1,9,0,0,0
54846,538,7,531,499,1,13,4,0,0
54847,2483,34,2449,2285,5,37,4,1,5
54848,5784,133,5651,5353,31,28,34,2,14
54849,1967,25,1942,1837,3,20,1,0,6
54850,428,7,421,376,15,5,0,0,0
54853,3967,79,3888,3543,11,144,21,0,11
54854,982,16,966,886,7,15,1,0,3
54855,944,7,937,888,0,26,1,0,1
54856,1545,18,1527,1368,7,49,7,0,9
54857,21,0,21,19,0,1,0,0,0
54858,1493,29,1464,1392,2,12,2,0,5
54859,1938,40,1898,1764,10,18,10,1,4
54861,309,14,295,9,0,282,0,0,0
54862,325,7,318,296,0,7,1,0,0
54864,1467,6,1461,1363,7,17,8,0,2
54865,495,11,484,442,0,15,1,0,1
54867,531,15,516,426,4,29,1,0,0
54868,15785,473,15312,14433,87,82,147,3,31
54870,1612,17,1595,1513,4,15,6,0,2
54871,3300,66,3234,2995,2,88,6,3,7
54872,2665,55,2610,2369,13,92,17,0,7
54873,3009,34,2975,2796,3,33,7,1,22
54874,3568,33,3535,3275,16,46,7,0,12
54875,1097,12,1085,1009,0,17,3,0,3
54876,1739,23,1716,1380,4,264,3,0,4
54880,30400,595,29805,26632,495,588,254,17,85
54888,1460,23,1437,1359,3,18,6,0,0
54889,2800,53,2747,2580,8,44,17,0,9
54891,3351,74,3277,2915,17,153,10,0,17
54893,4092,52,4040,3440,23,318,6,3,10
54895,988,20,968,902,3,3,4,0,2
54896,1683,36,1647,1526,32,30,3,0,2
54901,37594,1741,35853,29682,2527,365,1779,19,91
54902,22309,975,21334,19064,608,83,700,6,52
54904,21828,465,21363,19618,182,60,857,1,32
54909,2050,112,1938,1884,6,3,4,0,2
54911,26964,1684,25280,21443,782,225,1597,45,88
54913,23818,737,23081,21050,227,59,990,5,29
54914,31082,2613,28469,23946,923,207,2069,42,84
54915,43190,2932,40258,35410,872,197,2151,18,97
54921,1273,158,1115,1057,3,4,11,1,13
54922,1408,146,1262,1205,11,4,4,0,9
54923,8634,698,7936,7508,49,32,74,2,16
54926,56,1,55,54,0,0,0,0,1
54927,502,7,495,483,0,0,0,0,0
54928,425,3,422,412,0,2,1,0,0
54929,8724,292,8432,7969,25,88,31,2,12
54930,1842,56,1786,1725,1,10,4,0,1
54931,213,13,200,188,2,0,4,0,0
54932,1152,19,1133,1107,0,0,7,0,0
54933,135,1,134,132,0,0,0,0,2
54935,42513,3548,38965,34479,1717,160,811,8,110
54937,21333,1533,19800,18514,355,119,244,1,39
54940,4219,80,4139,3999,6,12,25,0,8
54941,2543,59,2484,2394,6,4,14,0,6
54942,10403,252,10151,9652,57,31,160,2,14
54943,1881,131,1750,1689,2,5,0,1,7
54944,9380,200,9180,8825,40,14,67,0,12
54945,3503,52,3451,3353,1,2,3,0,10
54946,302,2,300,291,5,1,0,0,1
54947,2667,39,2628,2529,9,7,8,3,5
54948,263,5,258,216,0,19,2,0,1
54949,3554,107,3447,3342,6,19,9,0,5
54950,3086,51,3035,2916,2,18,10,0,7
54952,27216,2464,24752,21968,580,143,919,3,83
54956,46316,2010,44306,40595,600,210,1150,20,85
54960,2729,52,2677,2594,9,11,3,0,5
54961,14122,827,13295,12730,88,56,88,0,24
54962,1167,17,1150,1115,1,2,6,0,0
54963,7454,291,7163,6804,49,25,62,0,18
54964,1068,36,1032,993,1,0,3,0,2
54965,1457,21,1436,1380,2,4,8,1,2
54966,1973,360,1613,1536,2,5,7,0,3
54967,404,20,384,375,0,1,0,1,1
54968,2963,64,2899,2770,29,6,8,0,4
54970,3901,215,3686,3137,351,54,24,4,1
54971,10938,740,10198,9588,163,17,83,13,31
54974,1620,48,1572,1517,6,4,3,0,12
54977,1360,8,1352,1306,0,0,7,0,4
54978,36,0,36,33,0,1,1,0,0
54979,1453,30,1423,1362,4,8,4,0,1
54980,166,5,161,150,4,0,0,0,0
54981,14998,465,14533,13762,89,72,121,2,41
54982,6987,692,6295,6031,16,29,30,4,14
54983,4515,223,4292,4131,5,15,13,0,2
54984,3066,141,2925,2817,9,6,9,2,7
54985,590,27,563,365,176,19,3,0,0
54986,5138,62,5076,4905,16,4,18,2,10
55001,2995,90,2905,2618,23,8,136,1,17
55003,4024,141,3883,2743,778,158,38,0,6
55005,4927,101,4826,4372,18,19,144,5,14
55006,3883,84,3799,3539,21,16,17,5,13
55007,2272,39,2233,2065,13,35,4,0,9
55008,16514,339,16175,15052,159,98,213,5,60
55009,8252,155,8097,7691,26,28,59,6,27
55011,10517,243,10274,9327,56,44,368,1,34
55012,1948,40,1908,1789,4,17,30,0,4
55013,6985,160,6825,6463,18,11,74,0,28
55014,28603,920,27683,23660,1386,205,1152,2,65
55016,38427,2600,35827,28619,2309,124,2748,15,128
55017,752,5,747,716,0,1,9,0,8
55018,968,17,951,882,3,2,8,0,7
55019,2168,127,2041,1879,17,5,36,0,4
55020,4053,151,3902,3595,42,7,79,2,16
55021,30636,3579,27057,21824,3637,202,416,0,76
55024,35948,1984,33964,29223,1321,102,1476,12,175
55025,25784,840,24944,22549,356,95,767,4,79
55026,399,12,387,375,0,2,3,1,1
55027,3089,254,2835,2752,4,10,7,2,6
55029,119,3,116,114,0,0,0,0,2
55030,1323,17,1306,1230,2,4,17,0,3
55031,1997,57,1940,1841,13,1,25,0,0
55032,3619,65,3554,3312,11,17,53,2,18
55033,29701,1009,28692,26406,551,144,342,11,84
55036,57,0,57,49,0,2,1,0,0
55037,5057,122,4935,4003,38,537,66,0,13
55038,23735,762,22973,20640,326,84,888,1,99
55040,13941,365,13576,12614,114,63,178,0,50
55041,7800,288,7512,7205,40,16,39,1,14
55042,12044,792,11252,9780,208,57,681,1,47
55043,3459,91,3368,3195,3,2,34,0,10
55044,60446,2918,57528,48793,2211,153,3431,9,326
55045,7804,130,7674,7269,36,23,60,0,13
55046,6093,227,5866,5437,61,19,68,3,17
55047,2491,44,2447,2301,4,3,14,5,15
55049,2619,323,2296,2200,18,4,6,0,5
55051,9858,160,9698,9197,42,70,42,0,9
55052,1995,90,1905,1825,9,2,15,0,7
55053,1079,14,1065,1023,4,1,5,0,2
55054,2489,71,2418,2234,34,1,46,0,8
55055,3797,300,3497,2557,370,44,284,0,12
55056,14245,403,13842,12694,129,74,295,0,56
55057,25519,2758,22761,19818,640,71,1057,8,310
55060,29693,2611,27082,24497,1317,51,308,17,41
55063,9236,197,9039,8402,59,97,81,1,37
55065,1217,27,1190,1152,6,4,4,0,3
55066,18732,889,17843,16268,481,196,166,16,61
55068,31593,1697,29896,24684,1706,95,1706,8,176
55069,5630,184,5446,4493,542,116,52,0,7
55070,8342,252,8090,7364,105,44,120,0,36
55071,5827,463,5364,4335,224,39,408,2,24
55072,4346,221,4125,3353,294,245,54,0,6
55073,3532,77,3455,3257,9,6,36,0,23
55074,2415,76,2339,2166,16,10,11,0,10
55075,20749,3206,17543,14316,1315,116,568,13,93
55076,21624,2606,19018,15908,1245,72,673,13,142
55077,14258,1707,12551,9957,881,61,922,10,56
55079,8875,239,8636,8033,44,28,146,7,23
55080,2768,34,2734,2602,5,9,16,3,12
55082,36441,1003,35438,32445,590,130,736,11,123
55084,1777,23,1754,1628,14,11,17,0,5
55085,412,15,397,387,2,0,2,0,0
55087,326,5,321,304,0,0,3,0,1
55088,1889,22,1867,1762,3,3,11,0,10
55089,1849,81,1768,1366,13,252,11,1,13
55090,450,22,428,367,4,3,8,0,8
55092,10801,303,10498,9767,80,43,129,0,30
55101,7788,449,7339,5195,1172,86,492,4,36
55102,20355,1390,18965,14646,2387,168,671,8,89
55103,13874,1181,12693,3842,4550,111,3437,9,79
55104,45612,3125,42487,26057,9698,304,3666,45,243
55105,28812,1272,27540,24062,806,75,1131,19,178
55106,60327,7812,52515,17272,8958,483,22728,11,243
55107,15383,3934,11449,6819,2529,186,999,0,106
55108,14767,728,14039,10863,934,59,1424,2,63
55109,35381,2537,32844,20367,4052,151,6393,10,133
55110,39205,1864,37341,32801,1188,111,1566,15,134
55111,92,7,85,25,39,4,2,1,1
55112,46728,3405,43323,32871,4227,153,3602,32,165
55113,41699,2351,39348,29451,3896,156,3828,21,142
55114,5012,184,4828,2585,1321,24,642,0,34
55115,8880,213,8667,7825,254,11,185,0,32
55116,25992,1434,24558,18612,3608,96,998,11,112
55117,44525,4131,40394,18315,7359,262,12165,6,174
55118,29106,4515,24591,20724,1673,123,742,17,129
55119,43010,5179,37831,18890,6763,213,9872,9,199
55120,4752,222,4530,4051,125,13,141,0,20
55121,9468,710,8758,5764,1524,45,919,2,57
55122,32204,2187,30017,21952,3454,92,2885,11,126
55123,27153,1301,25852,20476,1342,67,2704,9,101
55124,56353,4575,51778,39751,4966,191,3778,13,290
55125,43846,2215,41631,31627,3353,101,4402,13,128
55126,27390,936,26454,21355,990,66,2775,10,92
55127,18071,658,17413,14537,458,32,1651,2,61
55128,29217,2187,27030,19054,2852,101,3541,12,107
55129,31236,1387,29849,21829,2147,78,4146,6,130
55130,18581,2309,16272,3408,4436,162,7436,1,65
55150,173,8,165,154,0,0,5,0,0
55155,12,1,11,0,3,0,0,0,0
55301,12791,435,12356,10652,653,31,325,4,56
55302,7274,145,7129,6800,22,15,33,1,32
55303,51480,1943,49537,41907,3227,220,1548,17,166
55304,49128,1336,47792,42621,1097,131,1654,3,169
55305,21533,870,20663,16756,1435,50,1501,2,97
55306,16984,2589,14395,10462,2191,43,874,13,70
55307,3126,355,2771,2623,35,0,15,1,3
55308,9691,185,9506,9052,50,22,54,0,18
55309,20387,742,19645,17855,437,61,282,1,105
55310,1449,92,1357,1320,12,1,3,0,1
55311,37390,1109,36281,28782,2184,68,3467,5,139
55312,1527,60,1467,1426,3,2,4,1,0
55313,24406,639,23767,22331,244,72,210,6,59
55314,1192,93,1099,1031,5,1,2,0,4
55315,6353,216,6137,5445,129,6,309,3,9
55316,23919,847,23072,18682,1944,99,1140,1,108
55317,21774,816,20958,18288,318,28,1423,5,85
55318,29729,2774,26955,23136,1275,88,1137,5,75
55319,5415,45,5370,5142,20,11,29,2,6
55320,5072,87,4985,4745,30,8,24,0,39
55321,5597,170,5427,5159,41,13,19,0,21
55322,3637,104,3533,3338,30,5,22,0,11
55324,1228,19,1209,1158,2,2,5,0,1
55325,4792,88,4704,4534,12,10,12,0,7
55327,4935,185,4750,4195,175,17,137,0,17
55328,9729,240,9489,8977,26,20,77,0,43
55329,2035,58,1977,1918,9,6,6,0,0
55330,43626,1538,42088,37687,1440,187,786,14,133
55331,19568,658,18910,17488,164,19,494,1,48
55332,1838,204,1634,1564,3,13,6,1,7
55333,776,48,728,664,2,18,11,1,1
55334,2885,587,2298,2195,19,1,17,1,4
55335,1625,115,1510,1471,6,3,4,2,0
55336,8145,1040,7105,6803,29,14,51,3,7
55337,47333,5079,42254,29025,7661,177,2757,42,309
55338,1128,40,1088,1045,4,4,8,0,0
55339,1004,62,942,905,11,2,7,0,0
55340,8988,382,8606,6794,147,14,1260,1,22
55341,3484,72,3412,3174,23,2,72,1,18
55342,1788,86,1702,1632,4,1,6,0,3
55343,26307,1745,24562,17665,3995,81,1330,11,147
55344,15837,977,14860,8494,2326,47,3329,4,68
55345,22051,725,21326,19042,538,22,696,4,65
55346,17139,678,16461,13293,1125,20,1127,13,63
55347,31222,1315,29907,22919,1139,39,4434,0,117
55349,3945,112,3833,3657,19,17,9,0,14
55350,18669,964,17705,16708,149,62,154,21,39
55352,10020,736,9284,8456,163,60,135,10,66
55353,3247,40,3207,3107,15,1,6,4,6
55354,2868,303,2565,2470,12,4,11,1,0
55355,9592,650,8942,8570,63,13,28,1,16
55356,5790,192,5598,5245,44,6,94,1,17
55357,3370,72,3298,3097,12,5,35,0,12
55358,5361,83,5278,5017,13,7,16,0,25
55359,6375,177,6198,5815,42,12,72,0,28
55360,3387,79,3308,3118,21,2,43,0,14
55362,20476,1258,19218,17719,326,42,271,6,80
55363,5290,222,5068,4709,91,7,58,3,19
55364,15210,468,14742,13572,151,43,232,0,63
55366,373,29,344,323,3,1,0,0,0
55367,992,25,967,926,3,0,12,0,5
55368,2305,92,2213,2103,32,5,12,0,9
55369,38379,2002,36377,29623,2551,132,2055,12,200
55370,762,28,734,714,1,6,0,0,3
55371,17132,372,16760,15751,63,99,101,2,68
55372,34327,1026,33301,29204,791,457,1350,8,139
55373,5728,255,5473,5051,94,8,75,0,5
55374,15851,340,15511,14139,412,25,364,4,77
55375,4778,145,4633,4262,67,6,116,0,15
55376,17989,538,17451,15670,609,34,385,8,55
55378,31906,1495,30411,23152,2798,120,2875,23,131
55379,48254,4943,43311,30974,4098,666,5243,19,196
55381,2020,37,1983,1914,15,2,4,2,4
55382,3787,32,3755,3642,8,6,6,0,12
55384,1734,23,1711,1546,42,7,47,0,0
55385,1169,48,1121,1079,1,1,0,2,4
55386,9396,179,9217,8591,69,9,219,0,15
55387,14552,528,14024,13144,133,29,185,1,37
55388,5984,141,5843,5560,58,9,24,0,9
55389,2615,50,2565,2488,3,9,4,1,14
55390,3186,96,3090,2893,29,17,20,0,12
55391,15782,448,15334,14197,173,18,322,2,69
55395,2849,98,2751,2618,16,11,8,0,8
55396,2093,122,1971,1897,10,3,13,1,6
55397,2871,113,2758,2621,32,3,13,1,2
55398,17022,368,16654,15611,113,40,147,6,47
55401,12029,496,11533,9068,732,52,1175,3,51
55402,682,69,613,373,102,8,89,0,7
55403,17707,1129,16578,11545,2873,166,980,9,115
55404,29322,4359,24963,10411,10662,1399,1050,20,175
55405,15497,1070,14427,10041,2584,141,629,7,120
55406,34588,2634,31954,23561,5115,448,835,9,145
55407,38506,9488,29018,18328,6838,590,917,17,213
55408,33718,4996,28722,19523,6008,305,1180,20,166
55409,11843,1675,10168,7867,1244,71,302,4,76
55410,21352,867,20485,17853,597,48,709,7,78
55411,31214,3574,27640,5242,16274,474,3604,15,178
55412,23800,2795,21005,8612,8212,387,1926,9,155
55413,13914,1153,12761,10105,1385,103,381,0,63
55414,36600,1860,34740,23473,3165,185,6030,16,128
55415,5435,246,5189,3359,1036,148,404,4,34
55416,34129,1384,32745,28276,1505,108,1268,9,162
55417,26259,1975,24284,20061,1788,188,570,6,142
55418,31887,3017,28870,22692,3165,250,996,15,129
55419,27919,1757,26162,21477,2256,90,682,5,96
55420,23128,3562,19566,13093,3189,132,1802,8,156
55421,30580,4347,26233,16066,6297,342,1823,16,163
55422,29290,1702,27588,20929,3474,134,1048,3,179
55423,37137,6839,30298,21915,3613,203,2458,17,247
55424,10175,336,9839,8834,136,21,352,0,48
55425,10281,2130,8151,5080,1832,77,633,13,64
55426,26716,1594,25122,19507,2764,148,1229,21,177
55427,24353,1428,22925,17353,3066,83,988,7,165
55428,31896,3215,28681,16432,8017,158,2357,5,167
55429,28755,3568,25187,9860,8941,160,4639,3,145
55430,24058,3401,20657,7788,7242,192,3862,9,113
55431,19767,1414,18353,14631,1443,46,1206,10,85
55432,33022,3359,29663,19740,5629,231,2242,12,172
55433,34618,1719,32899,24851,3634,195,2137,9,146
55434,31776,2395,29381,22490,2478,153,2579,9,142
55435,14170,704,13466,9594,1008,34,2284,0,56
55436,14395,447,13948,12090,277,22,893,5,48
55437,19686,1084,18602,15000,1287,157,1214,11,85
55438,17079,674,16405,13422,1066,36,1050,3,89
55439,9309,315,8994,7239,300,5,1031,2,35
55441,18415,1124,17291,13727,1642,60,981,11,73
55442,12866,405,12461,10510,740,13,650,0,35
55443,36771,2011,34760,15114,10694,115,6906,4,181
55444,17214,1269,15945,6713,3949,110,4163,6,100
55445,13865,861,13004,6177,3003,47,3061,0,70
55446,28725,907,27818,18944,1358,61,6200,7,88
55447,21357,771,20586,16826,1329,44,1380,5,91
55448,28970,1275,27695,21331,2911,165,1739,6,131
55449,33321,1361,31960,24554,2297,102,3335,7,114
55450,27,2,25,5,11,5,2,0,0
55454,8279,394,7885,1866,4814,49,870,0,26
55455,4912,262,4650,3916,195,16,335,0,8
55601,176,2,174,158,0,3,1,0,0
55602,223,1,222,209,0,3,0,0,1
55603,510,4,506,477,0,2,0,0,7
55604,3661,74,3587,3337,8,54,28,0,24
55605,579,7,572,137,1,371,5,1,0
55606,295,5,290,245,3,19,0,0,0
55607,137,0,137,128,0,2,2,0,1
55609,269,1,268,262,0,1,2,0,0
55612,604,17,587,550,6,4,3,0,1
55613,179,2,177,167,0,2,1,0,0
55614,2476,26,2450,2353,3,7,17,0,4
55615,282,18,264,234,7,0,11,0,0
55616,7024,79,6945,6601,11,29,33,0,12
55702,410,0,410,362,0,20,0,0,0
55703,744,4,740,688,1,14,9,0,1
55704,1072,25,1047,968,6,14,10,0,2
55705,3226,26,3200,3031,13,15,9,0,6
55706,1738,14,1724,1643,6,12,5,0,2
55707,3386,44,3342,3136,6,28,13,0,2
55708,917,9,908,836,0,13,0,0,4
55709,4199,59,4140,3850,8,50,5,0,19
55710,1327,14,1313,1273,3,4,0,0,4
55711,707,12,695,527,30,103,0,0,1
55712,512,10,502,470,1,3,0,0,6
55713,979,16,963,912,7,11,3,0,0
55716,334,8,326,296,2,3,0,0,1
55717,295,2,293,275,0,4,1,0,0
55718,3245,42,3203,2961,8,76,8,1,11
55719,5668,114,5554,5151,63,58,15,0,15
55720,17236,316,16920,13618,115,2027,97,10,38
55721,3667,39,3628,3370,3,58,5,0,14
55722,1169,23,1146,1027,8,26,3,0,1
55723,2222,23,2199,2037,6,32,7,0,15
55724,824,13,811,782,2,6,1,0,0
55725,108,2,106,100,1,2,0,0,0
55726,999,1,998,955,6,4,3,0,2
55731,5494,85,5409,5027,129,38,18,2,29
55732,1358,7,1351,1281,3,13,2,0,2
55733,5104,61,5043,4795,9,51,22,1,10
55734,5964,76,5888,5485,54,69,22,0,23
55735,1699,30,1669,1566,10,20,9,0,5
55736,1454,19,1435,1355,11,6,7,0,3
55738,483,5,478,456,1,1,1,0,3
55741,3110,36,3074,2925,6,25,11,0,8
55742,312,5,307,282,0,6,0,0,0
55744,20096,266,19830,18342,114,264,95,0,61
55746,17071,265,16806,15507,236,136,77,11,37
55748,1394,11,1383,1289,3,12,1,0,2
55749,452,3,449,423,1,12,0,0,1
55750,2035,30,2005,1899,0,10,2,0,7
55751,1474,13,1461,1369,1,3,5,0,1
55752,401,6,395,374,1,4,1,0,0
55753,970,12,958,882,3,7,3,1,0
55756,430,8,422,381,1,4,2,0,5
55757,834,13,821,767,5,6,2,0,3
55758,156,4,152,135,1,5,0,0,0
55760,2890,58,2832,2477,10,252,0,1,4
55763,570,1,569,554,0,4,2,0,0
55764,504,6,498,456,0,7,3,0,1
55765,780,8,772,743,3,4,0,0,0
55767,4495,127,4368,3625,404,135,11,0,21
55768,2878,19,2859,2690,10,31,10,0,7
55769,2235,35,2200,2063,3,15,7,0,0
55771,1485,25,1460,1054,1,352,2,1,2
55772,73,2,71,3,0,66,0,0,0
55775,1242,13,1229,1162,1,12,1,0,1
55779,3974,51,3923,3642,18,67,6,2,12
55780,259,7,252,132,0,110,0,0,0
55781,728,6,722,707,0,1,1,0,2
55782,389,4,385,358,0,9,3,0,0
55783,2484,23,2461,2307,7,26,13,0,10
55784,99,1,98,91,0,0,1,0,2
55785,282,4,278,261,0,5,0,0,0
55786,302,6,296,269,2,5,1,0,0
55787,454,11,443,419,2,3,1,0,4
55790,1876,25,1851,1425,1,345,5,0,0
55792,9827,173,9654,8615,203,283,48,3,22
55793,606,4,602,564,0,5,2,0,2
55795,1624,33,1591,1442,50,11,4,0,7
55796,195,0,195,183,1,1,0,0,0
55797,1525,25,1500,1396,4,25,0,0,1
55798,664,4,660,616,1,4,3,0,0
55802,2544,76,2468,2012,126,101,45,1,12
55803,17796,249,17547,16293,93,113,228,4,64
55804,15471,214,15257,14292,76,81,172,4,41
55805,9731,259,9472,7543,610,410,175,3,35
55806,9761,306,9455,7167,647,605,137,8,44
55807,9674,200,9474,8237,280,242,68,2,16
55808,5943,111,5832,5136,74,185,32,2,14
55810,8700,98,8602,7987,30,109,67,1,20
55811,27761,490,27271,24759,432,264,483,7,71
55812,10571,423,10148,8492,773,160,207,7,55
55814,461,49,412,263,117,19,13,0,0
55901,58046,2842,55204,41787,5699,147,4897,29,203
55902,25878,1360,24518,20402,754,44,2078,14,89
55903,13,3,10,3,2,0,2,0,0
55904,29813,3139,26674,20569,3154,102,1428,4,85
55905,0,0,0,0,0,0,0,0,0
55906,19559,1031,18528,14904,1138,44,1510,12,95
55909,1325,43,1282,1253,3,0,4,0,2
55910,1361,115,1246,1196,3,2,6,0,4
55912,29718,4798,24920,20139,1579,45,2013,255,88
55917,3609,170,3439,3325,9,6,6,0,6
55918,955,65,890,855,3,6,0,0,9
55919,1003,6,997,956,1,6,8,0,2
55920,8512,202,8310,7834,57,7,118,5,16
55921,4808,77,4731,4585,32,8,14,0,4
55922,773,15,758,724,8,2,1,0,1
55923,4705,86,4619,4429,25,0,19,1,11
55924,1217,102,1115,1052,3,2,6,0,2
55925,1040,13,1027,1008,1,2,2,0,1
55926,739,5,734,706,5,0,6,0,0
55927,4154,396,3758,3508,34,14,38,1,4
55929,1247,39,1208,1166,4,0,3,0,1
55931,367,2,365,359,2,0,1,0,0
55932,1934,58,1876,1826,7,1,7,0,1
55933,247,5,242,229,1,0,0,0,5
55934,3332,78,3254,3093,23,1,18,1,10
55935,872,25,847,815,3,0,1,0,1
55936,1900,40,1860,1785,4,1,11,0,6
55939,2155,37,2118,2071,7,1,1,0,2
55940,2720,63,2657,2536,10,6,13,0,9
55941,1021,6,1015,982,2,4,3,0,4
55943,3037,35,3002,2896,9,4,8,0,8
55944,7937,330,7607,7232,54,7,34,0,10
55945,1415,9,1406,1373,5,2,3,0,2
55946,3288,182,3106,2971,27,10,4,0,5
55947,7461,109,7352,6940,41,19,72,4,12
55949,1864,38,1826,1776,8,2,8,1,6
55950,104,2,102,91,0,0,6,0,3
55951,1535,53,1482,1434,5,3,3,0,8
55952,2354,131,2223,2092,30,3,18,0,2
55953,888,33,855,811,6,1,3,0,2
55954,1480,32,1448,1419,2,0,1,0,4
55955,2718,80,2638,2535,13,3,8,0,13
55956,1962,35,1927,1841,7,7,6,0,6
55957,683,12,671,646,2,1,4,0,0
55959,2230,55,2175,2029,12,8,47,0,5
55960,3805,154,3651,3408,32,8,64,0,16
55961,378,1,377,365,1,0,0,0,0
55962,751,20,731,714,2,0,4,0,0
55963,5667,115,5552,5150,76,13,61,1,24
55964,4520,260,4260,4125,24,3,25,1,2
55965,2345,32,2313,2228,12,1,7,0,9
55967,941,15,926,895,2,0,2,0,0
55968,124,0,124,118,0,0,0,0,0
55969,1185,55,1130,1070,13,1,20,0,0
55970,933,25,908,874,5,0,2,0,3
55971,3112,36,3076,2964,7,0,20,1,19
55972,5265,376,4889,4580,30,3,98,0,21
55973,282,3,279,275,0,0,2,0,0
55974,2058,30,2028,1965,5,4,4,0,1
55975,4368,46,4322,4122,33,1,19,0,16
55976,8338,268,8070,7603,77,23,41,0,19
55977,193,5,188,183,1,0,0,0,0
55979,1067,39,1028,991,0,0,8,0,1
55981,3998,74,3924,3739,38,9,18,4,1
55982,441,11,430,416,1,1,0,0,3
55983,1535,30,1505,1449,13,2,5,0,1
55985,1807,85,1722,1635,11,5,6,0,23
55987,34010,1060,32950,30154,803,62,722,0,86
55990,931,17,914,889,2,0,1,0,2
55991,1292,16,1276,1244,3,3,4,0,1
55992,5161,108,5053,4787,31,16,45,6,25
56001,50729,2699,48030,40226,3706,169,1752,22,201
56003,15221,619,14602,13015,790,39,245,1,46
56007,21434,2839,18595,16451,422,70,982,3,38
56009,1514,63,1451,1413,11,0,1,0,1
56010,1046,41,1005,964,6,3,1,1,4
56011,9538,391,9147,8452,162,57,91,2,27
56013,4298,348,3950,3811,17,26,12,0,13
56014,755,64,691,669,3,4,4,0,1
56016,1020,38,982,843,0,0,116,0,3
56017,1712,36,1676,1611,3,1,14,1,5
56019,867,35,832,812,2,1,4,0,0
56020,99,3,96,86,0,0,0,0,0
56021,1115,12,1103,1076,0,1,2,0,0
56022,75,3,72,71,0,0,0,0,0
56023,461,14,447,426,1,0,1,0,0
56024,3580,129,3451,3157,82,9,40,1,7
56025,523,11,512,491,0,1,1,0,1
56026,1899,54,1845,1751,15,6,7,1,6
56027,786,88,698,675,1,1,0,0,6
56028,1271,11,1260,1198,11,5,4,0,0
56029,664,57,607,573,4,0,3,0,0
56030,31,0,31,30,0,0,0,0,0
56031,12117,1069,11048,10517,92,25,80,4,28
56032,318,5,313,306,1,2,2,0,1
56033,336,7,329,315,3,1,2,0,1
56034,609,12,597,576,1,4,0,0,4
56035,515,8,507,481,6,0,0,0,5
56036,1774,45,1729,1658,1,2,15,1,1
56037,1589,24,1565,1480,2,8,6,0,6
56039,990,40,950,926,3,1,0,0,2
56041,1075,24,1051,1021,6,0,5,0,0
56042,669,17,652,613,3,0,2,0,6
56043,449,24,425,407,2,0,9,1,1
56044,2135,41,2094,2018,2,8,9,1,11
56045,865,30,835,763,6,0,4,0,14
56046,92,1,91,89,0,0,0,0,0
56048,4150,95,4055,3903,15,5,9,5,8
56050,1531,39,1492,1410,33,3,5,0,0
56051,640,35,605,582,2,3,0,0,3
56052,746,9,737,698,5,3,1,1,7
56054,888,16,872,840,3,1,5,0,7
56055,3916,114,3802,3647,30,7,10,0,8
56056,84,6,78,75,2,0,0,0,0
56057,3949,690,3259,3098,28,3,20,1,6
56058,6066,592,5474,5113,105,10,28,8,19
56060,431,17,414,403,3,0,2,0,0
56062,3239,805,2434,2357,18,1,7,0,3
56063,2945,61,2884,2793,17,1,12,1,7
56065,2698,79,2619,2501,18,2,10,0,5
56068,1031,19,1012,971,4,7,1,0,2
56069,4837,293,4544,4321,31,17,23,6,9
56071,12913,288,12625,12037,65,50,100,3,25
56072,2401,74,2327,2259,14,1,1,0,4
56073,17275,485,16790,16239,92,21,83,3,20
56074,1965,66,1899,1820,19,3,3,0,1
56075,161,9,152,146,0,0,1,0,1
56078,454,12,442,425,0,2,1,0,1
56080,727,20,707,689,3,2,1,0,1
56081,6139,2096,4043,3857,16,12,35,0,12
56082,14507,1096,13411,11778,862,98,302,9,17
56083,797,10,787,766,2,0,0,0,2
56085,5087,510,4577,4444,13,4,28,3,1
56087,3026,121,2905,2847,4,11,8,0,0
56088,1881,59,1822,1755,5,4,3,2,4
56089,174,4,170,164,0,0,0,0,1
56090,603,22,581,560,1,1,3,0,3
56091,343,6,337,312,4,0,5,0,0
56093,12469,1106,11363,10442,304,108,96,7,12
56096,2909,75,2834,2707,23,12,4,0,2
56097,3613,281,3332,3207,13,8,19,0,4
56098,2073,155,1918,1830,12,8,6,0,8
56101,6008,739,5269,4779,115,12,84,68,30
56110,1803,124,1679,1601,9,8,31,5,0
56111,399,11,388,378,0,2,1,0,1
56113,261,1,260,255,0,0,0,0,0
56114,332,4,328,321,0,0,0,0,0
56115,1288,21,1267,1244,0,1,2,2,0
56116,592,6,586,558,0,4,2,2,0
56117,348,88,260,245,0,2,4,1,0
56118,416,15,401,376,0,3,5,4,1
56119,1001,122,879,813,11,5,12,0,2
56120,1088,284,804,749,4,0,40,0,0
56121,568,16,552,528,0,0,0,0,4
56122,551,113,438,421,3,0,4,0,1
56123,504,7,497,482,1,0,2,0,0
56125,58,0,58,57,0,0,0,0,0
56127,346,16,330,315,4,0,1,0,0
56128,2076,106,1970,1901,6,2,11,1,8
56129,754,24,730,706,0,2,2,0,0
56131,2248,144,2104,1948,5,8,90,0,1
56132,455,2,453,429,2,0,0,0,1
56134,411,18,393,377,1,2,0,0,0
56136,1222,20,1202,1176,0,5,1,0,0
56137,1051,98,953,923,10,0,7,0,0
56138,919,15,904,865,6,2,3,0,0
56139,408,43,365,355,0,1,3,0,0
56140,61,4,57,54,0,0,3,0,0
56141,351,4,347,338,0,2,0,0,0
56142,950,15,935,911,5,1,4,0,0
56143,4545,159,4386,4005,86,14,89,0,21
56144,1223,69,1154,1095,3,12,7,0,5
56145,562,28,534,518,0,1,1,0,0
56146,51,0,51,51,0,0,0,0,0
56147,187,5,182,170,1,3,0,0,0
56149,1261,25,1236,1200,0,2,3,0,0
56150,2715,70,2645,2536,21,5,10,0,0
56151,745,25,720,704,2,0,3,0,0
56152,1402,28,1374,1324,0,0,18,0,2
56153,213,2,211,211,0,0,0,0,0
56155,397,29,368,348,0,0,3,1,1
56156,6270,285,5985,5691,38,21,34,6,0
56157,729,80,649,632,4,0,2,0,3
56158,407,26,381,337,5,14,19,1,0
56159,2777,299,2478,2114,19,5,246,8,8
56160,196,8,188,186,2,0,0,0,0
56161,369,31,338,321,1,1,9,0,0
56162,221,12,209,203,0,0,2,0,0
56164,5678,558,5120,4705,98,83,42,0,7
56165,328,11,317,312,1,0,0,0,0
56166,233,4,229,211,0,0,12,0,1
56167,619,39,580,554,2,1,5,1,0
56168,876,109,767,741,0,3,4,0,0
56169,726,3,723,693,1,0,13,0,2
56170,549,30,519,499,0,5,0,0,1
56171,1676,49,1627,1594,2,1,2,0,3
56172,2954,93,2861,2779,15,1,7,1,5
56173,368,4,364,357,0,1,2,0,0
56174,391,12,379,356,0,1,7,0,6
56175,2915,131,2784,2416,3,10,261,0,3
56176,1092,24,1068,1030,3,0,3,0,3
56178,1651,42,1609,1541,5,3,11,0,3
56180,1225,16,1209,887,4,1,308,0,0
56181,1144,29,1115,1088,4,1,2,0,1
56183,1197,31,1166,1111,1,3,18,0,5
56185,551,29,522,498,3,3,3,2,2
56186,381,10,371,363,0,0,0,0,0
56187,15312,6690,8622,6030,953,39,1270,31,36
56201,24575,5145,19430,15597,2560,75,517,32,60
56207,235,6,229,222,1,1,0,0,0
56208,2029,67,1962,1734,12,6,14,133,5
56209,2333,86,2247,2143,2,12,7,1,9
56210,16,1,15,10,0,0,0,0,5
56211,505,6,499,483,0,3,0,0,7
56212,446,6,440,427,0,1,3,0,1
56214,592,11,581,565,0,1,6,0,0
56215,4765,270,4495,4262,55,7,53,0,0
56216,628,40,588,564,2,0,5,0,0
56218,551,18,533,516,0,0,1,0,2
56219,1052,41,1011,723,1,251,2,0,3
56220,2851,100,2751,2680,9,5,3,0,1
56221,752,18,734,719,0,5,0,0,1
56222,2099,107,1992,1905,7,1,4,27,13
56223,1328,113,1215,1150,1,20,5,0,0
56224,387,26,361,343,0,2,1,0,1
56225,805,26,779,715,15,9,5,3,10
56226,222,5,217,213,0,0,0,0,0
56227,178,0,178,176,0,0,0,0,0
56228,847,39,808,778,1,0,1,0,4
56229,1754,43,1711,1647,17,11,3,0,0
56230,794,64,730,709,1,5,1,0,1
56231,361,13,348,340,1,0,0,0,0
56232,2328,87,2241,2139,15,7,18,0,7
56235,505,5,500,486,0,1,0,0,1
56236,299,3,296,286,0,2,0,0,0
56237,562,15,547,509,5,8,6,0,0
56239,553,24,529,511,3,0,4,0,0
56240,954,10,944,920,0,6,0,0,6
56241,3903,186,3717,3178,43,291,6,0,8
56243,1690,63,1627,1577,2,0,5,0,5
56244,1737,190,1547,1484,8,6,9,0,12
56245,455,72,383,366,0,4,0,1,2
56248,684,8,676,656,1,1,0,0,1
56249,255,5,250,245,0,1,1,0,0
56251,1063,69,994,967,3,2,0,0,2
56252,1313,177,1136,1093,8,6,6,4,0
56253,932,30,902,880,0,0,6,0,2
56255,414,6,408,393,4,0,2,0,0
56256,2433,72,2361,2267,17,2,16,0,0
56257,421,2,419,412,0,0,0,0,1
56258,15480,1340,14140,11726,867,55,979,3,32
56260,868,24,844,802,7,4,2,0,3
56262,775,71,704,477,2,2,6,200,1
56263,512,11,501,485,2,1,7,0,2
56264,2113,96,2017,1954,11,8,5,0,0
56265,7634,892,6742,6320,43,38,32,51,29
56266,1510,55,1455,1375,1,34,1,0,2
56267,6647,773,5874,5382,77,101,60,1,20
56270,1197,73,1124,598,3,443,8,0,1
56271,1292,219,1073,1021,4,4,4,4,0
56273,4969,130,4839,4694,10,12,13,2,5
56274,159,1,158,147,0,4,0,0,0
56276,241,3,238,234,0,0,1,0,0
56277,2950,247,2703,2593,25,6,3,0,6
56278,2733,94,2639,2531,4,14,7,1,6
56279,1233,158,1075,1013,10,2,6,0,3
56280,441,7,434,430,0,1,0,0,0
56281,649,22,627,605,10,0,0,0,0
56282,1597,116,1481,1396,4,3,18,1,5
56283,6412,266,6146,5403,53,331,48,1,8
56284,2054,364,1690,1621,6,9,16,3,1
56285,1049,87,962,925,0,6,6,0,2
56287,70,0,70,58,1,0,0,0,0
56288,4623,114,4509,4361,9,5,13,2,11
56289,686,11,675,664,1,1,1,0,0
56291,452,8,444,441,0,0,0,0,0
56292,542,8,534,516,6,0,1,0,0
56293,1257,24,1233,1191,2,4,6,0,0
56294,72,0,72,71,0,0,0,0,0
56295,290,6,284,268,2,0,1,9,0
56296,1978,147,1831,1719,20,27,0,0,2
56297,808,17,791,757,4,6,9,0,0
56301,33786,1397,32389,22809,6724,113,1289,22,144
56303,27305,1156,26149,20545,3245,149,859,26,118
56304,17020,695,16325,11378,3499,142,372,6,71
56307,5399,119,5280,5159,10,0,18,0,6
56308,26391,623,25768,24589,196,73,202,9,32
56309,1326,18,1308,1262,2,4,3,3,4
56310,5225,63,5162,5037,10,4,8,0,8
56311,695,13,682,664,2,2,0,0,0
56312,2293,55,2238,2175,5,4,2,0,3
56313,78,0,78,77,0,0,0,0,0
56314,1281,22,1259,1246,0,0,2,0,0
56315,1726,22,1704,1649,3,4,5,0,2
56316,1438,53,1385,1341,9,1,9,0,0
56318,1158,20,1138,1107,4,4,3,0,2
56319,1300,17,1283,1248,2,2,0,0,0
56320,7985,363,7622,7411,20,10,13,0,20
56321,1572,110,1462,1226,82,4,90,0,9
56323,543,12,531,515,0,2,0,0,4
56324,1000,14,986,939,3,8,0,0,7
56325,213,6,207,206,0,0,0,0,0
56326,1577,25,1552,1515,3,4,1,0,3
56327,784,6,778,755,2,4,1,0,2
56328,150,0,150,146,0,0,0,0,0
56329,7615,92,7523,7288,20,20,15,0,3
56330,1763,34,1729,1646,7,5,10,0,7
56331,1949,79,1870,1845,1,1,1,0,3
56332,1523,33,1490,1445,0,3,4,0,1
56334,5830,104,5726,5525,20,15,26,0,11
56335,197,0,197,195,0,0,0,0,0
56336,1483,34,1449,1416,1,2,6,0,1
56338,1764,19,1745,1656,3,9,4,0,4
56339,1136,46,1090,1045,4,7,1,2,2
56340,2394,16,2378,2331,6,0,1,0,6
56342,2791,31,2760,2446,2,225,7,0,5
56343,910,18,892,851,3,3,6,0,11
56345,15058,299,14759,13972,148,49,57,4,29
56347,7449,1694,5755,5485,25,9,36,71,25
56349,779,1,778,756,1,0,0,0,3
56350,486,6,480,453,4,4,1,0,2
56352,5775,1137,4638,4536,17,5,11,0,12
56353,9314,106,9208,8704,21,68,42,3,22
56354,1455,15,1440,1416,0,3,4,0,0
56355,641,14,627,594,3,3,2,0,0
56356,305,2,303,301,0,0,0,0,1
56357,1053,19,1034,999,2,5,0,0,8
56358,3090,34,3056,2892,12,12,27,0,5
56359,3585,93,3492,2308,17,965,15,2,13
56360,4093,64,4029,3901,22,8,9,1,9
56361,2425,30,2395,2297,4,3,2,0,8
56362,5825,157,5668,5449,31,14,18,0,3
56363,254,7,247,235,1,2,1,0,0
56364,5562,81,5481,5350,6,13,7,0,4
56367,7164,125,7039,6754,37,11,35,2,7
56368,4372,77,4295,4185,2,4,10,1,8
56369,545,163,382,373,1,1,2,0,0
56371,125,13,112,111,0,0,0,0,1
56373,3233,76,3157,3064,4,10,5,1,10
56374,9943,361,9582,8709,471,23,139,0,11
56375,800,7,793,773,0,0,3,1,3
56376,303,6,297,289,3,0,1,0,0
56377,21013,531,20482,18764,359,59,492,4,37
56378,8174,467,7707,7482,44,10,28,1,4
56379,17467,531,16936,15495,335,89,263,4,54
56381,2511,48,2463,2367,6,6,18,0,7
56382,1446,29,1417,1382,3,2,1,0,1
56384,353,15,338,330,4,0,0,0,0
56385,918,21,897,881,4,1,0,1,0
56386,654,10,644,561,0,46,0,0,2
56387,7715,568,7147,4498,2187,40,168,3,19
56389,92,1,91,86,0,0,0,0,2
56401,30632,554,30078,27808,271,429,150,8,102
56425,8584,128,8456,7920,53,45,104,0,48
56431,8763,120,8643,8248,34,66,32,0,15
56433,1800,19,1781,1646,3,45,10,0,4
56434,219,2,217,200,1,1,1,0,0
56435,2595,33,2562,2394,7,24,17,0,4
56437,1474,20,1454,1412,5,5,1,1,4
56438,2877,183,2694,2563,17,6,13,0,7
56440,1343,74,1269,1212,5,8,5,0,0
56441,3439,35,3404,3224,13,32,12,1,4
56442,2720,19,2701,2612,5,10,1,2,15
56443,1395,14,1381,1334,1,2,6,0,0
56444,3044,32,3012,2883,9,18,9,1,18
56446,1661,37,1624,1578,4,5,7,0,2
56447,1008,6,1002,970,0,2,1,0,3
56448,441,1,440,420,0,4,4,0,0
56449,1897,21,1876,1774,7,10,7,0,6
56450,1129,11,1118,916,0,116,2,0,4
56452,1919,18,1901,1785,6,15,11,0,12
56453,837,5,832,794,1,3,1,0,1
56455,1692,23,1669,1585,7,14,2,0,5
56458,360,14,346,310,2,8,1,1,1
56461,3416,55,3361,3012,6,162,9,3,20
56464,4864,65,4799,4588,7,16,10,0,3
56465,2221,15,2206,2120,5,2,5,0,11
56466,3157,73,3084,2926,6,23,19,0,18
56467,2609,40,2569,2423,11,26,5,1,3
56468,4525,55,4470,4321,6,8,20,1,11
56469,1055,8,1047,989,2,17,4,0,0
56470,10668,330,10338,9628,51,142,37,4,24
56472,8315,68,8247,7913,11,31,26,5,25
56473,3763,53,3710,3537,16,13,6,0,13
56474,4419,54,4365,4151,12,28,22,1,22
56475,1611,30,1581,1523,3,11,3,0,1
56477,2771,30,2741,2637,9,7,6,3,2
56479,5387,128,5259,4987,28,33,18,1,24
56481,1972,31,1941,1860,6,9,10,0,2
56482,6925,161,6764,6353,92,48,26,5,7
56484,3517,60,3457,2702,3,597,18,0,7
56501,17784,321,17463,15459,142,592,116,6,61
56510,2327,128,2199,2064,9,31,3,0,19
56511,2192,29,2163,2003,3,26,1,0,7
56514,3963,61,3902,3738,8,14,10,2,2
56515,2967,41,2926,2820,15,4,6,0,8
56516,255,1,254,211,1,28,1,0,4
56517,273,11,262,254,0,0,0,0,1
56518,377,6,371,367,0,3,0,0,0
56519,283,20,263,240,0,3,2,0,0
56520,3952,139,3813,3529,33,66,8,1,5
56521,763,9,754,491,0,148,0,0,1
56522,515,29,486,468,2,4,0,0,0
56523,475,13,462,441,0,6,1,0,0
56524,681,11,670,661,0,0,0,0,2
56525,100,3,97,97,0,0,0,0,0
56527,916,11,905,853,2,1,2,0,1
56528,1669,22,1647,1563,5,6,4,0,1
56529,4613,261,4352,3878,156,69,23,0,14
56531,2065,39,2026,1930,4,11,11,2,1
56533,312,10,302,275,4,0,0,0,0
56534,1189,14,1175,1126,10,1,3,0,6
56535,1240,26,1214,1155,2,7,0,0,5
56536,474,15,459,425,0,1,3,0,6
56537,19230,400,18830,17574,272,118,133,12,42
56540,1919,27,1892,1800,6,13,9,0,4
56541,31,1,30,27,0,3,0,0,0
56542,2718,42,2676,2484,2,72,9,0,2
56543,277,1,276,263,0,1,0,0,0
56544,5361,90,5271,4844,43,98,22,0,9
56545,647,20,627,591,0,4,4,0,5
56546,257,23,234,217,0,4,2,0,0
56547,2597,127,2470,2280,23,25,4,0,2
56548,737,69,668,622,4,8,0,0,0
56549,5075,63,5012,4813,1,25,10,0,2
56550,396,12,384,343,0,10,4,0,0
56551,2256,28,2228,2149,5,0,9,1,3
56552,427,19,408,387,1,2,0,0,0
56553,252,3,249,245,0,1,0,0,0
56554,3098,54,3044,2870,4,30,9,2,6
56556,1176,23,1153,1094,7,8,4,0,2
56557,2826,100,2726,1166,1,1166,7,0,9
56560,44205,2345,41860,35416,2866,848,646,8,105
56562,461,24,437,375,18,2,24,4,0
56563,1130,32,1098,942,64,6,37,2,0
56565,103,15,88,79,1,2,0,0,0
56566,607,20,587,38,1,496,0,0,4
56567,3511,70,3441,3273,8,20,3,0,12
56568,118,26,92,88,0,1,0,0,0
56569,1279,21,1258,614,0,536,0,0,3
56570,1177,8,1169,1079,10,15,5,0,3
56571,1968,48,1920,1868,2,9,2,2,2
56572,5747,935,4812,4090,423,23,107,0,13
56573,7066,462,6604,6222,68,64,41,1,9
56574,261,7,254,240,0,3,2,0,0
56575,773,17,756,337,0,391,0,0,5
56576,818,7,811,773,3,3,2,0,2
56578,801,13,788,700,1,27,1,0,0
56579,1160,35,1125,1085,1,9,2,0,1
56580,1249,28,1221,1149,2,18,2,0,2
56581,247,6,241,227,2,3,0,0,0
56583,146,8,138,135,0,1,0,0,0
56584,1348,26,1322,1192,2,48,3,0,4
56585,1000,9,991,920,2,24,4,0,0
56586,1963,26,1937,1835,10,2,7,0,17
56587,1454,15,1439,1374,1,7,3,0,8
56588,522,6,516,490,0,0,0,1,2
56589,1850,20,1830,885,4,677,0,1,5
56590,403,8,395,375,0,1,2,0,0
56591,417,1,416,11,0,386,0,0,0
56592,504,8,496,437,1,13,2,0,3
56594,406,9,397,387,3,0,0,0,0
56601,34647,923,33724,27563,512,3184,253,9,112
56621,4407,44,4363,3489,11,584,16,2,8
56623,2640,42,2598,2451,10,18,15,0,8
56626,368,14,354,93,2,224,0,0,0
56627,253,4,249,236,0,0,0,0,1
56628,1725,26,1699,1586,18,21,7,1,0
56629,165,2,163,160,0,1,0,0,0
56630,2370,39,2331,1993,8,157,8,3,8
56633,4751,94,4657,1499,10,2805,2,3,12
56634,1545,18,1527,1411,1,37,2,0,3
56636,5055,77,4978,3709,8,909,10,0,14
56637,182,0,182,173,0,2,0,0,0
56639,423,10,413,373,1,3,1,0,1
56641,340,8,332,191,1,96,4,0,0
56644,854,4,850,791,1,27,5,0,2
56646,320,6,314,298,2,5,1,0,1
56647,744,9,735,657,1,22,0,1,5
56649,8923,125,8798,8085,44,170,27,7,18
56650,771,5,766,691,1,25,2,0,2
56651,638,12,626,523,1,66,2,0,0
56652,509,15,494,457,0,5,1,0,4
56653,1207,13,1194,1110,0,16,4,2,3
56654,137,1,136,133,0,0,1,0,2
56655,1502,11,1491,1301,3,132,5,0,2
56657,324,4,320,303,2,5,0,0,0
56658,4,0,4,4,0,0,0,0,0
56659,95,0,95,81,0,8,1,0,0
56660,291,1,290,264,0,7,0,0,1
56661,880,9,871,810,0,13,2,3,4
56662,504,5,499,472,0,4,0,0,0
56663,232,4,228,143,0,71,0,0,1
56666,886,7,879,4,0,874,0,0,0
56667,694,4,690,628,1,19,2,0,1
56668,182,3,179,167,0,2,1,0,0
56669,363,10,353,328,1,3,1,0,2
56670,1372,35,1337,8,0,1310,0,0,0
56671,3153,58,3095,23,0,3028,1,0,1
56672,1972,23,1949,1658,3,147,4,0,3
56673,689,3,686,657,0,1,5,0,1
56676,1773,22,1751,1608,6,22,2,0,7
56678,1307,18,1289,1173,3,23,3,0,7
56680,108,0,108,93,0,10,0,0,0
56681,271,7,264,177,0,81,0,0,0
56683,716,9,707,654,0,14,5,0,0
56684,384,5,379,367,1,4,0,0,0
56685,91,0,91,89,0,0,0,0,1
56686,859,12,847,794,2,2,1,0,7
56688,131,4,127,124,0,0,0,0,0
56701,12798,646,12152,11137,176,154,115,5,39
56710,511,78,433,406,0,8,0,0,1
56711,149,1,148,142,0,0,0,0,0
56713,904,19,885,844,0,0,1,0,0
56714,1191,17,1174,1117,7,2,8,2,4
56715,363,7,356,334,4,4,0,0,1
56716,8965,1152,7813,7023,250,108,66,3,28
56720,23,2,21,20,0,0,1,0,0
56721,10602,606,9996,8703,686,129,54,1,19
56722,314,2,312,302,0,0,0,0,0
56723,980,33,947,898,2,7,4,0,7
56724,170,2,168,161,1,0,5,0,0
56725,986,28,958,904,2,12,7,1,4
56726,1471,11,1460,1397,7,2,10,0,11
56727,684,5,679,631,3,1,6,2,2
56728,1231,32,1199,1159,0,5,4,2,1
56729,155,1,154,145,0,1,0,0,1
56731,73,0,73,72,0,0,0,0,0
56732,1097,5,1092,1035,1,8,7,3,11
56733,371,16,355,345,0,1,2,1,0
56734,374,9,365,359,0,0,3,0,0
56735,831,17,814,787,0,0,0,0,2
56736,859,4,855,824,0,15,0,0,3
56737,809,15,794,771,1,0,1,0,1
56738,1306,13,1293,1252,0,4,1,0,4
56742,834,18,816,778,2,13,1,0,0
56744,526,66,460,437,0,4,0,0,0
56748,592,13,579,525,2,14,1,1,8
56750,2392,70,2322,2227,6,21,4,2,6
56751,5648,114,5534,5229,45,33,61,7,24
56754,500,12,488,458,0,8,0,0,3
56755,91,2,89,87,0,0,0,0,0
56756,769,13,756,676,3,6,12,0,4
56757,853,54,799,790,0,1,0,0,1
56758,380,13,367,357,0,1,0,0,0
56759,351,3,348,341,1,0,2,0,1
56760,406,9,397,385,0,0,0,0,0
56761,406,4,402,388,1,0,0,0,0
56762,2561,121,2440,2349,6,14,7,0,13
56763,5132,77,5055,4210,21,185,300,1,11
57001,1504,33,1471,1404,0,13,12,0,2
57002,1393,61,1332,1253,19,10,3,0,3
57003,2109,46,2063,1973,6,11,10,0,6
57004,3459,132,3327,3168,7,14,13,0,4
57005,12619,295,12324,11598,120,68,92,4,37
57006,24271,992,23279,20712,536,286,861,13,48
57007,1604,39,1565,1451,39,26,26,0,0
57010,599,11,588,548,0,3,3,1,2
57012,1217,29,1188,1112,1,23,0,0,4
57013,4482,55,4427,4213,33,35,26,0,11
57014,1558,37,1521,1468,10,1,2,0,2
57015,883,18,865,818,1,8,0,1,2
57016,689,10,679,655,0,1,0,0,4
57017,1294,28,1266,1191,5,7,0,0,7
57018,1482,11,1471,1430,9,8,0,0,2
57020,1679,34,1645,1577,9,9,5,2,1
57021,226,2,224,215,0,1,3,0,0
57022,5432,87,5345,5147,10,27,13,0,18
57024,383,15,368,338,1,17,0,0,0
57025,2940,107,2833,2679,15,16,17,1,4
57026,1436,161,1275,1206,7,12,4,0,6
57027,134,3,131,125,0,0,0,0,0
57028,3348,259,3089,2051,10,706,86,0,11
57029,2142,101,2041,1973,3,18,11,0,7
57030,3042,81,2961,2805,7,37,3,0,9
57031,621,23,598,559,0,8,0,0,1
57032,8810,230,8580,8120,78,48,32,0,17
57033,5654,88,5566,5347,26,25,10,0,5
57034,733,19,714,686,1,4,0,0,1
57035,1218,14,1204,1120,2,14,4,0,0
57036,816,31,785,755,5,3,0,0,2
57037,885,15,870,844,0,13,2,0,1
57038,1774,51,1723,1622,8,5,9,0,9
57039,3717,63,3654,3482,17,39,11,0,7
57040,351,4,347,339,0,4,0,0,0
57041,94,3,91,84,0,1,1,0,1
57042,8131,571,7560,7042,85,103,61,10,16
57043,1399,41,1358,1298,4,5,0,1,3
57045,1042,8,1034,1009,0,4,1,0,5
57046,617,12,605,573,1,7,0,0,3
57047,245,7,238,227,2,1,0,0,0
57048,1025,13,1012,990,3,1,3,0,0
57049,7725,372,7353,6625,143,70,201,26,14
57050,206,4,202,195,0,2,0,0,1
57051,248,11,237,220,0,1,0,1,2
57052,419,4,415,406,0,3,2,0,0
57053,2110,77,2033,1921,4,11,5,0,3
57054,430,11,419,402,0,2,4,0,2
57055,1157,18,1139,1097,4,2,1,0,4
57057,182,1,181,177,0,2,0,0,1
57058,2011,68,1943,1875,4,10,1,0,4
57059,1569,13,1556,1520,0,11,0,0,1
57061,99,2,97,94,0,0,0,0,0
57062,2344,60,2284,1722,97,407,8,3,0
57063,1059,8,1051,1027,3,4,0,0,0
57064,6908,152,6756,6323,70,48,22,1,19
57065,375,7,368,351,0,6,0,0,1
57066,1428,24,1404,1360,2,3,2,2,2
57067,478,9,469,447,2,7,0,0,0
57068,1707,23,1684,1598,5,10,8,2,7
57069,13005,442,12563,10811,232,527,356,3,34
57070,1380,41,1339,1272,10,22,3,0,1
57071,3134,113,3021,2897,14,26,11,0,6
57072,676,9,667,640,6,5,0,0,0
57073,610,6,604,576,3,11,1,0,2
57075,1168,5,1163,1136,0,3,1,1,3
57076,317,5,312,306,0,1,0,0,1
57077,1371,19,1352,1274,4,13,6,0,12
57078,20104,1174,18930,17186,303,606,129,9,35
57103,36069,2935,33134,25192,3771,938,1595,18,108
57104,26998,2244,24754,18240,2736,1846,533,16,88
57105,22635,1349,21286,18724,719,508,247,11,95
57106,47877,2850,45027,38913,2075,796,939,17,96
57107,11915,1082,10833,9018,779,337,136,6,34
57108,31953,851,31102,28306,678,191,776,3,68
57110,22013,1108,20905,17446,1343,222,1063,0,60
57117,37,0,37,35,0,1,0,0,0
57197,102,8,94,49,22,2,20,0,0
57201,26091,712,25379,23707,108,620,191,3,44
57212,1999,49,1950,1903,3,8,5,0,0
57213,281,16,265,254,0,4,0,0,0
57214,140,3,137,136,0,0,0,0,0
57216,1037,25,1012,981,0,2,4,0,0
57217,225,2,223,220,0,0,0,0,0
57218,303,5,298,294,2,0,0,0,0
57219,502,13,489,480,0,0,2,0,0
57220,766,34,732,687,7,3,3,0,4
57221,886,18,868,829,4,1,0,0,2
57223,1437,59,1378,1326,1,17,3,2,1
57224,147,1,146,130,0,10,0,0,0
57225,1736,130,1606,1555,6,12,2,2,0
57226,2021,43,1978,1915,6,20,0,3,1
57227,421,18,403,379,0,2,0,0,0
57231,1674,22,1652,1606,2,11,5,0,0
57232,327,11,316,246,0,63,0,0,0
57233,131,0,131,127,0,0,0,0,0
57234,1256,113,1143,1111,2,6,6,2,0
57235,830,7,823,795,0,16,2,0,0
57236,215,2,213,204,2,0,0,0,0
57237,650,13,637,608,0,4,2,2,1
57238,498,47,451,442,1,1,0,0,0
57239,256,3,253,230,0,16,2,0,0
57241,1056,52,1004,984,0,3,0,0,2
57242,413,8,405,373,0,5,2,2,2
57243,589,6,583,565,0,3,3,0,4
57245,134,9,125,120,1,2,0,0,0
57246,138,7,131,128,0,2,0,0,0
57247,401,20,381,346,1,20,4,0,0
57248,1205,39,1166,1142,0,7,1,0,0
57249,999,30,969,944,2,2,0,4,0
57251,198,2,196,192,0,1,0,0,0
57252,5020,375,4645,4460,0,40,12,3,6
57255,488,7,481,347,1,101,1,0,3
57256,166,27,139,124,1,10,0,0,0
57257,776,5,771,191,1,548,1,0,0
57258,387,1,386,379,2,0,0,0,0
57259,453,18,435,424,0,3,1,0,1
57260,933,17,916,779,0,107,0,0,0
57261,339,9,330,312,0,9,0,0,0
57262,5326,132,5194,1872,26,2966,19,0,14
57263,434,3,431,417,0,1,0,0,0
57264,219,1,218,216,0,0,0,0,0
57265,212,2,210,200,0,7,0,0,0
57266,599,31,568,442,3,94,0,0,1
57268,466,15,451,448,1,1,0,0,0
57269,387,5,382,375,0,1,0,0,0
57270,619,167,452,277,0,148,4,0,0
57271,188,7,181,174,0,1,1,0,3
57272,205,3,202,195,0,0,1,0,0
57273,1256,20,1236,692,1,489,3,2,0
57274,2686,81,2605,2476,1,56,12,2,1
57276,1390,15,1375,1343,4,9,3,0,0
57278,837,23,814,797,0,6,0,0,0
57279,999,20,979,909,0,36,2,0,0
57301,18759,868,17891,16537,127,577,115,0,30
57311,1522,15,1507,1459,4,2,0,0,6
57312,485,52,433,416,0,2,0,0,0
57313,1165,34,1131,1055,4,35,1,1,0
57314,737,13,724,704,0,4,0,0,0
57315,1012,10,1002,938,4,34,1,0,3
57317,492,8,484,346,2,105,0,2,2
57319,1037,54,983,928,2,12,1,0,2
57321,384,3,381,375,0,1,0,0,1
57322,308,8,300,291,1,1,0,0,0
57323,224,2,222,214,0,2,1,0,0
57324,382,9,373,358,3,0,0,0,0
57325,3279,81,3198,2392,28,570,26,3,6
57328,1083,17,1066,1025,4,8,0,0,0
57329,233,12,221,187,1,27,1,0,0
57330,479,3,476,434,1,13,3,0,0
57331,452,2,450,441,1,1,1,0,1
57332,890,12,878,846,1,3,0,0,5
57334,986,32,954,901,2,14,3,0,1
57335,251,0,251,243,0,2,0,0,0
57337,114,2,112,110,0,0,1,0,0
57339,1413,6,1407,65,0,1298,0,0,0
57340,335,2,333,316,0,1,0,0,0
57341,137,4,133,124,0,4,1,0,0
57342,490,4,486,467,0,6,2,0,0
57344,165,3,162,156,0,0,0,0,1
57345,1083,15,1068,978,3,45,4,1,3
57346,68,7,61,4,1,54,1,0,0
57348,535,4,531,509,1,0,1,0,0
57349,1529,35,1494,1434,4,6,4,0,4
57350,16174,2660,13514,10558,130,239,2066,57,27
57353,956,23,933,907,3,6,2,2,0
57354,34,0,34,34,0,0,0,0,0
57355,1258,16,1242,1182,0,24,0,2,0
57356,2074,47,2027,1029,3,896,4,0,1
57358,49,1,48,47,0,0,0,0,0
57359,597,16,581,554,0,7,2,0,0
57361,619,13,606,18,0,587,0,0,0
57362,2039,40,1999,1934,7,10,3,0,6
57363,984,19,965,930,0,13,0,0,2
57364,82,0,82,82,0,0,0,0,0
57365,456,4,452,383,1,36,0,0,0
57366,2318,22,2296,2201,2,45,2,0,4
57367,234,14,220,153,1,44,3,0,0
57368,1270,187,1083,1001,10,30,6,0,0
57369,2685,33,2652,2553,3,25,6,0,2
57370,797,12,785,558,0,178,0,0,0
57371,237,3,234,231,0,1,0,0,0
57373,353,4,349,335,0,0,1,0,3
57374,333,3,330,325,0,4,0,0,0
57375,675,10,665,647,2,2,7,0,0
57376,920,23,897,846,2,12,4,0,2
57379,115,3,112,111,0,0,0,0,0
57380,3062,101,2961,1371,5,1406,13,14,0
57381,538,9,529,509,1,0,4,0,3
57382,1222,22,1200,1171,0,9,3,0,0
57383,729,21,708,691,2,6,0,0,0
57384,843,34,809,783,1,2,1,0,1
57385,1182,27,1155,1114,0,10,5,0,0
57386,223,7,216,210,2,1,0,0,0
57401,32275,1508,30767,27066,526,1031,901,44,85
57420,111,0,111,104,0,3,0,0,0
57421,63,0,63,56,0,1,0,0,0
57422,249,17,232,224,1,1,1,0,0
57424,259,4,255,252,0,1,0,0,0
57426,37,0,37,37,0,0,0,0,0
57427,610,5,605,572,1,12,0,0,3
57428,662,12,650,620,2,10,5,0,0
57429,104,1,103,100,0,0,0,0,0
57430,2123,39,2084,2022,4,18,1,0,0
57432,443,11,432,420,0,1,0,0,0
57433,429,4,425,405,1,13,0,0,2
57434,443,5,438,433,0,0,0,0,0
57435,220,6,214,210,1,0,0,0,0
57436,538,18,520,504,0,2,0,0,0
57437,1206,19,1187,1129,0,14,3,1,0
57438,1417,21,1396,1335,2,44,1,0,0
57439,42,4,38,36,0,0,0,0,0
57440,731,8,723,707,0,3,0,0,0
57441,509,10,499,479,2,0,0,0,4
57442,1971,33,1938,1647,6,235,13,0,3
57445,1951,55,1896,1810,2,24,10,0,2
57446,369,6,363,355,0,0,2,0,0
57448,306,2,304,300,1,1,0,0,0
57449,148,2,146,146,0,0,0,0,0
57450,605,5,600,588,0,2,0,0,0
57451,2381,30,2351,2257,8,25,13,0,0
57452,285,2,283,270,0,2,1,0,1
57454,551,13,538,508,1,4,3,1,0
57455,80,5,75,75,0,0,0,0,0
57456,788,30,758,741,1,3,0,0,0
57457,74,1,73,65,0,6,0,0,0
57460,376,13,363,353,1,2,0,0,0
57461,333,4,329,319,1,1,0,0,0
57465,310,7,303,296,0,0,1,0,0
57466,131,5,126,118,0,1,1,0,1
57467,249,7,242,236,0,0,2,0,0
57468,231,9,222,216,0,2,0,0,0
57469,3096,95,3001,2852,22,53,2,0,2
57470,153,0,153,148,0,0,0,0,1
57471,583,15,568,549,1,6,3,0,0
57472,914,12,902,844,2,29,3,0,3
57473,114,3,111,111,0,0,0,0,0
57474,259,10,249,235,0,8,2,0,0
57475,127,2,125,121,1,0,2,0,0
57476,455,2,453,443,0,1,0,0,0
57477,115,3,112,111,0,0,0,0,0
57479,658,32,626,605,2,7,3,0,0
57481,536,5,531,521,0,2,0,0,0
57501,17083,460,16623,13685,80,1862,126,4,49
57520,142,1,141,132,3,0,0,0,0
57521,240,5,235,134,1,90,0,0,0
57522,512,30,482,415,2,40,0,0,0
57523,1002,8,994,940,1,20,0,0,0
57528,750,1,749,652,0,63,0,0,0
57529,472,9,463,422,0,18,2,0,0
57531,161,2,159,147,2,1,0,0,0
57532,2832,33,2799,2413,11,196,5,9,5
57533,1773,23,1750,1566,6,101,18,2,0
57534,188,1,187,168,0,9,0,0,0
57536,510,11,499,307,1,169,2,0,2
57537,99,0,99,91,0,1,0,0,0
57538,215,3,212,184,0,17,1,0,0
57540,90,1,89,86,0,0,0,0,0
57541,203,3,200,106,2,87,0,0,0
57543,758,9,749,535,3,139,1,1,4
57544,400,3,397,347,0,37,0,0,1
57547,152,2,150,97,0,36,0,0,0
57548,1549,14,1535,27,1,1477,4,0,0
57551,2232,69,2163,820,5,1128,7,0,1
57552,533,9,524,482,2,15,0,1,0
57553,136,1,135,129,0,3,0,0,3
57555,3980,122,3858,313,6,3375,21,0,0
57559,651,8,643,526,2,54,0,0,2
57560,383,7,376,61,0,303,0,0,0
57562,77,0,77,69,0,0,0,0,0
57563,158,0,158,11,0,146,0,0,0
57564,963,27,936,882,2,7,6,0,0
57566,1030,6,1024,21,0,986,0,0,0
57567,1376,10,1366,1256,2,27,14,2,11
57568,677,10,667,611,1,22,0,0,0
57569,364,5,359,309,0,40,0,0,0
57570,1933,47,1886,48,1,1808,4,0,0
57571,43,2,41,28,0,8,0,0,0
57572,1239,19,1220,16,2,1165,15,0,0
57574,119,0,119,98,0,13,0,0,0
57576,171,3,168,156,0,4,0,0,0
57577,1091,27,1064,67,4,944,4,1,0
57579,1191,27,1164,420,1,650,3,0,4
57580,4356,52,4304,3238,8,841,6,0,3
57584,84,0,84,65,0,11,0,0,1
57585,214,7,207,114,0,81,0,0,3
57601,3824,80,3744,2593,5,890,8,0,4
57620,445,2,443,427,0,5,1,1,1
57621,308,0,308,4,0,299,0,0,0
57622,342,3,339,36,0,288,0,1,2
57623,882,18,864,205,0,630,1,1,0
57625,4029,62,3967,323,7,3511,6,1,2
57626,948,16,932,702,3,196,4,0,5
57630,46,0,46,23,0,23,0,0,0
57631,362,7,355,330,0,6,0,0,1
57632,608,17,591,552,0,19,1,0,0
57633,404,1,403,279,1,91,0,0,0
57634,95,2,93,82,0,7,1,0,0
57636,118,4,114,17,0,93,0,0,1
57638,1901,30,1871,1759,2,55,4,2,4
57639,398,7,391,6,0,380,0,0,0
57640,112,1,111,110,0,1,0,0,0
57641,246,1,245,171,0,51,7,0,0
57642,1884,27,1857,315,4,1451,11,0,0
57644,275,3,272,239,0,19,0,0,0
57645,171,3,168,139,0,20,0,0,0
57646,207,11,196,190,0,4,1,0,0
57648,414,4,410,395,0,6,4,0,0
57649,224,3,221,214,0,3,1,0,2
57650,21,1,20,20,0,0,0,0,0
57651,181,2,179,170,1,5,0,0,0
57652,293,12,281,13,0,261,0,0,0
57656,766,8,758,318,1,360,0,0,1
57657,138,2,136,77,0,42,0,0,0
57658,454,4,450,21,1,407,1,0,0
57659,12,0,12,12,0,0,0,0,0
57660,78,0,78,74,0,3,0,0,0
57661,124,0,124,13,0,106,1,0,0
57701,46258,2754,43504,31025,733,7817,792,33,139
57702,33162,1199,31963,28367,262,1175,382,10,137
57703,16933,818,16115,13409,181,1074,167,19,63
57706,2168,255,1913,1322,236,18,86,31,12
57714,749,12,737,31,2,699,0,0,1
57716,569,12,557,38,2,495,2,0,1
57717,8242,359,7883,7316,11,152,21,2,20
57718,7536,304,7232,6479,22,249,50,1,16
57719,11326,733,10593,8425,247,823,149,24,64
57720,752,20,732,686,2,20,0,0,1
57722,414,13,401,236,1,131,2,0,3
57724,166,5,161,155,1,2,0,0,1
57725,137,8,129,104,1,4,2,0,1
57730,5219,119,5100,4770,21,78,15,0,19
57732,1965,70,1895,1730,3,36,9,0,5
57735,1345,32,1313,1189,4,54,2,5,6
57737,47,0,47,47,0,0,0,0,0
57738,183,7,176,155,0,3,0,0,2
57741,109,7,102,79,2,17,0,0,0
57744,2475,78,2397,2068,10,185,12,0,12
57745,2078,214,1864,1673,8,65,14,0,15
57747,5695,154,5541,4823,37,314,47,6,28
57748,318,7,311,126,0,172,0,1,0
57750,405,12,393,128,0,236,1,0,0
57751,717,27,690,618,2,17,4,1,5
57752,2324,98,2226,109,2,2069,3,0,2
57754,3579,145,3434,3151,12,62,22,7,17
57755,143,3,140,128,1,0,0,0,5
57756,939,25,914,16,2,885,0,0,0
57758,190,6,184,170,0,1,1,0,0
57759,401,4,397,343,9,38,1,0,0
57760,1248,25,1223,1146,0,21,3,1,10
57761,1183,23,1160,1059,1,39,9,1,2
57762,510,11,499,470,0,4,3,2,0
57763,263,4,259,216,1,23,0,0,0
57764,1756,46,1710,34,0,1618,12,0,0
57766,259,2,257,241,0,5,0,0,0
57767,153,9,144,120,1,1,0,0,4
57769,4458,139,4319,3977,6,92,28,1,2
57770,5410,165,5245,220,19,4916,18,0,1
57772,2104,46,2058,50,1,1971,2,0,0
57773,125,5,120,114,1,1,0,0,0
57775,236,8,228,205,0,9,2,0,0
57776,2,0,2,2,0,0,0,0,0
57779,364,12,352,323,0,2,4,0,0
57780,140,0,140,94,1,37,0,0,0
57782,69,0,69,58,0,3,0,0,0
57783,16165,586,15579,14454,60,255,145,11,24
57785,9895,331,9564,8798,46,216,34,3,26
57787,336,4,332,327,0,2,0,0,0
57788,534,16,518,491,1,10,4,0,0
57790,1056,20,1036,881,12,58,7,0,1
57791,217,6,211,192,0,3,2,1,1
57792,98,0,98,92,0,0,1,0,0
57793,2017,44,1973,1840,7,32,7,0,8
57794,619,10,609,13,0,591,0,0,0
57799,675,39,636,529,37,56,9,0,0
58001,244,1,243,231,0,7,0,0,0
58002,28,0,28,25,0,1,0,0,0
58004,224,1,223,207,0,1,1,0,1
58005,783,4,779,749,2,1,0,0,0
58006,392,2,390,376,2,4,2,0,1
58007,111,0,111,109,0,2,0,0,0
58008,198,2,196,194,0,0,0,0,0
58009,75,1,74,72,0,0,0,0,0
58011,406,5,401,383,0,0,0,0,0
58012,2636,44,2592,2442,20,23,4,0,8
58013,123,3,120,114,0,0,0,0,0
58015,288,16,272,266,1,0,1,0,0
58016,124,2,122,122,0,0,0,0,0
58017,235,6,229,213,1,2,0,0,0
58018,370,6,364,340,4,3,1,1,0
58021,443,20,423,398,2,3,0,0,0
58027,1415,43,1372,1319,11,3,4,0,0
58029,129,3,126,118,0,0,0,0,0
58030,648,47,601,572,7,4,0,0,0
58031,418,3,415,385,1,3,0,0,0
58032,678,7,671,642,9,1,1,0,0
58033,347,1,346,336,2,2,1,0,0
58035,225,6,219,213,0,2,0,0,0
58036,389,7,382,367,0,6,1,0,1
58038,310,5,305,292,2,3,0,0,0
58040,1093,27,1066,981,32,2,3,0,0
58041,1575,26,1549,1414,6,81,1,0,5
58042,1395,10,1385,1334,2,7,0,0,12
58043,172,8,164,148,0,0,3,0,0
58045,2298,132,2166,2058,4,20,4,2,2
58046,561,7,554,547,0,3,0,0,0
58047,4216,74,4142,3935,29,38,6,0,20
58048,562,8,554,529,2,2,0,0,2
58049,294,1,293,277,2,3,0,0,2
58051,1706,26,1680,1630,3,6,3,1,1
58052,551,8,543,527,0,1,0,0,0
58053,1212,30,1182,1124,3,21,5,0,2
58054,3229,76,3153,3018,20,12,19,0,10
58056,168,0,168,163,0,0,0,0,0
58057,132,2,130,126,0,0,0,0,1
58058,130,3,127,123,0,2,0,0,0
58059,1697,49,1648,1530,27,12,4,0,1
58060,1487,34,1453,1411,4,2,4,0,0
58061,362,5,357,342,1,7,1,0,0
58062,132,0,132,122,0,0,0,0,0
58063,281,3,278,264,0,6,0,0,0
58064,410,3,407,395,0,5,0,0,0
58065,12,1,11,10,0,0,0,0,0
58067,262,3,259,256,1,1,0,0,0
58068,309,7,302,297,0,0,0,0,0
58069,139,1,138,137,0,0,0,0,0
58071,500,0,500,484,2,0,0,0,0
58072,7999,155,7844,7277,173,75,68,2,17
58074,5,0,5,3,0,2,0,0,0
58075,9028,338,8690,7782,127,308,105,14,16
58076,442,57,385,369,6,0,0,1,0
58077,849,9,840,822,0,1,3,3,0
58078,39161,1209,37952,33191,1783,418,851,5,80
58079,537,7,530,517,0,1,0,0,1
58081,881,36,845,815,1,3,7,0,0
58102,30767,1143,29624,25906,1034,514,921,14,59
58103,46754,1969,44785,33695,5414,960,2504,27,146
58104,48150,1385,46765,38578,4193,334,1726,32,128
58105,2524,199,2325,1981,245,24,11,0,0
58201,42598,1835,40763,34637,1892,888,1375,14,108
58202,2650,138,2512,2153,65,34,187,8,0
58203,16165,1034,15131,11925,826,622,804,9,42
58204,1808,285,1523,1121,133,0,66,14,5
58205,194,38,156,76,37,6,7,1,0
58210,289,10,279,265,1,4,1,0,0
58212,476,6,470,451,0,3,5,0,1
58214,373,4,369,348,0,3,2,0,1
58216,133,2,131,128,0,0,0,0,0
58218,753,6,747,715,2,6,0,0,1
58219,46,0,46,45,0,0,0,0,0
58220,2272,61,2211,2061,10,24,13,0,8
58222,257,3,254,238,1,3,0,0,1
58223,235,1,234,231,0,2,0,0,0
58224,42,0,42,39,0,0,0,0,0
58225,1024,43,981,939,1,4,0,0,8
58227,452,7,445,430,0,1,3,0,0
58228,936,60,876,760,21,24,8,0,1
58229,136,1,135,134,1,0,0,0,0
58230,620,16,604,588,3,1,0,0,0
58231,547,5,542,524,6,1,1,0,0
58233,322,27,295,280,0,3,3,0,1
58235,396,20,376,343,0,0,2,0,1
58236,28,6,22,22,0,0,0,0,0
58237,5269,984,4285,3915,55,78,35,0,17
58238,157,4,153,143,0,0,0,0,0
58239,39,0,39,38,0,0,0,0,0
58240,1165,47,1118,1066,4,12,4,0,1
58241,142,2,140,127,0,0,0,0,2
58243,539,40,499,477,5,6,1,0,0
58244,86,2,84,71,0,5,2,0,2
58249,2520,34,2486,2363,1,16,12,0,7
58250,209,10,199,192,0,2,2,0,0
58251,1894,94,1800,1698,12,24,11,0,1
58254,546,8,538,520,1,5,2,0,0
58255,0,0,0,0,0,0,0,0,0
58256,853,21,832,787,1,7,1,0,0
58257,2174,76,2098,1957,33,13,7,2,4
58258,285,12,273,264,1,1,0,0,1
58259,403,10,393,381,3,3,1,0,0
58260,122,0,122,116,0,0,1,0,0
58261,1076,162,914,859,0,23,0,0,0
58262,118,2,116,111,0,1,0,0,0
58265,464,17,447,420,2,9,1,0,2
58266,193,8,185,168,1,3,1,0,0
58267,1557,38,1519,1452,6,4,5,4,1
58269,183,2,181,164,0,8,0,0,2
58270,1940,58,1882,1821,1,16,2,0,10
58271,594,7,587,531,5,1,7,0,2
58272,285,5,280,270,1,1,0,0,0
58273,216,7,209,200,2,2,2,0,1
58274,942,19,923,886,6,6,2,0,0
58275,750,22,728,690,3,3,4,0,2
58276,485,80,405,373,5,4,0,0,1
58277,179,4,175,171,0,0,0,0,0
58278,2132,52,2080,1968,7,11,4,2,4
58281,86,2,84,84,0,0,0,0,0
58282,1269,19,1250,1096,4,89,2,0,0
58301,10105,242,9863,8015,58,1199,63,6,8
58310,10,0,10,9,0,0,0,0,0
58311,65,2,63,60,0,0,0,0,2
58313,59,0,59,57,0,2,0,0,0
58316,5412,55,5357,217,10,5001,1,0,0
58317,210,2,208,196,0,7,0,0,0
58318,3796,91,3705,3283,28,165,33,1,10
58321,148,1,147,143,0,1,2,0,0
58323,36,0,36,36,0,0,0,0,0
58324,1345,29,1316,1215,2,51,7,1,3
58325,73,0,73,69,0,2,0,0,0
58327,533,25,508,442,15,21,1,4,0
58329,2745,27,2718,347,1,2286,0,2,1
58330,299,3,296,278,0,2,3,0,0
58331,122,2,120,116,0,0,1,0,0
58332,262,1,261,252,0,4,1,0,0
58335,1320,19,1301,28,0,1255,0,0,0
58338,75,0,75,71,0,0,2,0,0
58339,37,0,37,33,0,1,2,0,0
58341,2404,21,2383,2273,9,18,11,0,5
58343,73,1,72,69,0,2,0,0,0
58344,895,31,864,833,1,5,1,1,2
58345,106,4,102,96,0,0,2,0,0
58346,639,11,628,598,0,11,0,0,0
58348,713,12,701,682,0,6,0,0,0
58351,363,9,354,294,1,53,0,0,1
58352,384,1,383,370,1,2,1,0,3
58353,110,3,107,99,0,4,0,0,0
58355,64,3,61,60,0,0,0,0,0
58356,1734,67,1667,1556,5,43,0,0,0
58357,470,9,461,104,0,330,0,0,0
58361,204,0,204,198,0,0,0,0,2
58362,70,0,70,56,0,1,1,0,0
58363,67,0,67,53,0,13,0,0,0
58365,230,0,230,215,0,8,0,0,0
58366,908,9,899,574,0,240,2,3,3
58367,1912,34,1878,774,0,939,20,2,3
58368,3418,67,3351,3070,37,139,13,5,7
58369,1133,11,1122,327,2,732,0,1,0
58370,1171,6,1165,135,0,1005,2,0,0
58372,93,1,92,85,0,0,0,0,2
58374,612,10,602,376,1,184,1,0,0
58377,251,2,249,235,0,3,0,0,0
58379,266,6,260,6,1,253,0,0,0
58380,383,15,368,344,0,7,3,0,1
58381,336,7,329,216,0,91,1,0,0
58382,134,1,133,127,0,1,0,0,0
58384,570,6,564,520,0,14,0,0,1
58385,191,1,190,178,0,4,0,0,1
58386,168,3,165,162,0,1,0,0,0
58401,17847,499,17348,16024,401,284,129,3,19
58402,0,0,0,0,0,0,0,0,0
58405,565,59,506,437,40,4,1,0,0
58413,1052,6,1046,1018,2,0,3,0,1
58415,136,3,133,131,0,0,0,0,0
58416,407,8,399,389,1,0,3,0,0
58418,367,7,360,351,0,0,0,0,0
58420,274,5,269,255,0,1,0,1,0
58421,2875,56,2819,2692,7,18,13,0,6
58422,123,0,123,121,0,0,0,0,0
58423,105,0,105,103,1,0,0,0,0
58424,303,1,302,296,0,0,0,0,0
58425,1347,7,1340,1292,3,12,4,0,2
58426,175,0,175,174,0,0,0,0,0
58428,316,4,312,308,0,1,0,0,0
58429,304,5,299,290,0,0,0,0,0
58430,78,0,78,72,0,3,1,0,0
58431,141,0,141,136,0,2,0,0,0
58433,1139,31,1108,1086,1,5,1,1,3
58436,1747,39,1708,1610,11,17,7,0,9
58438,674,11,663,635,4,0,2,0,0
58439,412,4,408,394,2,6,0,0,0
58440,155,4,151,139,2,0,2,0,0
58441,434,17,417,392,5,0,0,0,2
58442,422,18,404,380,0,4,0,0,0
58443,235,3,232,230,0,0,0,0,0
58444,199,1,198,191,0,3,1,0,1
58445,185,1,184,181,0,0,0,0,0
58448,330,7,323,305,4,0,0,0,1
58451,148,2,146,139,0,0,0,0,0
58452,22,1,21,18,0,0,0,0,0
58454,308,4,304,291,0,1,0,0,1
58455,302,3,299,287,0,1,0,0,0
58456,547,28,519,502,3,1,3,0,1
58458,1279,16,1263,1223,1,5,3,3,3
58460,243,1,242,236,1,0,2,0,0
58461,400,7,393,372,0,3,0,0,0
58463,598,5,593,560,0,3,4,0,3
58464,242,6,236,232,0,0,0,0,0
58466,366,8,358,341,1,1,0,0,1
58467,551,13,538,519,1,3,1,0,1
58472,434,1,433,418,1,2,1,0,1
58474,2628,143,2485,2389,3,8,21,0,5
58475,145,3,142,137,0,1,0,0,0
58476,298,1,297,292,0,0,0,0,0
58477,134,1,133,131,0,0,0,0,0
58478,106,1,105,102,0,0,0,0,0
58479,215,4,211,204,0,1,0,0,0
58480,319,2,317,302,0,2,1,0,2
58481,295,4,291,273,0,4,3,0,2
58482,938,12,926,892,2,5,1,3,0
58483,305,3,302,292,0,0,1,1,3
58484,74,1,73,72,0,0,0,0,0
58486,269,0,269,260,3,0,0,0,1
58487,456,23,433,423,1,0,0,1,0
58488,204,8,196,186,0,2,0,0,0
58490,224,7,217,207,1,5,0,0,3
58492,398,4,394,377,3,0,0,0,0
58494,326,0,326,309,0,4,0,0,2
58495,1208,43,1165,1104,3,6,15,0,6
58496,226,0,226,225,0,0,0,0,0
58497,344,5,339,334,1,0,1,0,0
58501,28388,1036,27352,23766,894,1334,247,52,72
58503,37157,920,36237,32776,777,937,574,103,65
58504,29517,1061,28456,24677,552,1728,218,161,66
58505,4,0,4,1,0,0,2,0,0
58520,290,4,286,270,2,1,2,1,3
58521,669,9,660,632,0,5,0,0,0
58523,3631,118,3513,3276,29,47,21,0,5
58524,131,1,130,130,0,0,0,0,0
58528,755,9,746,27,1,693,0,0,0
58529,599,10,589,557,0,11,1,0,0
58530,1268,24,1244,1175,2,20,2,2,0
58531,401,6,395,384,0,1,0,0,2
58532,283,10,273,258,0,7,0,0,0
58533,854,8,846,806,8,11,3,0,0
58535,585,6,579,545,4,18,2,0,0
58538,2287,27,2260,97,2,2087,2,0,0
58540,2880,62,2818,2176,16,488,28,1,2
58541,390,7,383,339,1,32,2,0,0
58542,245,2,243,238,0,0,0,0,0
58544,501,2,499,477,0,0,1,0,6
58545,3362,69,3293,3121,7,52,15,0,12
58549,192,1,191,190,0,0,0,0,0
58552,1660,24,1636,1571,0,11,10,0,2
58554,28642,1210,27432,24454,442,1199,158,34,59
58558,976,14,962,919,3,6,2,0,0
58559,274,6,268,262,0,2,0,0,0
58560,167,5,162,160,0,1,0,0,1
58561,1035,14,1021,988,1,6,0,0,1
58562,420,7,413,396,1,2,4,0,0
58563,2010,23,1987,1923,2,8,8,1,7
58564,70,0,70,65,0,3,0,0,0
58565,223,1,222,210,0,3,0,0,5
58566,238,4,234,229,0,2,2,0,0
58568,602,24,578,137,0,417,0,0,0
58569,85,0,85,80,0,3,0,0,0
58570,352,15,337,240,1,73,0,0,0
58571,610,14,596,536,2,18,5,1,0
58572,401,15,386,343,1,5,0,0,3
58573,566,5,561,551,0,2,0,0,0
58575,879,9,870,822,0,10,6,0,1
58576,959,14,945,878,4,10,0,1,2
58577,1840,22,1818,1730,7,13,9,2,2
58579,1261,18,1243,1154,0,36,1,3,3
58580,393,9,384,366,3,6,0,0,1
58581,217,0,217,209,0,0,1,0,1
58601,29697,2141,27556,24725,1023,348,325,48,79
58620,156,2,154,151,1,0,0,0,0
58621,1257,39,1218,1155,3,3,1,1,0
58622,1828,54,1774,1666,7,31,9,1,1
58623,2188,102,2086,2018,0,21,14,2,0
58625,213,7,206,195,0,0,2,0,1
58626,433,11,422,365,0,23,4,0,0
58627,140,2,138,133,0,2,1,0,0
58630,675,16,659,626,3,3,3,0,3
58631,1069,20,1049,1002,9,7,5,4,0
58632,202,5,197,196,0,0,0,0,0
58634,316,13,303,294,0,6,1,0,0
58636,807,22,785,480,2,248,3,0,2
58638,1101,38,1063,1014,4,0,0,0,6
58639,1706,29,1677,1563,10,11,35,1,0
58640,1500,51,1449,1298,13,32,21,0,4
58641,113,2,111,108,0,0,0,0,2
58642,314,7,307,294,2,1,1,0,1
58643,140,1,139,133,0,0,0,0,0
58644,16,0,16,13,0,0,0,0,0
58645,289,9,280,269,3,1,2,0,0
58646,1083,12,1071,1035,0,10,1,2,0
58647,1225,21,1204,1118,3,27,3,5,8
58649,339,8,331,315,1,1,3,0,0
58650,352,4,348,329,2,7,1,0,0
58651,463,8,455,446,0,0,0,0,0
58652,1208,39,1169,1094,1,9,8,0,3
58653,597,21,576,545,0,15,3,1,0
58654,302,4,298,272,2,9,0,0,4
58655,603,24,579,560,5,1,0,2,0
58656,482,9,473,453,0,1,3,0,0
58701,32517,1751,30766,26429,1173,952,460,17,91
58703,23341,1752,21589,18060,1260,437,432,77,88
58704,4765,745,4020,3020,303,43,124,29,33
58705,252,74,178,111,34,1,10,1,0
58707,460,50,410,288,46,16,18,1,1
58710,413,7,406,392,0,2,1,2,0
58711,167,3,164,156,0,1,1,0,1
58712,114,2,112,103,0,1,0,2,0
58713,37,1,36,35,0,0,0,0,0
58716,144,2,142,135,0,0,0,0,0
58718,1116,26,1090,1023,12,11,6,0,3
58721,506,10,496,480,0,5,0,0,2
58722,1795,46,1749,1613,11,29,7,0,11
58723,256,2,254,246,1,3,0,0,0
58725,289,4,285,268,0,1,2,0,0
58727,288,12,276,253,2,1,8,0,1
58730,1316,34,1282,1185,23,14,10,1,1
58731,236,4,232,221,0,0,1,1,0
58733,420,7,413,390,0,6,2,0,0
58734,268,1,267,261,0,0,0,0,0
58735,359,5,354,322,0,15,0,0,2
58736,474,4,470,451,0,1,1,0,0
58737,147,3,144,136,1,3,0,0,0
58740,762,10,752,693,7,11,2,0,0
58741,581,12,569,544,2,4,0,0,0
58744,155,0,155,148,0,0,0,0,0
58746,1462,44,1418,1348,2,9,15,3,7
58748,149,4,145,136,0,0,1,0,0
58750,496,3,493,475,1,4,3,0,0
58752,281,6,275,268,0,3,2,0,0
58755,150,1,149,146,1,0,0,0,0
58756,251,5,246,207,2,20,4,0,2
58757,1086,50,1036,76,0,906,0,0,3
58758,217,2,215,205,1,0,1,0,0
58759,770,5,765,712,3,13,1,0,2
58760,276,14,262,247,0,4,0,0,1
58761,1005,19,986,952,0,3,0,0,1
58762,240,4,236,229,0,2,2,0,0
58763,5009,367,4642,1189,81,2982,66,0,4
58765,300,6,294,284,0,3,0,0,0
58768,280,6,274,262,0,3,0,0,0
58769,339,10,329,302,2,3,1,1,3
58770,1330,76,1254,538,14,604,13,0,6
58771,515,19,496,423,3,32,3,0,6
58772,138,2,136,118,6,7,0,0,1
58773,857,26,831,810,2,5,4,0,1
58775,267,16,251,51,1,169,4,0,0
58776,323,15,308,295,2,1,1,0,0
58778,83,1,82,80,0,0,0,0,0
58779,458,4,454,397,2,15,0,0,4
58781,722,13,709,649,0,13,0,0,3
58782,374,6,368,363,0,1,0,0,0
58783,319,4,315,295,0,6,1,0,1
58784,3013,303,2710,2512,18,42,20,2,14
58785,1467,67,1400,1293,8,6,4,1,3
58787,134,0,134,128,0,1,0,0,1
58788,1065,42,1023,980,4,7,7,1,0
58789,358,5,353,336,1,4,0,0,0
58790,1654,15,1639,1576,1,9,3,0,1
58792,239,4,235,224,2,1,0,0,0
58793,516,12,504,488,2,0,1,0,0
58794,224,11,213,198,1,2,1,0,1
58795,233,3,230,226,0,0,0,0,1
58801,34921,3478,31443,25895,1989,827,580,97,134
58830,237,5,232,227,0,0,1,0,1
58831,1122,39,1083,1005,8,14,3,0,5
58833,95,10,85,77,0,0,1,3,1
58835,1050,76,974,884,19,18,3,0,8
58838,221,2,219,212,2,1,0,0,2
58843,743,31,712,605,4,31,1,0,3
58844,160,1,159,157,0,0,0,0,1
58845,392,7,385,358,3,3,1,0,0
58847,311,1,310,281,7,3,1,0,1
58849,1226,36,1190,1075,5,24,5,1,6
58852,2822,319,2503,2301,38,27,25,0,14
58853,485,23,462,173,0,214,0,0,3
58854,9142,1302,7840,6890,168,162,159,5,44
58856,187,2,185,175,2,2,0,0,2
59001,1392,35,1357,1265,1,9,6,0,5
59002,179,6,173,159,0,4,1,0,1
59003,1106,31,1075,417,2,596,5,1,0
59006,937,81,856,796,5,13,5,1,2
59007,105,7,98,93,0,0,0,0,0
59008,378,6,372,348,0,3,0,0,0
59010,148,8,140,125,0,7,1,1,0
59011,3157,81,3076,2885,8,20,9,3,7
59012,53,1,52,45,0,6,0,0,1
59013,119,3,116,110,0,0,0,0,0
59014,1483,28,1455,1386,0,12,0,0,9
59015,554,22,532,496,0,7,4,2,4
59016,1044,45,999,94,4,839,1,0,0
59018,729,20,709,674,0,1,0,0,5
59019,4047,124,3923,3653,4,39,10,0,8
59020,85,5,80,69,1,4,1,0,0
59022,1868,27,1841,74,1,1727,2,1,0
59024,303,6,297,282,0,2,0,0,1
59025,73,1,72,66,0,2,1,0,0
59026,150,9,141,131,1,4,0,0,0
59027,802,27,775,731,8,9,1,0,2
59028,411,14,397,374,2,1,0,0,2
59029,724,18,706,661,0,9,1,0,8
59030,1153,50,1103,1019,14,10,5,0,7
59031,462,7,455,30,2,411,1,0,0
59032,491,3,488,472,0,2,0,0,3
59033,130,4,126,95,0,2,3,0,0
59034,5418,353,5065,2292,2,2461,34,3,2
59035,312,4,308,180,0,113,1,1,1
59036,1522,56,1466,1352,3,7,3,0,4
59037,1940,82,1858,1723,5,29,6,0,6
59038,660,32,628,594,1,10,2,2,0
59039,27,0,27,27,0,0,0,0,0
59041,2034,51,1983,1837,2,26,1,0,10
59043,2874,60,2814,95,1,2644,1,0,0
59044,12099,496,11603,10766,35,164,59,2,26
59046,562,17,545,506,5,0,0,0,10
59047,13319,379,12940,12129,34,110,59,0,35
59050,1722,17,1705,239,0,1412,2,1,0
59052,162,6,156,146,0,0,4,0,1
59053,285,10,275,266,0,0,0,0,1
59054,318,9,309,293,1,7,1,0,0
59055,75,0,75,73,0,0,0,0,0
59057,645,37,608,546,3,9,1,0,9
59058,63,0,63,58,0,1,0,0,0
59059,168,5,163,140,0,3,3,3,2
59061,193,5,188,180,0,0,1,0,1
59062,77,2,75,65,0,3,0,0,3
59063,2174,57,2117,1984,6,22,1,0,16
59064,258,19,239,217,1,12,2,0,1
59065,229,10,219,199,0,4,4,0,0
59066,699,5,694,118,0,565,0,0,0
59067,192,10,182,174,0,0,0,0,0
59068,3670,89,3581,3368,7,37,18,0,13
59069,633,24,609,555,0,11,3,0,0
59070,1327,45,1282,1209,0,6,2,0,3
59071,81,3,78,72,0,1,0,0,2
59072,4150,130,4020,3753,0,77,18,2,10
59074,418,21,397,366,5,1,0,1,1
59075,221,12,209,73,0,121,1,0,0
59076,52,0,52,50,0,1,0,0,0
59077,58,0,58,58,0,0,0,0,0
59078,126,4,122,108,0,1,0,0,2
59079,3520,95,3425,3124,7,62,11,1,16
59081,19,0,19,19,0,0,0,0,0
59082,59,2,57,53,1,0,0,0,0
59083,20,0,20,15,0,0,0,0,5
59085,103,5,98,87,0,1,0,0,1
59086,759,14,745,708,5,3,3,0,2
59087,396,3,393,373,0,0,0,0,0
59088,1272,46,1226,1122,1,25,2,1,5
59089,416,8,408,77,0,317,1,1,0
59101,41522,3641,37881,31604,444,3084,211,39,162
59102,48133,2741,45392,40405,346,1538,484,129,158
59105,33310,2020,31290,27621,248,1269,237,24,111
59106,20681,838,19843,18223,96,344,256,12,75
59201,4998,117,4881,1723,22,2669,41,0,6
59211,178,4,174,156,2,2,0,0,0
59212,542,5,537,463,0,37,0,0,1
59213,791,27,764,153,0,579,2,0,2
59214,124,4,120,118,0,0,0,0,0
59215,1104,21,1083,1029,0,5,4,1,9
59217,85,2,83,71,0,0,1,0,7
59218,1127,32,1095,926,11,75,0,0,11
59219,230,9,221,196,1,6,0,0,0
59221,1936,75,1861,1721,7,28,9,1,10
59222,203,9,194,175,0,8,2,0,0
59223,110,1,109,97,0,4,0,0,3
59225,564,14,550,177,2,351,0,0,4
59226,411,14,397,338,1,22,1,0,1
59230,4623,90,4533,4121,7,170,14,0,12
59231,471,16,455,427,1,7,3,0,0
59240,16,0,16,16,0,0,0,0,0
59241,356,14,342,326,0,11,0,0,1
59242,107,2,105,100,0,4,0,0,0
59243,453,11,442,407,3,4,8,0,2
59244,80,1,79,71,0,2,0,0,3
59247,331,14,317,280,0,18,0,0,0
59248,986,28,958,835,1,65,2,0,8
59250,136,5,131,125,0,1,0,0,0
59252,173,5,168,151,0,5,0,0,0
59253,121,1,120,106,0,2,1,0,0
59254,1937,59,1878,1761,5,23,10,0,2
59255,3476,51,3425,415,3,2826,10,0,2
59256,95,1,94,90,1,0,0,0,0
59257,62,0,62,58,1,2,0,0,0
59258,160,6,154,131,1,10,3,0,1
59259,391,8,383,365,1,0,1,0,4
59260,129,3,126,126,0,0,0,0,0
59261,472,8,464,432,3,7,0,0,1
59262,702,19,683,636,1,10,0,0,1
59263,1284,38,1246,1129,0,32,9,0,0
59270,8633,501,8132,7355,51,127,101,4,31
59273,26,0,26,26,0,0,0,0,0
59274,246,8,238,224,0,5,0,1,0
59275,337,7,330,307,3,1,0,0,0
59276,44,1,43,40,0,0,1,0,0
59301,11509,356,11153,10361,67,194,50,7,13
59311,138,2,136,126,0,0,0,0,1
59312,32,3,29,28,0,0,0,0,0
59313,2592,55,2537,2431,3,26,5,2,2
59314,100,2,98,90,1,0,0,0,5
59315,126,2,124,115,0,1,0,0,3
59316,55,0,55,54,0,0,0,0,1
59317,1045,24,1021,969,2,11,0,0,2
59318,126,4,122,115,0,0,0,0,0
59319,57,0,57,53,0,0,0,0,0
59322,99,0,99,98,0,1,0,0,0
59323,2129,106,2023,1590,2,250,17,1,12
59324,967,8,959,916,0,7,1,0,2
59326,231,7,224,209,1,1,0,0,0
59327,2645,61,2584,2408,15,59,9,0,9
59330,8244,280,7964,7323,37,165,56,1,20
59332,114,1,113,112,0,0,0,0,0
59333,26,0,26,26,0,0,0,0,0
59336,253,5,248,234,2,1,2,0,0
59337,762,6,756,737,0,5,2,1,0
59338,162,4,158,150,1,1,0,0,0
59339,157,2,155,148,0,0,0,0,1
59343,64,0,64,56,1,0,0,0,0
59344,372,7,365,348,2,0,0,0,0
59345,89,0,89,84,1,0,0,0,0
59347,241,3,238,226,2,4,0,0,0
59349,864,24,840,782,1,12,7,0,0
59351,192,2,190,168,0,4,0,0,0
59353,949,27,922,872,2,5,2,2,5
59354,39,0,39,36,0,0,0,0,0
59401,13030,677,12353,10213,167,867,124,25,64
59404,28131,978,27153,23903,212,973,263,21,109
59405,33578,2096,31482,26030,680,1689,500,56,218
59410,887,21,866,822,1,9,3,0,1
59411,431,8,423,97,2,284,3,0,0
59412,1680,40,1640,1529,5,16,7,0,9
59414,950,29,921,736,3,83,2,2,3
59416,318,5,313,288,0,4,3,0,1
59417,7795,164,7631,289,4,7082,7,2,0
59418,132,1,131,129,0,0,0,0,0
59419,194,3,191,167,0,3,0,0,5
59420,221,2,219,206,0,1,1,0,0
59421,2057,74,1983,1888,5,22,3,1,4
59422,2738,34,2704,2482,9,66,6,3,8
59424,90,0,90,85,0,0,0,0,0
59425,3515,64,3451,3239,4,51,10,5,6
59427,5091,118,4973,2961,10,1463,29,12,10
59430,393,3,390,366,3,0,0,0,1
59432,142,1,141,113,0,17,0,0,0
59433,545,4,541,504,1,9,0,0,4
59434,473,12,461,158,3,257,0,2,0
59435,83,1,82,80,0,0,0,0,0
59436,1961,27,1934,1782,10,10,7,3,16
59440,225,7,218,191,0,2,0,0,7
59441,92,2,90,77,1,0,0,0,5
59442,1792,50,1742,1641,5,16,4,0,5
59443,653,10,643,587,1,11,1,0,0
59444,271,1,270,267,0,2,0,0,0
59446,505,8,497,476,0,6,4,0,2
59447,262,11,251,235,0,1,0,0,5
59448,718,19,699,33,0,656,3,1,2
59450,463,2,461,435,0,2,2,0,0
59451,230,0,230,219,0,1,0,0,0
59452,495,13,482,465,1,1,0,0,2
59453,315,6,309,301,0,2,0,0,0
59454,209,4,205,177,0,9,0,0,0
59456,333,3,330,324,0,1,0,0,0
59457,8894,207,8687,8143,17,116,38,0,24
59460,203,8,195,181,1,1,3,0,0
59461,34,0,34,32,0,0,0,0,0
59462,177,1,176,174,0,0,0,0,0
59463,197,4,193,188,0,1,0,0,1
59464,607,4,603,595,0,0,0,0,0
59465,62,0,62,57,2,3,0,0,0
59466,103,1,102,100,0,0,0,0,0
59467,67,3,64,60,0,1,0,0,1
59468,775,21,754,695,1,10,5,0,8
59469,126,0,126,119,0,0,1,0,0
59471,253,0,253,242,0,0,0,0,0
59472,709,9,700,657,1,3,2,0,13
59474,3476,151,3325,2788,31,316,36,0,18
59477,431,6,425,378,0,10,0,0,3
59479,819,22,797,751,7,0,3,2,6
59480,334,4,330,296,0,3,1,0,1
59482,561,12,549,520,1,9,0,0,1
59483,445,15,430,405,4,5,0,0,1
59484,199,5,194,187,0,1,0,0,1
59485,879,18,861,819,0,9,1,0,4
59486,1313,12,1301,1069,0,164,9,5,1
59487,1252,44,1208,1112,3,30,3,0,1
59489,357,4,353,332,0,5,0,0,0
59501,12676,423,12253,9813,42,1405,79,7,19
59520,1102,16,1086,986,4,66,4,0,2
59521,3820,120,3700,121,0,3507,0,0,3
59522,1371,9,1362,1291,1,9,5,0,5
59523,2114,33,2081,1812,2,141,4,0,18
59524,753,17,736,180,2,516,0,0,1
59525,267,0,267,254,0,1,0,0,2
59526,2649,89,2560,402,3,2048,4,0,13
59527,1177,21,1156,41,4,1075,4,0,1
59528,207,6,201,192,0,4,0,0,0
59529,181,4,177,160,0,5,0,0,0
59530,141,5,136,133,0,0,0,0,1
59531,279,2,277,260,3,0,1,0,1
59532,159,5,154,149,0,3,0,0,0
59535,56,0,56,52,0,0,0,0,0
59537,105,0,105,99,0,1,2,0,0
59538,2960,83,2877,2563,1,112,9,0,26
59540,492,13,479,458,0,2,0,1,1
59542,392,8,384,366,0,5,2,0,0
59544,162,1,161,140,0,13,0,0,0
59545,30,0,30,29,0,0,0,0,0
59546,131,4,127,88,0,27,3,0,0
59547,37,0,37,36,0,1,0,0,0
59601,30848,1202,29646,26745,175,599,282,17,117
59602,29390,1048,28342,25975,71,401,190,17,126
59623,0,0,0,0,0,0,0,0,0
59625,294,10,284,245,3,4,17,0,1
59631,234,6,228,193,0,7,7,0,2
59632,2010,51,1959,1761,2,70,8,0,16
59633,248,19,229,188,2,3,1,0,5
59634,5393,123,5270,4939,6,28,27,0,6
59635,7738,238,7500,6703,11,186,46,10,32
59636,37,3,34,29,0,4,0,0,0
59638,770,32,738,663,0,13,2,0,4
59639,1230,41,1189,1091,2,24,6,0,7
59640,113,5,108,100,0,3,2,0,2
59642,53,1,52,47,0,1,0,0,0
59643,544,8,536,504,3,3,1,0,0
59644,4418,153,4265,3990,8,26,4,0,9
59645,1699,36,1663,1565,12,3,2,0,7
59647,275,7,268,244,2,6,0,0,1
59648,618,16,602,566,1,7,3,0,0
59701,33937,1603,32334,29983,124,469,208,20,131
59710,288,8,280,269,0,2,1,0,2
59711,9234,237,8997,8428,21,171,32,1,15
59713,236,8,228,220,0,0,0,0,0
59714,22333,1370,20963,19281,71,166,126,18,115
59715,37286,1498,35788,32708,206,386,606,31,158
59716,2924,216,2708,2549,9,6,24,5,17
59718,43831,2126,41705,38450,162,310,567,29,210
59720,301,7,294,286,0,0,0,0,1
59721,434,10,424,389,4,4,2,0,5
59722,5697,133,5564,4829,64,403,20,3,9
59724,107,2,105,103,0,0,1,0,0
59725,8069,352,7717,7174,21,118,35,3,30
59727,260,24,236,217,0,1,3,0,1
59728,335,9,326,319,0,2,0,0,0
59729,2684,46,2638,2499,10,12,10,1,15
59730,2154,102,2052,1947,6,7,8,0,9
59731,211,5,206,198,0,1,0,0,2
59732,159,18,141,128,1,4,1,0,1
59733,151,2,149,142,0,1,0,0,4
59735,339,5,334,327,0,0,1,1,0
59736,120,7,113,107,1,0,0,0,3
59739,325,23,302,287,0,0,0,0,2
59740,611,20,591,558,0,3,2,0,6
59741,5397,205,5192,4788,6,16,21,5,23
59743,190,2,188,175,1,1,0,0,0
59745,119,3,116,105,1,1,1,0,0
59746,131,3,128,122,0,1,0,0,1
59747,147,6,141,132,0,0,0,0,0
59748,255,4,251,241,0,3,1,0,0
59749,1640,40,1600,1520,0,7,4,2,8
59750,405,8,397,381,1,0,0,0,2
59751,173,6,167,161,0,0,0,0,0
59752,4535,156,4379,4056,17,36,24,1,20
59754,903,30,873,818,0,6,0,2,2
59755,260,13,247,233,0,0,1,0,1
59756,346,16,330,267,3,50,0,0,0
59758,1932,285,1647,1514,17,1,20,2,9
59759,3467,68,3399,3201,3,36,4,0,13
59760,269,7,262,250,2,1,2,0,0
59761,267,21,246,226,0,0,0,0,3
59762,287,12,275,260,0,0,3,1,0
59801,30629,1713,28916,25271,339,928,374,29,166
59802,19892,854,19038,17057,120,489,149,34,78
59803,17203,581,16622,15087,91,303,273,22,60
59804,8193,287,7906,7150,29,197,137,2,36
59808,21546,825,20721,18466,88,511,376,26,83
59812,1195,1173,22,18,0,0,0,0,0
59820,1562,76,1486,1321,7,31,11,4,13
59821,2563,70,2493,1266,13,974,14,0,9
59823,1684,40,1644,1509,4,22,15,1,8
59824,1575,45,1530,1145,4,243,3,0,5
59825,2450,73,2377,2175,3,35,19,0,11
59826,497,10,487,467,0,2,2,0,0
59827,278,1,277,267,0,4,0,0,0
59828,6265,279,5986,5628,4,31,27,5,32
59829,2489,65,2424,2190,8,32,5,1,73
59830,210,3,207,194,1,1,0,0,0
59831,467,14,453,265,0,147,1,0,8
59832,764,25,739,692,0,1,0,0,3
59833,5825,194,5631,5206,4,60,29,1,31
59834,2410,54,2356,2129,6,40,22,1,12
59837,400,5,395,376,0,2,1,0,4
59840,14466,561,13905,12917,54,86,115,11,125
59841,805,27,778,766,0,0,0,1,0
59842,99,1,98,93,0,0,0,0,0
59843,244,4,240,222,0,1,3,0,2
59844,664,20,644,614,4,3,2,0,4
59845,1254,37,1217,933,1,138,14,1,6
59846,1641,47,1594,1500,0,17,8,2,10
59847,6112,192,5920,5466,10,111,30,4,16
59848,140,1,139,113,0,18,4,0,0
59851,189,7,182,169,0,1,0,1,1
59853,846,17,829,761,7,3,4,0,7
59854,225,6,219,212,0,1,0,0,0
59855,743,57,686,206,1,421,1,0,1
59856,238,9,229,207,0,2,0,0,0
59858,1679,46,1633,1555,0,20,2,0,2
59859,3683,109,3574,3259,2,78,12,3,19
59860,11309,442,10867,8050,32,1637,47,8,34
59863,85,5,80,55,2,18,0,0,2
59864,7348,323,7025,3958,12,2229,39,11,29
59865,3338,125,3213,1970,4,950,10,1,17
59866,1019,29,990,926,4,17,0,0,8
59867,26,2,24,20,0,1,0,0,0
59868,2087,65,2022,1884,7,25,5,0,18
59870,11245,388,10857,10149,13,90,51,5,71
59871,249,2,247,235,0,1,1,0,4
59872,2406,64,2342,2145,2,41,18,1,7
59873,3416,106,3310,3028,3,35,12,0,23
59874,1695,32,1663,1539,3,17,6,0,6
59875,3721,110,3611,3391,5,24,18,5,3
59901,57900,1936,55964,51530,173,556,471,43,230
59910,506,11,495,345,1,122,1,0,2
59911,8722,283,8439,7937,12,66,45,3,42
59912,15395,448,14947,13779,43,129,56,23,62
59913,727,11,716,668,0,14,1,0,3
59914,377,10,367,302,1,41,2,0,0
59915,464,9,455,166,2,268,0,0,0
59916,188,11,177,161,0,5,1,0,6
59917,4274,157,4117,3855,11,41,15,1,23
59918,492,16,476,441,2,1,3,0,7
59919,828,29,799,721,0,16,3,0,8
59920,1880,56,1824,1688,4,12,12,1,10
59922,2643,76,2567,2435,0,16,15,1,16
59923,9743,232,9511,8820,14,103,55,12,26
59925,1633,33,1600,1469,1,11,11,0,5
59926,439,29,410,375,0,14,1,1,0
59927,413,13,400,370,0,8,1,0,0
59928,171,2,169,158,0,2,0,0,1
59929,227,5,222,214,0,4,0,0,0
59930,1184,46,1138,1061,1,15,5,0,7
59931,297,6,291,272,0,6,1,0,3
59932,1558,54,1504,1431,1,4,8,0,4
59933,29,2,27,20,0,2,0,0,0
59934,523,8,515,466,3,4,2,0,6
59935,3432,100,3332,3062,1,38,20,0,17
59936,392,13,379,350,0,4,1,2,2
59937,14354,415,13939,13006,35,89,98,3,79
60002,24086,2269,21817,19640,501,48,546,6,56
60004,52546,4849,47697,39653,890,46,5493,10,135
60005,30221,3368,26853,22289,611,16,3029,6,98
60007,33670,4273,29397,23835,600,41,3959,4,80
60008,22760,6030,16730,12819,610,8,2602,13,55
60010,46365,2250,44115,36263,395,37,5815,3,109
60012,10916,700,10216,9433,66,4,284,0,40
60013,26144,2904,23240,21439,181,31,641,7,74
60014,48275,7103,41172,37327,629,52,1256,8,164
60015,28013,1233,26780,23092,356,22,2379,2,129
60016,61888,8880,53008,33654,2427,77,15093,7,347
60018,30051,11718,18333,13727,544,15,3366,2,74
60020,10967,1509,9458,8466,242,15,272,4,14
60021,5404,466,4938,4434,40,4,206,0,21
60022,8482,336,8146,7338,90,6,358,0,37
60025,41256,2857,38399,29174,534,22,7115,6,183
60026,14518,1007,13511,9344,212,6,3432,4,32
60029,514,35,479,428,7,0,29,0,3
60030,36346,4744,31602,26645,1342,49,2057,14,142
60031,37650,6658,30992,21528,3114,53,4499,24,245
60033,13581,5785,7796,7244,70,7,85,0,27
60034,2148,283,1865,1765,14,1,3,0,8
60035,30152,2673,27479,24820,460,25,1093,0,134
60040,5102,2615,2487,2076,112,8,138,0,23
60041,9140,1538,7602,6911,170,21,107,3,37
60042,8433,1393,7040,6435,95,9,162,1,25
60043,2514,103,2411,2207,8,2,105,0,12
60044,10244,918,9326,7617,235,9,1058,1,53
60045,21026,999,20027,17636,245,17,1371,3,65
60046,34690,4200,30490,26221,1061,36,1712,5,116
60047,43944,2945,40999,33513,480,30,5483,16,80
60048,29353,1738,27615,23886,371,21,2139,9,83
60050,31854,4733,27121,24999,310,20,551,6,45
60051,24649,2555,22094,20599,207,26,299,0,51
60053,25297,2041,23256,13359,474,34,8540,2,71
60056,57177,9191,47986,36702,1450,30,8281,15,164
60060,37599,11781,25818,20264,682,26,3797,9,92
60061,27581,3336,24245,15486,664,42,7080,10,124
60062,42751,1727,41024,31433,489,32,7802,2,150
60064,15206,7796,7410,1231,5317,8,336,14,142
60067,39324,3249,36075,27689,745,28,6286,11,108
60068,39672,2865,36807,33443,204,16,1920,3,128
60069,8735,439,8296,6326,102,15,1556,2,22
60070,15840,4656,11184,9009,211,24,1635,2,38
60071,3891,251,3640,3386,42,3,35,0,16
60072,988,62,926,863,13,0,6,0,0
60073,61721,27974,33747,24824,3000,63,3494,35,213
60074,37705,11601,26104,19929,1427,46,3612,6,142
60075,40,7,33,31,0,0,0,0,0
60076,34295,3543,30752,16885,2636,28,9577,15,245
60077,28856,3220,25636,13713,2093,28,8765,8,147
60081,9396,570,8826,8365,39,10,74,0,9
60083,9564,1861,7703,4931,1392,5,999,0,50
60084,17029,3337,13692,12381,173,13,521,0,46
60085,71609,46284,25325,8356,11422,92,3414,31,639
60087,28207,15303,12904,6871,3798,56,1117,10,222
60088,14188,3254,10934,6329,2864,83,853,90,85
60089,43227,2871,40356,26747,525,34,11870,6,115
60090,39017,13013,26004,17731,884,22,6502,6,169
60091,28053,1384,26669,21788,230,12,3292,4,123
60093,20691,1820,18871,16910,106,11,1059,3,66
60096,6760,982,5778,4866,356,20,156,2,41
60097,10849,1362,9487,8876,43,25,72,2,40
60098,33153,7697,25456,22808,786,43,594,6,139
60099,31579,11970,19609,9156,8083,65,655,17,233
60101,37644,16821,20823,15967,1187,41,2927,3,114
60102,31959,3687,28272,24117,739,28,2181,7,85
60103,41740,5012,36728,26862,997,33,7401,7,97
60104,18829,5045,13784,552,12728,19,119,2,64
60106,20562,10121,10441,8265,750,26,986,1,57
60107,39535,13358,26177,16566,2230,29,6283,3,111
60108,23070,2813,20257,15253,801,39,3489,0,68
60109,580,81,499,472,0,1,3,0,0
60110,38762,21878,16884,11734,2163,42,1977,3,124
60111,258,11,247,234,0,2,0,0,0
60112,4560,821,3739,3102,347,9,61,2,14
60113,255,45,210,178,14,2,2,0,0
60115,42103,7344,34759,23486,7538,45,1621,16,165
60118,16342,2475,13867,12086,512,10,680,1,51
60119,10905,790,10115,9420,77,7,187,0,28
60120,50799,30612,20187,13309,2981,51,2573,10,152
60123,47932,22159,25773,18361,3686,91,2083,19,182
60124,24859,3147,21712,17235,663,23,2811,1,87
60126,48147,4709,43438,37546,1038,41,3097,7,148
60129,213,17,196,184,1,1,1,0,1
60130,14346,1624,12722,6761,4345,26,879,3,113
60131,18205,9447,8758,7469,237,18,699,2,70
60133,37494,15567,21927,11889,2539,59,6331,20,158
60134,30503,2049,28454,26340,189,10,757,3,75
60135,7292,1105,6187,5807,47,14,49,0,4
60136,8497,1426,7071,5388,257,4,1069,1,33
60137,38985,3136,35849,30257,1175,15,2895,9,82
60139,33196,10876,22320,10634,2336,39,8323,12,145
60140,21902,3867,18035,15628,631,22,892,5,54
60141,131,9,122,42,75,0,0,0,1
60142,29831,2733,27098,24034,460,25,1548,1,69
60143,11214,1540,9674,8002,224,13,1092,0,46
60144,71,6,65,59,0,0,2,0,0
60145,2350,275,2075,1938,10,3,4,2,3
60146,2420,214,2206,2064,17,3,5,2,10
60148,52794,5882,46912,35619,2373,59,6940,8,176
60150,1713,182,1531,1409,34,6,2,0,3
60151,3997,319,3678,3494,12,4,24,0,11
60152,12382,1953,10429,9793,104,27,81,0,28
60153,23512,8002,15510,722,14193,19,110,4,61
60154,16895,3552,13343,8877,3311,14,687,2,55
60155,8011,1231,6780,746,5642,3,171,0,38
60156,28982,4697,24285,20870,655,32,1635,10,88
60157,2668,229,2439,2180,23,1,134,1,11
60160,24776,18504,6272,4292,1438,11,306,3,56
60162,8337,2960,5377,1417,3524,12,258,2,35
60163,5285,1989,3296,1231,1695,13,219,3,13
60164,22367,14298,8069,6372,659,17,636,4,60
60165,4576,4087,489,280,134,3,44,0,6
60169,34248,7403,26845,15522,2009,53,8115,2,137
60171,10612,3347,7265,6609,202,3,232,1,34
60172,24560,2823,21737,17889,553,21,2518,11,73
60173,13764,1337,12427,5467,792,12,5734,0,82
60174,30958,3860,27098,24380,453,28,1123,4,84
60175,26024,1767,24257,21647,504,13,1095,2,78
60176,11714,3632,8082,6892,164,11,803,0,23
60177,24361,5081,19280,15280,827,15,2121,6,81
60178,22386,1936,20450,18403,625,26,434,4,67
60180,1568,170,1398,1325,1,0,20,0,3
60181,29821,6634,23187,17419,1777,44,2847,7,119
60183,71,5,66,55,0,1,5,0,0
60184,2326,176,2150,1903,14,3,167,0,11
60185,34775,15719,19056,14994,795,55,2326,0,129
60187,30059,1960,28099,23438,1167,25,2142,4,135
60188,43053,7228,35825,23863,2708,20,7735,4,190
60189,30377,1916,28461,23896,1177,23,2106,0,80
60190,11455,885,10570,9279,183,2,654,0,19
60191,14456,3775,10681,9251,241,8,871,0,35
60192,16550,989,15561,9224,468,15,5295,0,44
60193,40805,4053,36752,26264,1278,37,7823,7,102
60194,20622,2602,18020,11164,993,39,5121,3,65
60195,5150,407,4743,2054,214,18,2291,1,23
60201,44652,4134,40518,26866,5610,34,5506,12,233
60202,33245,4615,28630,17568,6713,65,2137,13,245
60203,4634,420,4214,3068,524,0,381,0,32
60208,213,29,184,100,6,0,58,0,1
60301,3043,262,2781,1710,565,0,356,1,11
60302,33698,2967,30731,20160,6659,17,1771,6,184
60304,17842,1851,15991,10976,2976,12,817,5,90
60305,11710,990,10720,8303,869,9,932,0,93
60401,8156,898,7258,6638,297,12,66,0,13
60402,64706,41349,23357,15747,4795,90,1462,10,227
60403,17667,4442,13225,9409,2627,16,499,1,49
60404,19916,2642,17274,14823,1187,7,535,0,63
60406,24011,12448,11563,3774,7188,40,87,6,67
60407,1532,71,1461,1375,12,3,2,0,1
60408,5601,430,5171,4808,56,8,14,0,4
60409,36045,6480,29565,2678,25963,51,50,4,116
60410,13503,1385,12118,11269,161,8,92,6,55
60411,53515,15123,38392,8842,27605,61,247,29,215
60415,14433,2258,12175,9983,1388,5,336,0,55
60416,9512,640,8872,8367,58,19,45,3,18
60417,15342,1839,13503,8112,4593,24,103,1,57
60418,10813,1554,9259,7708,1069,1,187,0,31
60419,21409,931,20478,596,19314,19,38,1,107
60420,4701,199,4502,4234,40,1,31,0,14
60421,3734,346,3388,3197,76,7,17,2,12
60422,9927,483,9444,3012,5782,11,188,4,41
60423,32784,2202,30582,26601,2068,20,873,2,67
60424,2102,133,1969,1887,15,1,9,0,2
60425,8781,745,8036,1287,6492,4,12,3,35
60426,24114,6759,17355,645,15620,39,513,12,114
60428,11351,1975,9376,818,8168,10,99,0,32
60429,14683,945,13738,1050,12208,16,51,3,73
60430,20146,1744,18402,8357,8878,21,259,0,94
60431,26853,6038,20815,15829,3221,29,702,3,85
60432,19989,12544,7445,3566,3466,27,53,3,42
60433,16526,7034,9492,4418,4485,24,67,7,53
60435,48927,16364,32563,22673,7280,67,904,1,126
60436,18535,7024,11511,6426,4194,24,159,4,91
60437,168,13,155,152,1,0,0,0,0
60438,29661,6209,23452,8757,13478,30,259,4,177
60439,24327,1782,22545,21056,220,6,610,6,40
60440,52031,16525,35506,17815,10503,70,5154,9,199
60441,37093,4567,32526,27638,3086,32,529,1,106
60442,12218,900,11318,10675,166,15,50,0,27
60443,21309,1565,19744,2872,15954,25,243,2,105
60444,1784,113,1671,1601,6,0,4,0,2
60445,14692,4639,10053,7419,1885,12,199,3,44
60446,40465,13895,26570,17111,5380,34,2729,3,124
60447,15750,2299,13451,12182,436,15,165,0,48
60448,25512,1779,23733,22126,403,21,472,3,35
60449,8961,955,8006,5847,1679,13,129,4,34
60450,20877,2372,18505,17183,320,13,204,7,56
60451,36561,2538,34023,32087,375,43,357,3,69
60452,27363,4485,22878,18560,2008,66,1310,3,123
60453,58362,13167,45195,37499,4335,84,1630,6,204
60455,17098,4000,13098,11345,660,15,565,4,67
60456,4343,1118,3225,2979,86,7,38,2,16
60457,14420,2313,12107,10882,460,10,388,0,39
60458,14504,2961,11543,8215,2695,22,228,2,33
60459,29451,11655,17796,15710,518,24,906,4,79
60460,1449,49,1400,1337,7,0,0,0,1
60461,4785,162,4623,725,3676,3,67,0,34
60462,40539,3720,36819,32488,1388,28,1787,4,142
60463,14048,828,13220,12416,220,5,250,0,31
60464,9982,647,9335,8763,94,0,239,2,36
60465,18530,1889,16641,14729,1040,9,392,0,85
60466,21904,1717,20187,3929,15089,26,153,9,132
60467,26098,1597,24501,21579,718,22,1533,1,46
60468,6112,541,5571,5238,65,3,28,2,15
60469,5469,3372,2097,1075,886,6,31,0,11
60470,580,35,545,524,4,2,2,0,0
60471,13155,561,12594,828,11304,22,95,1,36
60472,4671,360,4311,254,3916,2,10,0,22
60473,21661,1475,20186,2119,17383,24,87,1,87
60474,824,32,792,773,1,0,0,0,4
60475,9969,2096,7873,4771,2567,12,74,2,56
60476,2388,445,1943,1325,528,3,9,0,8
60477,37335,3407,33928,28823,2783,9,1259,4,91
60478,16893,887,16006,1010,14376,22,133,1,47
60479,685,46,639,616,0,1,4,0,2
60480,5272,658,4614,4209,72,15,170,0,8
60481,11518,605,10913,10284,81,26,40,3,26
60482,11216,1721,9495,8362,467,6,246,5,63
60484,6761,275,6486,322,5869,13,18,0,47
60487,26388,2271,24117,20596,1373,5,1430,1,57
60490,21907,3333,18574,8923,3617,16,5006,3,95
60491,22999,1474,21525,20401,170,16,382,0,31
60501,11746,8334,3412,2122,867,21,226,3,37
60502,22592,2613,19979,11452,1867,27,5728,6,110
60503,16855,2326,14529,8660,1804,12,3199,3,85
60504,38901,8029,30872,16215,5497,41,7464,9,190
60505,57906,44332,13574,8007,4128,76,520,21,123
60506,52011,24117,27894,18627,5810,62,1775,25,157
60510,28156,2548,25608,23215,629,13,663,3,84
60511,1721,102,1619,1553,4,1,6,0,0
60512,1165,186,979,885,11,0,20,0,1
60513,19514,5039,14475,12816,597,27,346,3,52
60514,10320,720,9600,7992,213,3,895,1,36
60515,29278,1822,27456,24026,797,20,1549,9,76
60516,28694,2151,26543,22633,1117,21,1754,8,71
60517,33276,5006,28270,19471,3296,41,4199,14,141
60518,3325,223,3102,2997,10,6,8,0,10
60519,76,20,56,51,1,0,1,0,0
60520,2773,188,2585,2453,12,2,19,3,3
60521,18199,983,17216,13846,314,15,2253,5,55
60523,10347,525,9822,6236,237,5,2997,2,57
60525,32613,4566,28047,25376,997,20,656,1,73
60526,13810,1608,12202,10848,585,13,317,2,31
60527,29139,2232,26907,19833,2283,15,3884,6,61
60530,577,26,551,527,4,0,1,0,3
60531,1879,129,1750,1656,4,1,11,0,6
60532,28766,2490,26276,19606,1623,35,3836,7,131
60534,10749,5360,5389,4418,464,15,179,1,43
60536,80,5,75,70,0,0,0,0,1
60537,627,29,598,575,1,5,1,0,0
60538,28898,10157,18741,14509,2270,16,714,3,100
60539,275,43,232,115,95,0,7,1,1
60540,44201,3168,41033,30454,1719,35,6891,21,197
60541,3061,156,2905,2803,2,0,14,1,5
60542,18540,3533,15007,12410,1012,11,920,8,49
60543,40299,6757,33542,27171,2831,39,1684,7,166
60544,27680,4437,23243,18494,2203,22,1529,4,82
60545,13888,4769,9119,7471,851,14,218,1,42
60546,16819,4250,12569,10928,674,19,420,0,65
60548,12019,1393,10626,10054,89,6,71,1,20
60549,666,43,623,586,4,5,8,0,1
60550,1293,54,1239,1186,4,2,6,0,3
60551,5006,321,4685,3514,978,4,19,0,11
60552,4339,289,4050,3828,13,4,9,0,5
60553,703,32,671,633,5,0,2,0,6
60554,12049,1045,11004,10164,181,11,187,1,32
60555,13909,3267,10642,8963,382,19,674,3,44
60556,1956,158,1798,1690,26,5,12,0,5
60557,122,9,113,101,2,0,1,0,0
60558,13629,624,13005,12309,57,3,246,1,27
60559,24363,3234,21129,15119,1661,32,3526,14,69
60560,27185,3681,23504,20626,1420,26,372,1,94
60561,23139,1922,21217,16805,757,4,2934,13,71
60563,37997,3740,34257,22459,2700,36,7580,12,158
60564,45616,2520,43096,24769,2269,39,14274,11,152
60565,40300,2373,37927,27551,1374,15,7419,4,172
60585,24920,2591,22329,16536,1674,29,3039,8,87
60586,47212,10561,36651,28698,4635,41,1449,2,148
60601,15814,1199,14615,9410,792,19,3587,0,102
60602,1261,115,1146,712,72,2,281,0,9
60603,1288,91,1197,738,54,0,331,0,10
60604,897,60,837,527,78,1,179,0,4
60605,34071,2703,31368,18052,4817,38,6637,21,190
60606,3797,260,3537,2462,219,8,665,0,14
60607,31816,2863,28953,16487,3667,28,7292,13,320
60608,75770,38827,36943,14065,10887,103,10269,22,277
60609,65770,38218,27552,8339,13538,45,4473,10,195
60610,43794,2691,41103,30088,6042,50,3404,5,134
60611,38456,2475,35981,26807,1537,26,6160,10,168
60612,34402,4546,29856,7547,18991,50,2017,7,154
60613,53048,5964,47084,36529,4070,54,3967,14,239
60614,73173,5134,68039,56511,2858,37,5388,20,305
60615,43502,2505,40997,9861,25000,48,3975,10,215
60616,54013,4753,49260,11986,13941,74,21592,21,274
60617,77270,29432,47838,3915,42140,128,154,7,244
60618,90316,34492,55824,43419,2773,134,5717,20,452
60619,63303,1196,62107,355,60016,69,71,9,179
60620,66514,2144,64370,343,62525,80,69,4,172
60621,29570,1696,27874,231,26876,43,34,4,90
60622,55075,12092,42983,34334,3158,46,2970,16,193
60623,87649,58713,28936,1896,25805,112,156,10,200
60624,37547,3739,33808,884,32002,71,80,6,92
60625,76525,25697,50828,33524,3586,160,10464,27,458
60626,50548,10730,39818,21175,11972,107,3834,9,439
60628,62832,2783,60049,850,57599,76,65,7,187
60629,114453,87362,27091,6431,18957,86,536,8,318
60630,54064,15625,38439,29003,842,83,6456,22,233
60631,29691,3653,26038,23759,222,19,1046,3,153
60632,92237,77465,14772,6311,1359,77,6318,15,268
60633,13359,6298,7061,3437,3295,14,49,1,42
60634,75694,32619,43075,35809,1604,77,3875,12,276
60636,34800,7171,27629,219,26530,35,51,8,123
60637,53555,2270,51285,7044,39275,75,2882,15,258
60638,56928,30764,26164,22593,2034,86,586,13,183
60639,89543,70850,18693,5506,11041,94,991,13,279
60640,65941,8812,57129,35734,10849,99,7358,19,327
60641,69354,37912,31442,24041,2041,126,3311,9,314
60642,21687,3789,17898,13286,2110,15,1575,3,101
60643,47831,1900,45931,9887,34317,59,205,5,200
60644,47239,4390,42849,889,41006,50,77,9,107
60645,48356,10025,38331,19445,8107,93,8670,8,520
60646,28383,4100,24283,19351,379,39,3404,3,127
60647,85631,33529,52102,40947,4152,81,3525,21,348
60649,48171,1196,46975,897,44355,66,140,12,166
60651,62819,27961,34858,3041,30378,56,295,1,197
60652,40898,19288,21610,3624,17109,21,210,2,124
60653,33146,1075,32071,1182,29519,37,260,5,130
60654,23890,1469,22421,17587,1060,31,2783,9,102
60655,27837,2648,25189,22309,1970,19,165,2,136
60656,28474,4154,24320,19953,527,28,2985,4,110
60657,72316,6080,66236,55436,2055,54,5312,15,283
60659,40579,8064,32515,13581,4245,101,12940,1,328
60660,42534,7041,35493,21958,5231,70,6239,10,294
60661,11987,691,11296,6742,604,17,3411,8,71
60706,24327,3253,21074,18719,127,14,1771,7,54
60707,43241,18121,25120,19289,3670,45,1225,7,172
60712,13463,993,12470,7682,248,7,4164,1,45
60714,31006,3448,27558,20271,497,12,6066,2,74
60803,22189,5764,16425,10706,4692,13,397,8,62
60804,85673,76194,9479,5421,2880,71,457,14,162
60805,19945,3411,16534,10899,4775,22,232,8,95
60827,24936,997,23939,528,22845,27,24,9,85
60901,33628,6065,27563,16371,9578,77,151,3,132
60910,524,76,448,409,19,1,2,0,0
60911,1257,26,1231,1174,8,1,3,0,5
60912,511,24,487,452,26,0,0,0,0
60913,1472,51,1421,1365,3,4,3,0,2
60914,28894,2184,26710,21826,2821,36,698,2,100
60915,10128,1153,8975,7717,633,14,80,0,36
60917,515,20,495,473,2,0,0,0,0
60918,803,26,777,727,9,3,4,0,0
60919,481,14,467,454,0,0,0,0,1
60920,149,8,141,126,0,1,1,0,1
60921,1506,103,1403,1338,12,0,10,0,0
60922,2186,104,2082,1927,45,2,6,0,4
60924,1519,44,1475,1443,1,0,5,0,4
60926,60,1,59,51,2,0,0,0,0
60927,2226,71,2155,2044,6,4,5,0,4
60928,632,14,618,588,1,2,1,0,0
60929,638,17,621,596,0,1,0,0,0
60930,876,20,856,833,0,1,1,0,2
60931,572,23,549,524,1,0,0,0,1
60932,90,7,83,81,1,0,1,0,0
60933,282,1,281,275,0,0,0,0,0
60934,248,8,240,229,1,0,2,0,0
60935,1114,46,1068,1009,2,3,4,0,7
60936,4315,121,4194,3974,30,4,34,0,13
60938,2080,376,1704,1618,7,1,6,0,0
60939,47,1,46,46,0,0,0,0,0
60940,3246,287,2959,2823,15,2,1,2,5
60941,1927,55,1872,1768,9,1,6,0,1
60942,5731,640,5091,4821,60,9,16,0,11
60945,133,3,130,125,0,0,0,0,0
60946,351,10,341,335,1,0,0,0,0
60948,1492,48,1444,1363,14,2,5,0,4
60949,501,47,454,406,8,0,7,0,8
60950,11996,737,11259,10441,243,13,78,4,40
60951,803,23,780,735,7,0,4,0,4
60952,636,30,606,575,0,1,4,0,3
60953,2113,94,2019,1938,3,2,6,0,3
60954,5825,961,4864,4304,202,9,27,2,28
60955,1828,686,1142,1052,23,0,8,0,4
60956,133,1,132,128,1,0,0,0,0
60957,5499,249,5250,4893,48,15,13,0,15
60958,1835,242,1593,176,1350,2,0,0,9
60959,958,81,877,821,0,3,5,0,2
60960,923,46,877,837,9,0,3,0,1
60961,733,26,707,685,5,4,2,0,3
60962,532,31,501,481,2,2,0,0,1
60963,1636,72,1564,1504,5,1,4,0,1
60964,4628,540,4088,3347,497,4,18,0,8
60966,1379,65,1314,1216,11,10,10,0,0
60967,23,0,23,23,0,0,0,0,0
60968,390,46,344,335,0,0,0,0,0
60969,59,2,57,55,0,1,0,0,0
60970,6306,418,5888,5466,83,12,34,0,15
60973,342,11,331,322,0,0,0,0,1
60974,257,4,253,243,2,0,0,0,0
61001,1144,19,1125,1093,7,1,0,0,1
61006,1640,58,1582,1481,11,0,5,0,5
61007,472,13,459,432,1,1,0,0,0
61008,33747,9926,23821,21379,809,49,401,4,122
61010,7733,351,7382,6944,57,16,36,0,16
61011,2899,169,2730,2478,59,3,84,0,10
61012,2160,643,1517,1433,17,1,8,0,14
61013,663,29,634,596,11,2,2,0,0
61014,1016,41,975,949,2,0,6,0,0
61015,895,29,866,826,2,0,4,0,2
61016,4738,413,4325,3882,126,2,164,2,12
61018,1048,37,1011,963,6,1,1,0,1
61019,3622,97,3525,3356,21,6,14,4,12
61020,3267,444,2823,2645,39,2,16,0,5
61021,22984,1727,21257,18401,1756,20,201,5,65
61024,2456,71,2385,2267,10,4,7,0,5
61025,4504,138,4366,4176,29,3,27,6,6
61027,47,2,45,41,1,0,2,0,0
61028,1865,42,1823,1762,5,4,3,0,4
61030,2077,42,2035,1948,7,2,8,0,1
61031,1430,54,1376,1307,4,0,5,2,14
61032,29110,1821,27289,20911,4290,65,278,10,124
61036,7111,461,6650,6380,36,12,45,0,29
61037,122,12,110,108,0,0,0,0,0
61038,1175,121,1054,991,3,1,9,0,4
61039,780,23,757,731,5,0,0,0,0
61041,1352,53,1299,1218,18,7,5,0,1
61042,511,34,477,451,0,0,2,0,1
61043,133,9,124,109,1,0,2,0,0
61044,231,6,225,217,0,0,0,0,0
61046,2998,63,2935,2828,11,3,11,1,10
61047,1688,61,1627,1540,5,2,15,0,4
61048,4081,104,3977,3848,14,4,6,1,6
61049,476,29,447,408,2,0,1,0,4
61050,349,4,345,324,0,0,0,0,0
61051,1444,31,1413,1342,6,0,4,0,4
61052,1041,27,1014,979,8,2,0,0,1
61053,2542,65,2477,2394,9,1,4,1,2
61054,3731,271,3460,3290,36,4,12,0,0
61057,108,5,103,100,0,0,0,0,0
61059,116,2,114,113,0,0,0,0,0
61060,1387,46,1341,1302,6,0,2,0,1
61061,6865,280,6585,6205,45,12,40,0,24
61062,1871,89,1782,1718,11,0,2,0,2
61063,3901,127,3774,3585,39,2,21,1,1
61064,3693,141,3552,3400,16,4,6,0,3
61065,11206,1853,9353,8424,278,18,88,2,29
61067,669,9,660,640,3,0,1,0,2
61068,14653,3905,10748,9780,291,24,98,0,27
61070,1109,18,1091,1046,3,2,1,0,11
61071,13389,1882,11507,10588,180,19,42,2,36
61072,11259,516,10743,10009,113,21,136,2,30
61073,19936,1117,18819,16987,411,24,417,11,68
61074,4023,294,3729,3526,60,5,6,2,14
61075,989,13,976,950,3,2,0,0,2
61077,74,2,72,72,0,0,0,0,0
61078,1388,53,1335,1296,11,2,2,0,0
61079,226,2,224,209,0,4,1,0,2
61080,11252,1292,9960,8762,401,19,168,0,39
61081,21064,4538,16526,15079,439,19,191,7,57
61084,3036,110,2926,2761,16,2,11,0,5
61085,3194,87,3107,3008,16,2,16,0,4
61087,1541,34,1507,1456,0,0,0,0,3
61088,5966,228,5738,5354,72,8,51,0,16
61089,831,15,816,787,3,0,1,0,1
61091,93,1,92,88,0,0,0,0,1
61101,19784,3331,16453,8074,7165,49,89,9,97
61102,17281,5035,12246,6088,5290,56,55,2,51
61103,23294,3313,19981,12310,6086,50,196,4,136
61104,17354,4396,12958,6216,4830,54,846,0,87
61107,30722,3911,26811,20955,3128,31,1237,5,91
61108,29660,6077,23583,16776,3814,57,1437,9,153
61109,26958,5893,21065,15123,3309,71,1109,3,125
61111,23028,2065,20963,17756,1216,36,767,6,68
61112,139,13,126,113,4,1,5,0,0
61114,15569,1495,14074,11093,1514,13,795,1,53
61115,22599,1741,20858,18312,715,55,478,9,66
61201,37366,4321,33045,22093,7146,63,1612,12,164
61230,1191,22,1169,1138,1,0,4,0,1
61231,5291,150,5141,4914,44,9,17,1,5
61232,1335,39,1296,1236,12,5,3,0,2
61233,391,6,385,376,0,1,0,0,0
61234,1197,40,1157,1104,4,0,20,0,0
61235,1328,35,1293,1257,3,0,5,0,5
61236,89,4,85,83,0,0,0,0,1
61237,22,1,21,21,0,0,0,0,0
61238,3028,60,2968,2824,13,3,6,0,4
61239,1024,114,910,547,279,6,3,2,4
61240,5902,309,5593,5256,44,5,34,4,18
61241,6841,473,6368,6006,50,11,19,3,7
61242,1121,30,1091,1045,4,2,1,0,5
61243,249,8,241,234,0,1,0,0,0
61244,24004,4538,19466,13809,3829,32,811,0,68
61250,2587,53,2534,2449,4,4,8,0,4
61251,387,11,376,356,0,3,2,0,4
61252,5436,161,5275,5067,24,7,27,0,22
61254,11587,375,11212,10684,51,9,66,5,45
61256,1779,146,1633,1511,25,2,5,0,13
61257,1097,23,1074,1010,5,1,3,0,3
61258,180,7,173,169,1,0,0,0,1
61259,1197,33,1164,1140,0,1,1,0,0
61260,748,32,716,676,1,1,0,0,2
61261,847,34,813,771,1,0,1,0,3
61262,961,39,922,869,1,0,7,0,3
61263,742,31,711,683,5,0,1,0,1
61264,10157,501,9656,8680,368,21,76,4,31
61265,44342,8159,36183,29186,3688,75,1279,12,132
61270,7055,304,6751,6477,60,3,28,0,15
61272,1449,32,1417,1374,0,2,0,0,3
61273,3227,105,3122,2982,13,7,12,0,5
61274,317,9,308,295,4,2,0,0,0
61275,4154,176,3978,3813,18,2,12,0,17
61276,75,3,72,67,0,0,0,0,0
61277,3233,106,3127,2961,28,2,12,0,8
61278,697,30,667,637,8,1,1,0,0
61279,1000,26,974,893,8,3,3,0,5
61281,2529,84,2445,2353,9,5,4,0,3
61282,8278,1374,6904,5605,738,19,178,1,25
61283,1486,37,1449,1389,8,3,3,3,1
61284,2298,59,2239,2189,6,3,9,0,3
61285,2681,229,2452,1770,580,38,8,1,2
61301,10375,1760,8615,7887,236,15,90,1,17
61310,3700,177,3523,3362,24,7,21,1,6
61311,179,13,166,144,4,1,2,0,0
61312,413,17,396,381,2,0,2,0,1
61313,304,11,293,275,1,0,0,0,0
61314,702,8,694,671,2,0,5,0,2
61315,281,27,254,238,0,1,1,0,0
61316,269,12,257,237,3,1,0,0,1
61317,441,22,419,408,2,0,4,0,0
61318,620,51,569,546,4,2,1,0,0
61319,1147,49,1098,1060,1,0,5,0,1
61320,641,31,610,585,2,0,7,0,0
61321,264,5,259,245,0,0,0,0,1
61322,1463,920,543,468,17,1,18,1,1
61323,119,3,116,114,0,0,0,0,0
61324,102,3,99,98,0,0,0,0,0
61325,992,65,927,894,0,1,2,0,0
61326,2103,203,1900,1810,18,1,11,2,0
61327,1207,56,1151,1115,4,1,5,2,0
61328,65,1,64,60,0,0,0,0,0
61329,1266,128,1138,1084,3,1,2,0,5
61330,1369,75,1294,1251,4,2,3,1,5
61331,34,1,33,31,0,0,0,1,0
61332,133,5,128,121,0,0,1,0,2
61333,343,6,337,329,0,0,0,0,0
61334,642,25,617,592,0,2,3,0,4
61335,519,33,486,468,0,0,1,0,3
61336,561,16,545,520,2,2,0,0,0
61337,443,20,423,410,7,0,0,0,0
61338,345,6,339,320,0,0,1,0,2
61340,479,24,455,433,1,1,0,0,3
61341,8092,496,7596,7103,47,12,38,0,28
61342,8648,2245,6403,5987,91,4,76,4,28
61344,323,9,314,295,5,1,0,0,0
61345,753,34,719,681,5,1,4,0,1
61346,78,3,75,73,0,0,0,0,0
61348,4576,346,4230,4041,23,9,27,0,2
61349,903,30,873,829,4,0,6,1,0
61350,23997,2054,21943,20239,454,41,244,3,64
61353,1207,59,1148,1079,18,0,0,0,3
61354,10447,951,9496,8808,128,6,186,0,33
61356,10915,535,10380,9815,96,22,156,13,10
61358,410,18,392,364,8,0,0,0,3
61359,313,16,297,278,0,1,13,0,1
61360,3306,157,3149,2959,20,10,14,0,7
61361,1336,30,1306,1265,3,1,0,1,2
61362,5961,1062,4899,4501,95,13,61,0,16
61363,225,12,213,205,0,0,0,0,0
61364,18449,1978,16471,15076,468,26,105,0,68
61367,691,44,647,632,1,0,3,0,1
61368,1302,29,1273,1213,2,0,3,0,1
61369,1586,94,1492,1409,20,0,10,0,1
61370,1317,85,1232,1179,3,1,5,0,5
61371,100,8,92,81,1,1,2,0,1
61372,225,11,214,212,0,0,0,0,0
61373,1976,123,1853,1748,7,2,9,0,5
61374,77,0,77,76,0,0,0,0,0
61375,1095,20,1075,1034,6,3,4,0,4
61376,2022,43,1979,1904,4,0,2,1,1
61377,1302,82,1220,1136,25,1,7,0,3
61378,518,36,482,462,4,0,2,1,0
61379,1244,43,1201,1142,3,5,6,0,0
61401,31169,2373,28796,23279,3231,49,302,7,181
61402,1589,247,1342,328,1006,0,6,0,2
61410,3632,101,3531,3315,47,4,11,1,10
61411,355,12,343,319,1,1,0,0,0
61412,1346,35,1311,1260,2,2,7,0,0
61413,1020,23,997,962,5,0,2,0,0
61414,782,20,762,732,0,0,3,1,0
61415,1623,23,1600,1555,11,2,0,1,0
61416,210,8,202,195,0,0,0,0,2
61417,206,0,206,199,0,0,0,0,0
61418,677,12,665,646,3,1,1,1,0
61419,113,0,113,110,0,0,0,0,0
61420,964,9,955,924,0,0,4,0,2
61421,1234,27,1207,1176,2,2,1,0,2
61422,3099,41,3058,2883,33,1,4,2,6
61423,596,7,589,570,0,0,1,0,0
61424,59,0,59,55,0,0,0,0,0
61425,394,8,386,371,0,0,2,0,0
61426,92,2,90,81,1,0,0,0,0
61427,2157,17,2140,2062,7,3,2,0,1
61428,1125,15,1110,1082,7,0,3,0,1
61430,753,34,719,672,7,0,15,0,0
61431,295,0,295,292,1,1,0,0,0
61432,586,7,579,564,1,0,2,0,1
61433,41,1,40,40,0,0,0,0,0
61434,3058,93,2965,2826,21,4,5,1,4
61435,211,4,207,193,3,1,0,0,0
61436,840,10,830,805,0,3,0,0,1
61437,663,9,654,640,3,2,0,0,0
61438,709,11,698,670,0,2,5,0,0
61439,274,10,264,247,3,0,0,0,0
61440,600,5,595,583,0,3,1,0,1
61441,824,5,819,788,2,2,1,0,4
61442,691,12,679,646,2,1,0,0,0
61443,13780,1854,11926,10508,850,26,52,3,13
61447,923,17,906,853,8,0,5,0,0
61448,3794,91,3703,3522,31,6,5,0,3
61449,399,11,388,380,0,0,1,0,0
61450,1576,16,1560,1523,6,1,2,0,0
61451,305,6,299,279,2,1,2,0,2
61452,259,4,255,240,2,1,0,0,0
61453,609,11,598,569,2,2,2,0,0
61454,641,26,615,601,0,0,1,0,0
61455,17630,835,16795,14006,1449,36,530,2,61
61458,672,9,663,638,2,1,1,0,1
61459,396,3,393,382,0,1,1,0,0
61460,290,1,289,282,0,0,0,0,0
61462,10980,1675,9305,8021,549,14,309,9,34
61465,1116,32,1084,1049,0,0,7,1,0
61466,292,6,286,262,0,3,0,0,0
61467,1069,19,1050,1024,4,4,2,2,1
61468,104,6,98,92,1,0,0,0,0
61469,1802,27,1775,1692,16,1,4,4,0
61470,542,12,530,499,9,0,4,0,1
61471,102,0,102,102,0,0,0,0,0
61472,614,31,583,551,0,4,1,0,3
61473,1539,38,1501,1438,5,10,2,5,5
61474,282,3,279,266,0,0,1,1,2
61475,201,2,199,186,0,0,1,0,0
61476,386,6,380,373,1,0,1,0,0
61477,569,7,562,544,0,0,3,0,2
61478,298,8,290,271,0,1,2,0,4
61479,107,1,106,98,0,0,0,0,0
61480,1242,22,1220,1188,5,1,3,0,0
61482,559,8,551,535,1,2,0,0,1
61483,1872,43,1829,1754,5,3,7,0,1
61484,787,19,768,744,2,1,1,0,2
61485,541,21,520,503,0,0,0,0,3
61486,1383,43,1340,1282,0,5,6,0,0
61488,1019,39,980,936,12,0,5,0,0
61489,915,14,901,856,7,1,3,0,1
61490,1011,22,989,949,8,0,1,0,0
61491,2015,47,1968,1884,9,4,15,0,2
61501,1610,23,1587,1558,2,0,0,0,1
61516,662,14,648,630,2,0,2,1,2
61517,3293,40,3253,3130,8,6,7,1,12
61519,216,0,216,206,0,1,0,0,0
61520,16156,515,15641,13973,1060,28,54,3,41
61523,10951,384,10567,10013,41,18,35,2,31
61524,237,4,233,222,0,1,3,0,0
61525,11433,330,11103,8422,385,7,1809,4,32
61526,1060,18,1042,976,6,1,11,2,0
61528,3285,90,3195,2689,64,1,316,2,20
61529,2852,54,2798,2655,17,1,14,1,4
61530,6698,137,6561,6187,96,4,34,1,21
61531,3325,63,3262,3130,6,6,1,2,7
61532,475,4,471,445,0,2,0,0,2
61533,2198,28,2170,2066,4,5,8,0,2
61534,1622,27,1595,1512,8,6,3,0,1
61535,1748,26,1722,1629,8,4,21,0,7
61536,2974,75,2899,2768,12,7,19,0,8
61537,2807,44,2763,2631,8,3,12,0,9
61539,186,4,182,169,4,0,0,0,0
61540,2741,47,2694,2590,14,5,4,0,1
61541,94,3,91,88,2,0,0,0,0
61542,3423,36,3387,3257,10,5,1,1,16
61543,110,2,108,106,0,0,0,0,0
61544,688,11,677,651,2,1,0,0,1
61545,597,14,583,553,1,0,3,0,4
61546,3886,61,3825,3672,8,2,7,1,4
61547,3757,61,3696,3556,19,6,13,0,7
61548,12355,283,12072,11447,55,20,118,3,23
61550,18488,452,18036,17037,155,14,266,7,31
61552,244,13,231,189,9,2,9,0,2
61553,187,1,186,180,0,1,0,0,0
61554,40854,924,39930,37142,751,142,271,16,74
61559,3199,134,3065,2898,26,5,24,0,16
61560,654,5,649,627,1,2,1,0,2
61561,2610,41,2569,2486,13,2,4,2,8
61562,89,3,86,82,0,0,0,0,0
61563,534,4,530,502,4,2,0,0,0
61564,1002,13,989,944,8,5,3,0,2
61565,1409,37,1372,1295,9,3,5,0,5
61567,645,7,638,598,0,1,2,0,4
61568,4346,74,4272,4061,39,8,19,1,8
61569,1123,19,1104,1047,4,4,4,0,3
61570,1720,10,1710,1626,10,3,5,0,8
61571,24766,586,24180,22687,188,33,269,3,81
61572,997,9,988,950,1,1,2,0,1
61602,1198,89,1109,704,268,0,60,2,17
61603,15503,2249,13254,5675,6286,31,202,4,71
61604,29344,1727,27617,16677,8807,54,326,12,135
61605,14049,1305,12744,3622,8252,27,39,9,87
61606,6798,608,6190,3979,1549,34,233,2,47
61607,10353,287,10066,9340,147,22,65,2,28
61610,4942,178,4764,4409,63,13,15,2,7
61611,23837,769,23068,21253,346,39,186,14,79
61614,27119,1125,25994,19347,3759,56,1388,14,123
61615,24314,1130,23184,15479,3407,42,3075,4,110
61616,5966,263,5703,4764,502,9,58,0,27
61625,495,58,437,346,56,5,15,0,0
61701,34497,3092,31405,23842,4582,82,850,16,156
61704,37129,2521,34608,25694,2896,68,4306,11,113
61705,14682,710,13972,11754,1038,25,537,7,56
61720,256,6,250,238,1,0,1,0,1
61721,565,3,562,536,1,2,2,0,0
61722,551,34,517,479,0,0,2,0,2
61723,2266,42,2224,2131,9,3,7,0,3
61724,494,4,490,473,0,1,2,0,0
61725,1558,33,1525,1419,34,5,9,0,8
61726,2417,101,2316,2187,17,0,18,0,8
61727,9450,408,9042,8640,80,12,29,11,10
61728,1381,30,1351,1274,14,0,3,0,2
61729,1182,8,1174,1138,4,3,12,0,3
61730,305,3,302,289,0,0,0,0,0
61731,220,15,205,195,0,0,2,0,0
61732,2101,40,2061,1961,3,3,3,0,11
61733,1099,13,1086,1024,12,4,9,0,7
61734,2597,36,2561,2410,20,3,7,0,13
61735,360,10,350,345,0,0,1,0,0
61736,1966,33,1933,1859,8,2,11,0,1
61737,444,7,437,425,4,0,1,0,1
61738,4253,79,4174,3956,52,3,13,0,3
61739,4784,151,4633,4471,30,8,20,0,8
61740,1484,31,1453,1378,13,1,18,0,5
61741,1538,118,1420,1376,4,3,2,0,3
61742,1186,23,1163,1130,5,1,1,0,0
61743,164,5,159,155,0,0,0,0,0
61744,2021,56,1965,1866,22,0,8,0,7
61745,4331,117,4214,4038,8,3,13,2,15
61747,1471,13,1458,1384,9,5,7,0,2
61748,2721,56,2665,2548,11,5,11,0,4
61749,588,14,574,546,2,0,2,0,3
61750,92,0,92,92,0,0,0,0,0
61751,110,4,106,99,0,0,3,0,0
61752,4250,78,4172,3998,15,5,7,1,10
61753,2950,43,2907,2776,14,2,4,0,9
61754,1192,28,1164,1094,6,5,6,0,3
61755,4422,78,4344,4114,29,5,15,0,9
61756,2165,20,2145,2031,16,4,12,1,0
61759,1449,29,1420,1359,4,2,4,0,3
61760,2350,22,2328,2239,13,3,0,0,7
61761,53045,3469,49576,38799,6002,53,2307,1,203
61764,13668,965,12703,11209,953,20,79,0,52
61769,556,25,531,508,1,0,0,0,1
61770,996,37,959,911,3,0,2,0,5
61771,1005,13,992,958,4,0,2,0,4
61772,348,10,338,317,3,0,3,0,0
61773,447,13,434,404,2,0,0,0,7
61774,949,10,939,890,4,0,4,0,3
61775,286,8,278,264,4,0,1,1,0
61776,1393,22,1371,1309,15,0,3,0,1
61777,864,14,850,823,1,0,3,2,0
61778,638,11,627,597,4,4,1,0,0
61801,27658,2613,25045,12940,4443,42,6098,8,132
61802,19460,2290,17170,11094,3840,30,1126,5,80
61810,329,6,323,298,8,2,0,0,0
61811,666,13,653,606,3,3,3,0,5
61812,275,2,273,267,0,0,1,0,0
61813,1705,21,1684,1589,10,1,6,1,8
61814,1206,49,1157,1087,15,1,5,0,0
61815,339,6,333,287,11,0,0,0,0
61816,482,9,473,449,3,0,1,0,0
61817,2490,40,2450,2351,8,4,5,0,6
61818,1553,19,1534,1453,7,5,2,0,8
61820,40822,4559,36263,19026,5197,49,10042,14,226
61821,29057,2199,26858,16226,7471,42,1401,5,101
61822,25091,1289,23802,15155,3596,14,3564,9,134
61830,497,5,492,464,2,0,2,0,0
61831,133,2,131,126,0,0,0,0,0
61832,32878,2005,30873,19778,8853,59,443,6,139
61833,1968,53,1915,1783,31,2,5,0,6
61834,7895,539,7356,5996,1054,20,39,0,30
61839,584,23,561,527,5,1,0,0,0
61840,784,10,774,740,1,2,2,0,1
61841,1307,20,1287,1250,2,1,2,0,0
61842,2771,47,2724,2601,17,2,3,3,3
61843,2527,42,2485,2363,13,2,9,1,2
61844,1027,36,991,934,5,3,4,0,4
61845,352,8,344,327,0,0,2,1,0
61846,4669,94,4575,4259,105,11,7,1,12
61847,1188,23,1165,1109,7,2,4,0,3
61848,202,4,198,189,0,0,1,0,1
61849,1715,33,1682,1603,4,0,10,0,1
61850,511,3,508,488,2,6,0,0,0
61851,425,9,416,399,1,0,3,0,0
61852,205,1,204,195,1,0,0,0,0
61853,14218,463,13755,12688,116,27,286,5,27
61854,1431,19,1412,1358,0,2,3,0,4
61855,107,2,105,103,0,1,0,0,0
61856,7933,109,7824,7434,48,9,56,0,23
61857,177,1,176,169,1,0,0,0,0
61858,2756,50,2706,2553,22,7,7,0,7
61859,1119,13,1106,1070,3,0,1,0,6
61862,456,13,443,417,4,0,1,0,1
61863,827,13,814,777,7,0,0,0,9
61864,1637,17,1620,1543,4,3,7,2,13
61865,1359,40,1319,1241,12,1,6,0,5
61866,13459,2272,11187,7250,2771,26,148,8,50
61870,1186,20,1166,1113,7,3,1,3,2
61871,308,2,306,292,0,0,3,0,1
61872,748,19,729,653,0,6,10,0,2
61873,5911,135,5776,5495,21,11,39,0,17
61874,8739,371,8368,5686,598,11,1618,1,38
61875,802,23,779,718,10,0,5,0,11
61876,671,7,664,635,1,1,2,0,2
61877,1585,30,1555,1464,10,0,7,0,8
61878,1347,61,1286,1198,26,1,6,0,2
61880,4317,101,4216,3928,42,10,21,1,21
61882,641,5,636,612,0,0,2,0,1
61883,4340,94,4246,4028,42,6,14,0,18
61884,1094,14,1080,1021,2,2,3,0,5
61910,4460,1094,3366,3244,10,3,29,2,17
61911,4849,146,4703,4612,6,4,11,0,4
61912,1143,7,1136,1102,4,6,5,0,0
61913,1563,26,1537,1487,4,0,8,0,1
61914,1845,17,1828,1737,1,10,3,0,5
61917,569,4,565,548,2,2,0,0,1
61919,778,10,768,738,0,1,1,1,2
61920,20847,1067,19780,16898,1456,35,457,23,157
61924,2274,25,2249,2154,12,1,6,0,14
61925,944,16,928,857,21,1,1,0,7
61928,606,1,605,591,0,1,3,0,2
61929,759,20,739,706,4,2,2,0,1
61930,486,24,462,449,1,1,0,0,0
61931,1075,44,1031,1006,5,0,0,0,0
61932,396,6,390,377,0,0,0,0,1
61933,977,13,964,890,7,0,1,0,2
61936,220,3,217,198,2,1,0,0,1
61937,1934,22,1912,1818,10,6,9,0,1
61938,20768,605,20163,18500,568,37,138,1,49
61940,216,4,212,198,4,0,0,0,0
61941,44,0,44,44,0,0,0,0,0
61942,1146,40,1106,1055,9,2,4,0,0
61943,1438,29,1409,1358,3,0,2,0,1
61944,11780,168,11612,11203,57,14,44,0,12
61949,144,2,142,140,0,0,0,0,0
61951,8057,118,7939,7618,63,9,29,0,12
61953,6365,186,6179,5869,26,11,58,1,7
61955,193,1,192,189,0,0,0,0,0
61956,2885,86,2799,2641,16,6,6,2,8
61957,1766,13,1753,1690,0,6,4,1,0
62001,1702,72,1630,1553,9,4,3,0,8
62002,30176,753,29423,20657,6653,96,207,11,150
62006,633,9,624,618,0,0,0,0,0
62009,1636,32,1604,1497,7,7,3,0,1
62010,10847,258,10589,9847,174,15,54,1,22
62011,186,5,181,166,0,1,0,0,0
62012,6373,84,6289,6031,38,7,12,0,8
62013,430,7,423,399,2,0,0,0,2
62014,3836,68,3768,3512,21,7,16,0,1
62015,491,6,485,455,1,2,3,0,0
62016,3690,48,3642,3518,11,3,6,0,6
62017,1115,8,1107,1051,1,3,1,0,3
62018,3412,106,3306,2847,216,15,22,5,14
62019,425,5,420,395,0,0,2,0,0
62021,1033,16,1017,940,3,4,6,0,5
62022,1074,14,1060,1000,5,1,6,0,3
62023,101,1,100,94,0,0,0,0,0
62024,9337,190,9147,8166,397,27,42,4,26
62025,35229,1205,34024,28864,2616,45,822,30,109
62026,1197,68,1129,773,270,2,46,0,2
62027,411,0,411,400,0,0,1,0,4
62028,1148,43,1105,979,60,1,15,3,1
62030,96,3,93,89,0,0,0,0,0
62031,830,13,817,801,0,0,0,0,0
62032,684,5,679,648,2,0,0,0,1
62033,4584,41,4543,4320,8,16,16,0,4
62034,14665,844,13821,11736,1003,23,317,10,53
62035,16172,408,15764,13742,1139,40,125,0,64
62036,610,10,600,588,2,0,0,0,0
62037,1779,22,1757,1657,15,0,3,0,3
62040,40872,2904,37968,31548,3858,94,281,3,108
62044,1728,11,1717,1666,1,2,0,1,2
62045,513,8,505,478,2,0,1,0,0
62046,913,9,904,843,9,0,6,0,0
62047,1443,17,1426,1387,1,1,6,0,4
62048,1240,40,1200,1120,15,3,11,0,1
62049,7952,251,7701,6589,826,17,29,2,8
62050,282,1,281,268,1,2,1,0,3
62051,848,18,830,815,2,2,0,0,1
62052,12503,158,12345,11740,50,9,40,0,22
62053,635,13,622,578,0,3,0,0,0
62054,641,4,637,610,1,3,1,0,0
62056,8559,176,8383,7987,52,7,74,3,4
62058,767,21,746,693,0,4,4,0,0
62059,631,9,622,8,595,2,0,0,1
62060,3865,189,3676,874,2655,12,15,1,5
62061,1745,34,1711,1590,4,5,9,2,2
62062,8297,311,7986,7022,422,9,180,3,11
62063,1144,16,1128,1068,7,5,1,0,4
62067,2390,31,2359,2253,10,7,10,0,3
62069,3076,42,3034,2911,5,2,10,0,1
62074,1103,47,1056,1013,6,2,0,0,0
62075,3229,47,3182,3048,15,4,14,1,3
62076,123,3,120,116,0,0,0,0,0
62077,383,7,376,360,0,0,2,0,6
62078,76,0,76,72,0,0,0,0,0
62079,314,2,312,302,0,0,1,0,0
62080,2197,20,2177,2108,3,4,2,0,1
62081,295,3,292,283,0,0,0,0,1
62082,2401,25,2376,2270,2,0,2,0,6
62083,199,0,199,195,0,0,0,0,0
62084,1520,43,1477,1360,31,9,9,2,4
62085,246,3,243,232,0,0,0,0,0
62086,1237,19,1218,1167,4,3,0,0,0
62087,1887,51,1836,1637,79,9,8,1,4
62088,6605,112,6493,6153,17,18,30,0,6
62089,499,7,492,480,0,0,0,0,1
62090,988,7,981,26,941,1,0,0,0
62091,358,3,355,339,0,1,1,0,2
62092,2682,19,2663,2568,2,3,10,2,1
62093,529,3,526,485,4,1,2,0,2
62094,1017,14,1003,960,7,3,2,0,0
62095,11060,236,10824,9735,440,23,54,5,39
62097,2906,62,2844,2695,16,3,14,2,5
62098,90,0,90,90,0,0,0,0,0
62201,5125,1857,3268,474,2634,7,15,0,9
62203,6344,109,6235,457,5600,6,7,1,14
62204,4483,71,4412,112,4176,2,5,0,29
62205,6682,61,6621,81,6345,16,5,2,15
62206,12929,300,12629,2991,9022,47,10,6,54
62207,7045,83,6962,141,6570,6,4,3,23
62208,16992,764,16228,9117,5447,26,470,11,115
62214,1087,19,1068,1043,1,0,2,2,0
62215,1877,170,1707,1647,4,0,7,0,6
62216,3019,67,2952,2843,9,10,16,1,6
62217,738,8,730,703,0,0,0,0,0
62218,1566,16,1550,1521,5,0,0,0,0
62219,934,51,883,846,3,1,5,0,0
62220,19474,773,18701,12650,4634,31,188,19,92
62221,29039,1226,27813,16364,8779,67,648,20,138
62223,16263,535,15728,10409,4293,38,113,2,110
62225,5332,619,4713,3377,675,10,203,23,33
62226,29156,1017,28139,16965,9104,64,498,31,112
62230,6414,226,6188,6012,14,10,16,0,10
62231,7171,117,7054,6519,177,26,43,1,14
62232,7547,995,6552,5353,667,20,91,4,34
62233,8187,527,7660,5866,1575,9,17,0,11
62234,31843,2890,28953,23254,3668,55,240,7,108
62236,13924,297,13627,12964,70,20,83,0,31
62237,2413,22,2391,2298,28,0,9,4,9
62238,617,24,593,547,8,1,3,0,1
62239,4638,129,4509,3978,203,14,17,2,18
62240,1645,42,1603,1454,52,8,1,0,3
62241,1010,6,1004,984,0,2,1,0,2
62242,1239,19,1220,1149,2,4,0,0,1
62243,5796,130,5666,5376,26,12,14,7,18
62244,1059,10,1049,994,5,3,6,0,1
62245,1815,68,1747,1695,4,3,1,0,0
62246,10145,524,9621,8085,989,39,87,11,86
62248,429,10,419,401,0,1,0,0,0
62249,16052,294,15758,14970,48,25,109,1,35
62250,439,12,427,408,2,1,2,0,1
62253,656,8,648,614,0,1,3,0,5
62254,6503,255,6248,5029,766,13,74,2,26
62255,953,26,927,886,1,2,0,0,0
62256,66,0,66,60,1,0,0,0,0
62257,2753,39,2714,2583,20,2,1,2,1
62258,10379,499,9880,8453,549,27,148,8,59
62260,7162,141,7021,6611,71,7,30,3,17
62261,145,5,140,134,0,1,0,0,0
62262,1541,17,1524,1422,48,3,1,0,2
62263,5105,90,5015,4789,40,12,38,6,1
62264,3147,69,3078,2915,13,4,6,1,10
62265,4446,213,4233,3858,100,10,30,2,21
62266,248,27,221,212,1,0,0,0,0
62268,704,21,683,643,0,1,5,1,9
62269,36068,1844,34224,25310,5390,49,1005,32,190
62271,2101,28,2073,1983,5,7,8,11,0
62272,1472,177,1295,1232,5,1,3,1,0
62273,268,2,266,255,1,0,0,0,0
62274,7673,375,7298,5813,1251,9,42,0,7
62275,3452,52,3400,3268,18,6,7,0,5
62277,1113,9,1104,1027,0,8,0,0,3
62278,6646,91,6555,6247,27,14,26,0,17
62279,97,5,92,92,0,0,0,0,0
62280,404,2,402,386,0,0,0,0,1
62281,2912,83,2829,2640,25,0,25,2,13
62282,638,10,628,610,0,0,4,0,0
62284,556,10,546,512,15,2,1,0,0
62285,4718,68,4650,4400,38,7,26,1,11
62286,5719,119,5600,4511,735,7,17,1,29
62288,2708,40,2668,2546,15,4,16,1,1
62289,410,10,400,369,4,0,5,1,0
62292,770,28,742,684,3,0,0,0,5
62293,4562,128,4434,4172,34,17,27,1,15
62294,15431,455,14976,13748,294,29,119,2,47
62295,1514,33,1481,1406,2,2,5,0,4
62297,378,2,376,364,0,0,1,0,1
62298,17630,302,17328,16503,40,23,96,2,26
62301,31481,783,30698,26607,2004,51,234,16,128
62305,19042,294,18748,17477,401,19,227,13,46
62311,754,9,745,716,2,1,0,0,1
62312,2017,29,1988,1886,6,3,7,0,6
62313,387,3,384,376,1,0,0,0,0
62314,500,7,493,468,1,0,1,2,1
62316,664,5,659,619,2,3,4,0,1
62319,199,2,197,195,0,0,0,0,0
62320,2286,28,2258,2173,7,2,9,0,7
62321,3873,141,3732,3573,4,10,14,1,3
62323,233,1,232,219,2,1,1,1,0
62324,1278,25,1253,1192,11,1,3,0,2
62325,416,7,409,387,2,0,0,0,2
62326,2255,18,2237,2175,3,4,10,1,0
62330,1600,17,1583,1534,3,3,3,0,2
62334,147,1,146,139,1,0,1,0,0
62336,82,0,82,75,1,0,0,0,0
62338,1437,24,1413,1330,16,3,8,0,4
62339,852,13,839,800,0,2,8,0,3
62340,1618,32,1586,1522,6,4,3,2,4
62341,3369,57,3312,3154,28,7,17,0,10
62343,653,17,636,609,0,0,0,0,1
62344,101,1,100,95,1,0,0,0,0
62345,302,3,299,284,0,1,1,0,0
62346,185,5,180,172,1,1,0,0,0
62347,2371,23,2348,2257,11,4,1,0,9
62348,165,4,161,154,0,0,0,0,0
62349,627,11,616,576,2,0,0,0,3
62351,1793,17,1776,1722,1,0,0,0,6
62352,229,0,229,215,0,3,1,0,0
62353,5093,273,4820,3661,1032,4,9,0,2
62354,1475,34,1441,1367,10,9,2,1,5
62355,718,0,718,701,0,3,2,0,0
62356,506,10,496,479,0,0,3,0,0
62357,233,4,229,226,0,0,0,0,0
62358,699,11,688,660,8,1,1,0,1
62359,149,2,147,139,0,0,1,0,0
62360,1706,27,1679,1586,8,6,6,1,1
62361,373,1,372,359,0,1,2,0,0
62362,358,0,358,337,1,0,1,0,0
62363,5726,135,5591,5368,44,17,21,0,6
62365,577,8,569,539,0,0,0,3,0
62366,1338,23,1315,1268,2,0,0,1,0
62367,1165,7,1158,1123,5,4,2,1,2
62370,382,3,379,369,1,0,0,0,2
62373,305,3,302,299,0,0,0,1,0
62374,285,4,281,255,0,0,3,0,0
62375,341,2,339,326,0,0,2,0,0
62376,1187,17,1170,1097,0,2,3,0,12
62378,793,6,787,761,3,4,0,0,0
62379,1894,24,1870,1776,4,6,11,1,1
62380,319,4,315,301,0,0,0,0,3
62401,19408,677,18731,17837,115,19,196,4,26
62410,996,14,982,960,0,1,2,0,4
62411,4408,61,4347,4181,10,11,12,1,2
62413,442,5,437,424,1,1,3,0,1
62414,1831,28,1803,1730,2,0,3,1,7
62417,2984,38,2946,2824,32,1,3,2,6
62418,2027,18,2009,1951,9,4,2,0,4
62419,397,1,396,389,0,2,1,0,0
62420,4196,57,4139,4022,17,2,8,0,4
62421,744,6,738,726,1,0,1,0,0
62422,1041,11,1030,979,7,3,6,0,9
62423,653,4,649,623,0,2,4,0,2
62424,2427,27,2400,2322,5,1,7,0,2
62425,576,2,574,565,1,1,0,0,1
62426,912,13,899,844,3,2,2,0,4
62427,1582,10,1572,1513,8,3,5,0,5
62428,2907,29,2878,2747,12,4,4,0,4
62431,1043,7,1036,1020,0,2,1,0,0
62432,569,8,561,535,0,0,2,0,1
62433,866,16,850,824,6,2,1,0,5
62434,346,0,346,337,0,0,0,0,0
62436,571,3,568,551,0,1,1,0,0
62438,286,5,281,268,1,0,0,0,1
62439,6966,128,6838,6400,85,5,38,4,11
62440,1121,14,1107,1041,2,2,12,0,2
62441,7236,149,7087,6809,31,16,37,0,12
62442,2322,34,2288,2198,2,6,5,0,9
62443,1589,15,1574,1507,8,4,5,0,1
62444,365,2,363,358,0,2,0,0,1
62445,940,9,931,902,0,0,12,0,2
62446,372,9,363,346,7,0,3,0,0
62447,3005,44,2961,2861,11,3,5,0,8
62448,5719,59,5660,5485,22,8,9,3,14
62449,3095,35,3060,2918,34,8,6,1,3
62450,11978,242,11736,11113,64,23,118,6,13
62451,1972,16,1956,1885,0,0,13,0,3
62452,363,0,363,348,2,0,3,1,0
62454,10753,371,10382,9407,563,23,49,1,10
62458,2170,37,2133,2082,4,1,2,0,8
62459,238,2,236,230,0,3,2,0,0
62460,1018,16,1002,945,1,6,0,1,3
62461,781,16,765,718,2,0,5,0,1
62462,1103,10,1093,1058,1,1,4,0,2
62463,1184,11,1173,1127,3,0,10,0,1
62464,99,0,99,95,0,0,0,0,0
62465,921,5,916,900,1,0,2,0,1
62466,4201,329,3872,2502,1271,0,16,0,8
62467,3764,30,3734,3661,4,0,9,0,7
62468,2601,26,2575,2497,4,2,7,0,4
62469,472,5,467,430,3,1,3,0,2
62471,10530,547,9983,8863,757,66,51,0,15
62473,1280,10,1270,1241,3,0,0,0,0
62474,749,4,745,720,7,3,1,0,0
62475,271,1,270,269,0,0,0,0,0
62476,1570,11,1559,1522,2,7,1,0,3
62477,904,3,901,876,0,1,0,0,6
62478,331,0,331,322,1,1,0,0,2
62479,782,6,776,763,0,0,1,1,2
62480,639,6,633,613,0,2,1,0,2
62481,348,0,348,331,0,4,0,0,0
62501,2377,27,2350,2243,9,4,4,1,9
62510,1650,30,1620,1533,11,0,6,0,0
62512,428,5,423,414,2,0,0,0,0
62513,1716,31,1685,1590,8,9,1,1,5
62514,209,1,208,207,0,0,0,0,0
62515,909,5,904,848,2,2,3,0,2
62517,219,5,214,199,0,0,0,0,1
62518,411,6,405,396,0,0,1,0,1
62519,89,0,89,86,1,1,0,0,0
62520,1505,20,1485,1420,4,1,2,0,4
62521,33793,739,33054,24459,6435,48,249,15,118
62522,14838,457,14381,9311,4031,43,108,5,90
62523,886,24,862,428,397,4,10,0,2
62526,31758,1140,30618,20185,7837,47,608,7,149
62530,1458,13,1445,1368,3,4,3,0,6
62531,1740,24,1716,1645,2,5,2,0,15
62532,119,3,116,115,0,0,0,0,0
62533,929,23,906,865,5,2,0,0,0
62534,1066,7,1059,1037,6,1,2,0,0
62535,3745,87,3658,3039,74,3,408,0,7
62536,886,10,876,830,5,4,7,0,1
62537,182,1,181,173,1,0,1,0,0
62538,339,7,332,318,1,4,0,0,0
62539,1264,15,1249,1196,1,3,1,0,2
62540,1341,10,1331,1267,5,3,1,0,3
62541,50,0,50,49,1,0,0,0,0
62543,453,2,451,429,0,0,1,0,0
62544,1795,28,1767,1717,7,1,0,0,5
62545,1162,18,1144,1095,6,4,3,0,0
62546,1560,23,1537,1473,2,1,1,0,2
62547,742,15,727,684,2,0,3,0,5
62548,2145,21,2124,2080,3,2,1,0,1
62549,6282,92,6190,5810,47,8,80,1,19
62550,2708,30,2678,2585,26,10,8,0,4
62551,753,7,746,714,1,3,6,0,1
62553,474,3,471,463,0,1,1,0,0
62554,1559,40,1519,1424,6,2,19,0,4
62555,535,3,532,510,2,1,6,0,0
62556,399,1,398,375,1,3,0,0,0
62557,6841,63,6778,6523,21,7,35,0,4
62558,3503,38,3465,3273,27,3,12,0,17
62560,1431,12,1419,1352,8,5,5,1,3
62561,5229,106,5123,4716,62,10,27,3,24
62563,6062,99,5963,5577,55,5,55,1,25
62565,7477,102,7375,7134,27,11,34,0,10
62567,1013,12,1001,949,3,1,1,1,1
62568,17043,896,16147,15188,320,31,120,0,23
62570,473,7,466,446,2,1,3,0,0
62571,1242,7,1235,1184,0,0,4,0,5
62572,522,2,520,504,0,0,4,0,0
62573,1416,19,1397,1316,7,1,2,0,5
62601,361,1,360,351,2,0,0,0,0
62610,213,1,212,202,2,0,1,0,0
62611,978,48,930,887,6,0,0,2,0
62612,1774,3,1771,1687,11,8,3,0,0
62613,3869,40,3829,3591,32,6,12,1,3
62615,5424,102,5322,4994,35,19,17,0,25
62617,662,7,655,643,3,1,2,0,0
62618,7596,2620,4976,4009,671,18,103,29,9
62621,1072,14,1058,1018,0,0,3,0,1
62622,77,5,72,71,0,0,0,0,1
62624,461,11,450,438,0,0,0,1,1
62625,817,14,803,772,3,1,2,0,6
62626,8033,95,7938,7358,134,20,60,0,10
62627,928,12,916,890,3,1,5,0,0
62628,825,4,821,788,2,0,0,0,1
62629,15255,392,14863,13031,557,32,520,0,50
62630,474,4,470,440,2,0,0,0,2
62631,307,4,303,299,0,0,0,0,0
62633,617,12,605,593,3,1,0,0,1
62634,847,17,830,782,6,3,4,0,1
62635,718,8,710,683,5,1,3,0,0
62638,1305,7,1298,1240,0,0,3,0,4
62639,283,3,280,265,0,3,0,0,0
62640,3446,39,3407,3227,19,9,11,0,3
62642,1344,20,1324,1269,5,2,5,1,4
62643,450,4,446,426,3,3,2,0,0
62644,4690,72,4618,4372,24,9,7,0,4
62649,453,6,447,439,0,0,0,0,0
62650,24891,759,24132,20882,1924,49,235,9,70
62655,566,7,559,534,1,2,3,0,0
62656,18634,684,17950,15577,1462,33,154,1,68
62661,1280,14,1266,1183,12,2,4,0,4
62663,265,1,264,254,0,0,0,0,0
62664,2712,31,2681,2587,12,4,8,1,0
62665,1279,17,1262,1212,2,0,1,5,1
62666,570,10,560,540,1,0,1,0,1
62667,459,4,455,436,0,1,3,0,0
62668,1378,17,1361,1302,12,0,7,0,0
62670,3162,40,3122,2976,20,3,11,1,6
62671,515,6,509,483,1,1,1,0,0
62672,208,0,208,193,1,0,0,0,0
62673,462,3,459,448,1,0,0,0,0
62674,1305,10,1295,1247,4,9,3,0,0
62675,6044,92,5952,5663,37,8,31,0,16
62677,2571,48,2523,2402,16,1,8,1,10
62681,5284,120,5164,4633,280,17,25,1,16
62682,745,16,729,698,2,2,1,0,2
62684,5469,96,5373,5103,42,5,47,1,8
62685,1814,18,1796,1610,89,12,0,0,7
62688,652,5,647,605,5,2,0,0,2
62689,516,8,508,480,4,0,0,0,0
62690,3736,46,3690,3540,22,0,19,0,10
62691,2278,105,2173,2078,15,9,6,2,0
62692,1970,29,1941,1831,14,6,14,2,7
62693,1733,25,1708,1629,5,3,1,0,2
62694,3061,31,3030,2948,5,1,7,1,4
62695,464,9,455,433,4,0,6,0,4
62701,1354,61,1293,729,392,1,111,2,11
62702,33712,1041,32671,23524,6400,82,327,4,164
62703,28344,990,27354,14883,10354,80,295,26,145
62704,39157,1359,37798,28013,6235,46,1312,12,142
62706,0,0,0,0,0,0,0,0,0
62707,7290,127,7163,6436,305,20,41,2,23
62711,18115,453,17662,15168,703,19,1195,1,27
62712,10321,210,10111,8985,437,2,296,1,20
62801,20502,720,19782,16146,2152,43,280,1,74
62803,967,21,946,896,20,3,3,0,1
62806,3247,35,3212,3094,10,0,20,2,8
62807,879,5,874,843,4,3,0,0,1
62808,1383,22,1361,1313,3,1,5,0,2
62809,304,1,303,299,0,1,0,0,0
62810,1088,16,1072,1021,0,5,0,0,0
62811,282,1,281,272,0,0,0,0,0
62812,10962,249,10713,10129,45,36,54,0,14
62814,2013,17,1996,1907,7,1,9,0,0
62815,353,1,352,344,2,1,0,0,0
62816,1158,8,1150,1083,6,3,0,0,2
62817,522,7,515,483,3,0,3,0,0
62818,356,6,350,346,0,0,0,0,1
62819,412,4,408,383,1,0,0,0,0
62820,142,1,141,131,1,1,0,0,0
62821,7083,106,6977,6615,32,10,47,7,5
62822,2745,22,2723,2590,11,8,0,0,6
62823,1693,15,1678,1618,0,0,6,0,4
62824,1654,6,1648,1602,1,9,3,0,2
62825,193,2,191,175,0,0,1,0,0
62827,1103,7,1096,1048,14,6,0,4,3
62828,1363,10,1353,1312,2,0,2,0,0
62829,52,0,52,49,0,0,0,0,0
62830,1436,31,1405,1301,19,3,17,0,0
62831,526,8,518,507,0,0,2,0,0
62832,8921,225,8696,7912,377,19,68,1,19
62833,390,3,387,383,0,0,0,0,0
62835,1354,38,1316,1227,37,3,6,0,1
62836,815,7,808,764,5,1,0,0,0
62837,8467,122,8345,8004,75,23,32,1,18
62838,1463,11,1452,1411,1,2,8,0,2
62839,6441,135,6306,5959,24,18,64,0,8
62841,151,1,150,145,1,0,0,0,0
62842,807,2,805,781,3,1,2,1,1
62843,74,2,72,65,1,0,0,1,0
62844,1930,28,1902,1820,3,1,11,2,6
62846,1930,143,1787,1335,399,4,11,0,1
62848,564,8,556,533,4,0,2,0,1
62849,2181,14,2167,2087,3,3,5,0,3
62850,389,1,388,366,0,0,0,0,1
62851,330,2,328,319,2,0,0,0,1
62852,150,1,149,144,0,2,0,0,0
62853,927,12,915,887,1,0,3,0,3
62854,1605,34,1571,1505,3,5,5,0,0
62856,332,7,325,315,0,0,1,0,1
62858,2962,58,2904,2810,3,2,7,0,5
62859,5346,72,5274,5059,28,14,7,0,1
62860,507,5,502,482,4,1,0,0,0
62861,91,1,90,86,2,0,0,0,1
62862,316,3,313,304,0,1,0,0,0
62863,9607,156,9451,8834,53,12,249,6,9
62864,23327,635,22692,18712,2299,52,304,7,56
62865,2012,14,1998,1903,2,5,4,1,7
62867,484,2,482,467,0,0,3,0,0
62868,1883,24,1859,1795,7,2,0,0,8
62869,2602,19,2583,2485,3,0,1,7,0
62870,1890,26,1864,1747,27,13,2,0,5
62871,588,0,588,570,0,0,1,0,0
62872,1204,5,1199,1157,5,1,0,0,0
62874,347,5,342,325,0,3,0,0,0
62875,1154,11,1143,1072,5,2,2,0,3
62876,198,7,191,179,6,0,1,0,0
62877,447,7,440,420,2,0,0,0,1
62878,341,2,339,325,0,0,0,0,0
62879,42,0,42,38,0,0,0,0,0
62880,698,2,696,685,0,0,1,0,0
62881,11053,185,10868,10118,105,22,72,0,17
62882,2215,27,2188,2026,27,10,9,0,6
62883,660,5,655,634,2,0,0,0,0
62884,2907,66,2841,2700,11,5,2,0,0
62885,777,3,774,757,2,1,0,1,3
62886,368,0,368,355,0,0,2,1,0
62887,270,0,270,254,1,2,0,0,0
62888,1956,25,1931,1855,11,3,6,0,2
62889,803,4,799,772,5,1,1,0,0
62890,2631,27,2604,2501,16,4,1,0,7
62891,546,10,536,515,0,0,1,0,1
62892,291,1,290,288,0,0,0,0,0
62893,904,7,897,850,4,3,5,0,2
62894,1000,5,995,949,10,2,0,0,5
62895,1864,20,1844,1784,1,0,3,1,3
62896,11376,201,11175,10516,66,31,44,3,23
62897,435,0,435,425,2,0,5,0,0
62898,2038,18,2020,1905,19,3,8,0,4
62899,1692,23,1669,1610,2,3,4,0,2
62901,22967,1591,21376,12855,5402,45,1676,13,130
62902,4344,270,4074,3360,296,13,123,1,25
62903,2473,188,2285,1835,228,2,77,2,12
62905,633,78,555,517,2,3,6,0,1
62906,7464,270,7194,6633,183,26,36,8,10
62907,2120,35,2085,2007,1,10,2,0,2
62908,454,4,450,424,3,1,0,1,0
62910,2269,35,2234,1938,168,8,4,0,5
62912,1226,18,1208,1149,5,1,1,0,2
62914,1929,21,1908,543,1261,6,0,0,5
62915,506,27,479,418,15,3,1,0,3
62916,1045,9,1036,1010,1,1,1,0,0
62917,2406,44,2362,2001,217,11,7,0,14
62918,10538,309,10229,9074,319,27,249,5,30
62919,768,12,756,715,0,0,3,0,1
62920,3072,398,2674,2516,25,8,11,2,7
62921,342,3,339,182,134,0,2,0,0
62922,2871,41,2830,2666,8,4,3,0,5
62923,497,5,492,466,6,0,1,1,1
62924,2726,87,2639,2363,101,8,6,0,6
62926,2063,37,2026,1897,16,7,8,0,3
62927,399,6,393,359,8,3,1,0,0
62928,176,3,173,169,1,0,0,0,0
62930,5716,102,5614,5343,33,7,10,0,14
62931,1237,25,1212,1136,4,1,7,1,2
62932,1451,33,1418,1288,37,3,5,1,1
62933,1108,17,1091,1016,24,2,7,0,1
62934,882,13,869,838,0,0,3,0,4
62935,2060,24,2036,1940,11,8,5,0,5
62938,2532,53,2479,2330,30,1,15,0,1
62939,3129,44,3085,2937,12,1,9,1,1
62940,397,16,381,357,6,1,0,0,1
62941,706,10,696,632,30,3,0,0,1
62942,567,9,558,534,2,0,0,0,0
62943,653,17,636,601,5,3,0,1,0
62946,12235,282,11953,10761,425,33,96,0,55
62947,533,7,526,500,2,0,1,0,0
62948,12536,305,12231,11029,350,22,174,3,29
62949,780,3,777,733,7,2,1,0,3
62950,193,7,186,177,4,0,0,0,0
62951,5136,115,5021,4679,37,13,12,0,12
62952,3036,72,2964,2837,13,7,7,0,4
62953,350,8,342,289,32,1,1,0,1
62954,442,3,439,428,0,0,0,0,0
62956,875,24,851,762,46,3,2,0,3
62957,733,12,721,653,27,0,2,0,2
62958,2206,78,2128,1844,44,4,85,3,11
62959,27629,829,26800,23189,1847,145,293,1,99
62960,10792,280,10512,9140,672,26,39,5,52
62961,52,0,52,46,0,0,0,0,0
62962,14,1,13,11,0,1,0,0,0
62963,544,5,539,204,299,2,0,0,6
62964,1141,17,1124,480,598,5,1,0,3
62965,126,3,123,106,1,2,1,0,1
62966,14026,583,13443,11204,1433,22,91,5,65
62967,246,1,245,236,2,0,0,0,1
62969,350,4,346,314,1,3,0,0,1
62970,583,3,580,496,57,6,0,0,2
62972,1265,20,1245,1203,3,2,0,0,1
62974,1508,22,1486,1406,3,5,4,0,6
62975,266,4,262,253,0,0,1,0,0
62976,392,7,385,167,204,0,0,0,0
62977,678,10,668,640,1,8,3,0,0
62979,1194,11,1183,1123,12,0,8,0,0
62982,1156,25,1131,1063,9,0,8,1,0
62983,1513,23,1490,1414,6,0,0,0,6
62984,1567,26,1541,1457,11,4,8,0,3
62985,895,11,884,846,1,1,2,0,1
62987,1266,14,1252,1202,2,2,4,0,1
62988,1256,23,1233,884,298,8,4,0,0
62990,940,19,921,855,24,3,0,0,0
62992,785,137,648,447,142,14,4,0,1
62994,659,14,645,615,1,1,1,0,0
62995,6077,449,5628,4078,1391,9,7,1,7
62996,517,7,510,409,70,0,1,0,1
62997,623,46,577,555,2,3,0,0,1
62998,357,3,354,340,1,0,1,0,1
62999,1529,24,1505,1426,4,5,6,0,3
63005,19235,619,18616,14796,305,25,2737,6,61
63010,35027,1073,33954,31042,306,69,411,15,105
63011,37495,1257,36238,30567,985,33,2999,4,123
63012,10711,231,10480,9784,33,33,36,5,25
63013,1663,14,1649,1600,3,0,9,0,2
63014,810,14,796,747,0,2,0,0,2
63015,2317,54,2263,2104,15,14,6,2,13
63016,7881,137,7744,7250,15,36,24,0,12
63017,42773,1927,40846,32436,1348,50,5413,18,134
63019,4456,47,4409,3946,151,16,34,3,7
63020,20408,297,20111,18798,120,63,41,3,56
63021,56680,2082,54598,45083,1660,78,4868,17,250
63023,4844,53,4791,4507,12,24,12,1,8
63025,16742,506,16236,15133,114,13,250,5,22
63026,44648,1443,43205,39082,521,97,1119,13,118
63028,27924,623,27301,24853,489,70,162,8,82
63030,267,2,265,251,4,4,0,0,0
63031,47609,1493,46116,23142,19409,79,615,21,360
63033,43175,861,42314,9361,30861,65,237,9,236
63034,18428,289,18139,4534,12546,25,302,3,132
63036,959,12,947,881,6,5,1,0,1
63037,3240,31,3209,3039,7,3,11,0,3
63038,6775,221,6554,5825,113,13,264,0,26
63039,811,7,804,754,2,1,0,1,0
63040,8857,266,8591,7594,129,8,518,0,32
63041,483,2,481,454,3,0,1,1,1
63042,19646,903,18743,8299,8892,42,285,7,163
63043,22362,988,21374,13891,3013,53,3135,15,176
63044,10587,818,9769,6554,2286,12,343,3,45
63045,7,1,6,2,0,0,0,0,1
63047,28,3,25,22,0,0,0,0,0
63048,4219,79,4140,3810,65,15,43,2,22
63049,16929,477,16452,15145,138,47,215,1,49
63050,16874,274,16600,15509,89,29,66,1,41
63051,14136,323,13813,12730,64,43,89,6,24
63052,28925,672,28253,25981,338,61,237,8,75
63053,65,1,64,58,0,0,0,0,1
63055,2394,62,2332,2170,17,5,11,1,5
63056,1882,29,1853,1760,8,4,10,0,3
63060,2027,14,2013,1938,12,2,5,1,4
63061,172,1,171,167,0,0,0,0,1
63068,5113,116,4997,4680,30,11,10,1,11
63069,15542,446,15096,13288,783,48,113,4,35
63070,7659,179,7480,6765,121,19,36,4,26
63071,1094,11,1083,1002,0,2,1,0,9
63072,3063,44,3019,2792,53,12,21,0,13
63073,762,10,752,721,4,0,3,0,4
63074,15233,1224,14009,7752,4782,53,402,7,109
63077,11874,198,11676,10857,121,52,30,0,36
63079,234,3,231,217,2,0,0,0,0
63080,13554,241,13313,12530,45,43,60,1,37
63084,19500,501,18999,17531,243,65,90,6,57
63087,910,15,895,854,3,3,1,0,2
63088,8221,389,7832,6548,353,3,482,2,22
63089,5791,110,5681,5233,82,16,21,0,22
63090,22843,513,22330,21125,114,31,175,18,50
63091,1342,22,1320,1236,0,4,3,0,2
63101,4171,203,3968,1568,2050,5,136,2,24
63102,2508,112,2396,948,1233,7,114,0,28
63103,9411,391,9020,3744,4441,27,449,6,46
63104,19317,632,18685,9451,7890,20,354,3,92
63105,18846,749,18097,13283,1403,14,2456,2,83
63106,9113,117,8996,300,8371,14,17,1,41
63107,8829,106,8723,536,7866,28,30,2,47
63108,23603,1109,22494,12044,6241,41,2880,10,270
63109,26777,1065,25712,21970,1968,42,510,3,108
63110,18199,793,17406,11080,4376,18,905,7,124
63111,19538,2013,17525,7600,8053,71,412,5,130
63112,18954,879,18075,4208,11750,40,1244,7,126
63113,10882,101,10781,546,9794,24,21,3,79
63114,35237,4752,30485,16884,10468,77,835,2,227
63115,16056,159,15897,197,15183,46,16,1,84
63116,41959,3882,38077,23361,8991,104,3106,12,224
63117,9660,400,9260,7351,833,10,573,0,46
63118,25194,2386,22808,9000,11524,54,653,8,140
63119,34793,1128,33665,28925,2420,42,724,3,139
63120,7213,91,7122,122,6779,5,12,2,20
63121,22909,516,22393,2733,18406,55,358,5,120
63122,41319,1093,40226,36050,1782,24,647,11,115
63123,50989,1708,49281,42781,1545,76,2449,21,183
63124,11375,281,11094,9545,371,10,709,0,30
63125,32816,1411,31405,26737,1596,62,1082,5,111
63126,15851,491,15360,13940,310,18,363,5,72
63127,5642,154,5488,4948,67,6,209,0,20
63128,29728,685,29043,26676,386,24,786,2,52
63129,53432,1456,51976,47072,1361,80,1158,11,147
63130,29454,1171,28283,13951,10718,28,2029,19,237
63131,18241,479,17762,15479,315,5,1238,8,72
63132,14657,756,13901,6286,5040,24,1782,0,85
63133,6444,161,6283,296,5743,11,8,0,30
63134,12737,1352,11385,2773,7705,32,140,8,101
63135,19584,440,19144,4799,13328,19,105,5,101
63136,41767,538,41229,2238,37510,80,135,8,180
63137,18765,212,18553,2257,15658,46,31,6,72
63138,18852,339,18513,2340,15311,67,57,2,161
63139,21971,936,21035,17325,1754,29,759,8,122
63140,258,18,240,78,145,1,7,0,1
63141,21995,831,21164,15758,1786,24,2592,7,161
63143,9686,426,9260,7147,1216,14,231,8,45
63144,9596,334,9262,7737,389,17,626,1,23
63146,31459,1290,30169,19612,4694,55,4232,13,232
63147,8499,86,8413,355,7771,26,10,0,29
63155,3,1,2,0,1,0,0,0,0
63301,50890,2828,48062,41331,3174,85,749,28,233
63303,47292,2165,45127,37047,3474,55,2217,8,182
63304,42028,1314,40714,35908,1708,44,1118,10,150
63330,55,2,53,41,6,0,0,0,0
63332,1406,34,1372,1294,5,2,13,0,5
63333,713,11,702,683,0,1,0,0,2
63334,8108,164,7944,6958,665,9,9,4,18
63336,1028,7,1021,928,33,5,0,0,2
63339,1007,15,992,941,6,1,3,0,0
63341,3784,74,3710,3523,42,3,21,0,3
63343,4459,87,4372,4028,78,18,8,2,0
63344,1632,18,1614,1513,25,2,3,3,1
63345,331,1,330,312,8,0,0,0,0
63347,2825,49,2776,2560,30,13,5,3,2
63348,10051,259,9792,9002,170,11,95,2,34
63349,1962,47,1915,1739,28,4,8,3,7
63350,477,15,462,440,1,0,9,0,1
63351,1766,57,1709,1599,9,8,5,1,8
63352,1017,9,1008,963,3,0,0,0,1
63353,4394,194,4200,3747,188,22,7,0,5
63357,5835,132,5703,5404,29,12,12,1,15
63359,1319,18,1301,1249,5,1,2,0,4
63361,4334,89,4245,3937,61,5,25,3,7
63362,8799,303,8496,7646,256,32,31,2,37
63363,1515,31,1484,1406,4,1,9,0,2
63365,63,2,61,55,1,0,0,0,0
63366,53861,2314,51547,44471,2873,81,1028,69,164
63367,27009,908,26101,22952,1082,74,645,8,79
63368,46007,1763,44244,37281,1882,56,2755,23,139
63369,2698,59,2639,2506,10,8,4,0,10
63373,617,7,610,575,3,3,0,0,2
63376,76064,2861,73203,63181,3876,111,1794,35,266
63377,2728,37,2691,2526,25,7,5,2,14
63379,26583,786,25797,23460,536,70,125,9,80
63380,859,27,832,722,33,0,8,0,6
63381,505,6,499,463,4,4,0,0,0
63382,4597,96,4501,3957,312,12,16,1,23
63383,15340,483,14857,13548,256,68,76,1,43
63384,1693,32,1661,1580,23,8,2,1,1
63385,47756,1545,46211,40599,2401,99,649,15,131
63386,397,3,394,368,2,1,3,1,0
63387,52,0,52,52,0,0,0,0,0
63388,695,7,688,584,5,4,4,0,0
63389,7224,136,7088,6544,78,33,34,4,17
63390,11982,710,11272,10019,407,35,37,0,43
63401,21901,435,21466,18826,1270,54,146,14,68
63430,530,4,526,505,2,2,1,0,0
63431,328,7,321,311,1,0,0,0,0
63432,518,5,513,497,0,1,0,0,0
63433,35,1,34,33,0,0,0,0,0
63434,644,31,613,572,10,0,1,0,2
63435,4391,76,4315,4076,76,13,18,0,1
63436,1169,16,1153,1108,8,1,3,0,2
63437,1485,32,1453,1398,5,6,1,0,0
63438,423,1,422,413,1,2,0,0,0
63439,176,0,176,168,0,0,0,0,0
63440,1227,20,1207,1161,2,10,0,0,1
63441,1179,15,1164,1122,12,1,0,0,1
63443,352,15,337,309,2,1,0,0,0
63445,3726,35,3691,3570,12,2,2,0,8
63446,593,1,592,574,1,2,1,0,1
63447,1035,39,996,888,45,5,0,0,3
63448,1520,10,1510,1393,54,3,1,0,0
63450,128,2,126,125,0,0,1,0,0
63451,261,0,261,257,0,1,0,0,0
63452,1222,14,1208,1161,6,2,3,0,3
63453,373,2,371,352,1,0,0,0,0
63454,944,5,939,886,8,4,2,0,12
63456,4432,89,4343,3942,131,16,13,1,18
63457,295,3,292,288,3,1,0,0,0
63458,138,5,133,105,4,1,12,0,2
63459,4162,34,4128,3867,55,15,7,3,13
63460,297,1,296,279,2,0,0,0,3
63461,5942,83,5859,5469,107,12,21,2,15
63462,1508,23,1485,1402,7,0,2,0,8
63463,620,5,615,584,2,0,0,0,4
63465,468,2,466,449,1,1,1,0,0
63466,33,0,33,33,0,0,0,0,0
63467,120,0,120,106,0,0,0,0,0
63468,2560,35,2525,2445,3,10,1,0,2
63469,1092,11,1081,1037,3,1,0,0,5
63471,504,7,497,480,2,1,0,0,4
63472,400,3,397,376,1,3,8,0,2
63473,301,2,299,299,0,0,0,0,0
63474,537,3,534,498,4,0,0,0,0
63501,21501,615,20886,17956,1262,36,670,12,45
63530,880,10,870,791,13,0,5,0,2
63531,549,7,542,522,1,2,1,0,0
63532,1225,21,1204,1113,10,0,2,0,1
63533,822,4,818,804,1,1,1,0,0
63534,730,4,726,688,2,0,0,0,1
63535,57,1,56,54,0,0,0,0,0
63536,791,9,782,760,0,1,0,0,2
63537,1711,11,1700,1644,8,1,3,0,0
63538,242,5,237,220,1,2,2,0,0
63539,235,4,231,227,0,1,0,0,0
63540,141,1,140,137,0,1,1,0,0
63541,354,2,352,349,0,0,1,0,1
63543,306,1,305,297,2,0,0,0,0
63544,807,15,792,771,2,3,2,0,1
63545,939,56,883,847,4,7,1,0,0
63546,1555,19,1536,1453,1,0,2,0,1
63547,407,0,407,391,3,0,1,0,0
63548,1205,24,1181,1139,0,0,7,1,4
63549,2594,31,2563,2456,6,3,10,1,11
63551,352,6,346,334,0,0,0,0,0
63552,7913,183,7730,7006,260,16,65,4,18
63555,3182,24,3158,3054,4,4,5,1,0
63556,3452,948,2504,2163,199,6,26,1,9
63557,267,6,261,247,1,2,0,0,0
63558,645,3,642,600,1,1,0,0,0
63559,1227,22,1205,1168,0,2,8,0,5
63560,149,11,138,134,1,0,0,0,0
63561,1182,3,1179,1144,0,0,7,0,1
63563,605,1,604,594,0,0,0,0,0
63565,3682,98,3584,3488,8,5,0,0,0
63566,106,1,105,101,0,2,0,0,0
63567,99,1,98,97,1,0,0,0,0
63601,16123,205,15918,14780,178,56,40,4,33
63620,1229,26,1203,1079,43,6,5,1,1
63621,1249,14,1235,1112,13,5,7,0,1
63622,934,5,929,883,1,3,1,0,3
63623,850,13,837,798,10,3,2,0,0
63624,3293,39,3254,3043,6,9,4,2,7
63625,441,8,433,401,7,4,3,1,0
63626,935,12,923,842,3,8,1,0,5
63627,2938,33,2905,2771,9,4,4,1,6
63628,16373,236,16137,13963,1315,48,62,12,52
63629,1049,15,1034,976,1,4,4,0,0
63630,4169,48,4121,3849,20,12,3,0,12
63631,754,6,748,736,1,1,2,0,0
63633,632,16,616,569,13,0,7,0,0
63636,518,6,512,463,4,13,2,0,0
63637,1013,12,1001,957,7,4,4,0,1
63638,2746,38,2708,2587,4,7,2,0,0
63640,29145,569,28576,25875,1140,74,292,3,83
63645,11991,325,11666,10992,57,47,41,0,18
63648,1348,13,1335,1298,1,2,2,0,2
63650,3989,98,3891,3598,50,21,13,0,5
63653,1126,13,1113,1018,4,1,0,0,4
63654,577,20,557,518,5,5,3,0,0
63655,1242,24,1218,1147,0,1,6,0,4
63656,527,3,524,479,3,0,3,1,0
63660,3699,30,3669,3015,499,12,6,0,9
63662,1020,20,1000,926,4,5,4,0,5
63663,662,7,655,601,6,6,1,1,0
63664,8333,87,8246,7697,65,23,13,0,15
63665,289,2,287,268,3,1,0,0,0
63670,11691,190,11501,10749,300,36,26,1,8
63673,2078,29,2049,1946,7,9,2,0,0
63674,119,0,119,94,5,2,0,1,0
63675,103,1,102,101,0,0,0,0,0
63701,39246,1283,37963,31164,3742,76,979,5,104
63703,8599,389,8210,5371,2185,30,89,5,21
63730,3136,19,3117,2978,8,8,2,0,8
63732,843,10,833,801,0,2,3,0,0
63735,707,15,692,607,19,5,2,0,0
63736,3337,97,3240,3060,44,6,3,0,2
63738,50,2,48,46,0,0,0,0,0
63739,570,8,562,520,1,3,1,0,4
63740,5223,78,5145,4824,33,8,13,2,8
63742,45,0,45,41,0,0,1,0,0
63743,108,1,107,95,0,1,0,0,1
63744,185,1,184,172,0,0,3,0,0
63745,50,2,48,38,0,0,0,0,4
63746,47,0,47,44,0,0,0,0,0
63747,442,4,438,429,0,0,1,0,2
63748,931,3,928,906,3,0,1,0,0
63750,57,3,54,44,2,0,0,0,0
63751,1332,16,1316,1230,2,1,0,0,5
63755,27496,481,27015,24920,506,46,217,1,50
63758,359,7,352,346,0,1,0,0,0
63760,630,11,619,602,3,0,0,0,1
63763,158,2,156,149,0,0,0,0,0
63764,4675,57,4618,4417,15,9,13,3,2
63766,1193,22,1171,1114,11,2,4,0,6
63767,631,14,617,566,15,0,0,0,3
63769,1446,13,1433,1355,5,7,3,0,4
63770,174,1,173,156,3,0,2,0,2
63771,2714,70,2644,2366,141,4,1,0,7
63774,123,3,120,111,1,0,0,0,0
63775,16547,376,16171,15322,97,29,118,0,20
63780,6326,122,6204,5896,47,12,8,0,7
63781,1149,21,1128,1063,5,5,1,0,7
63782,235,2,233,222,2,5,0,0,0
63783,145,1,144,140,1,0,0,0,0
63784,204,6,198,175,5,2,0,0,0
63785,905,14,891,845,4,2,1,1,0
63787,625,5,620,591,1,4,0,0,0
63801,22572,597,21975,16005,4669,55,163,2,84
63820,193,0,193,184,1,0,0,0,0
63821,726,112,614,592,5,3,2,0,0
63822,2789,58,2731,2547,76,6,2,0,1
63823,1091,19,1072,905,108,1,0,0,9
63824,195,8,187,158,0,1,0,0,0
63825,4016,59,3957,3780,17,5,13,0,1
63826,68,2,66,63,3,0,0,0,0
63827,402,6,396,357,28,1,0,0,0
63828,160,2,158,153,0,0,0,1,0
63829,885,92,793,745,5,5,1,0,2
63830,6443,172,6271,3971,1949,9,17,1,19
63833,157,7,150,123,16,0,0,0,2
63834,6170,121,6049,3096,2734,10,15,0,27
63837,1368,136,1232,1052,95,2,1,0,1
63839,346,13,333,319,4,0,0,0,0
63840,61,0,61,59,2,0,0,0,0
63841,13413,320,13093,12435,108,23,48,0,16
63845,5278,91,5187,4838,139,21,6,0,17
63846,1227,26,1201,1115,48,10,1,0,2
63847,93,1,92,90,0,0,0,0,0
63848,1153,20,1133,1067,4,1,1,0,0
63849,108,7,101,87,12,1,0,0,0
63850,7,1,6,6,0,0,0,0,0
63851,3765,85,3680,1737,1801,11,1,0,4
63852,1277,129,1148,1094,3,4,0,0,1
63853,200,21,179,160,12,0,2,0,2
63855,963,79,884,832,21,1,0,0,4
63857,12236,765,11471,8822,1976,20,70,1,37
63860,120,1,119,115,1,0,0,0,0
63862,1263,17,1246,763,428,4,2,0,0
63863,5416,125,5291,3963,1008,22,4,3,10
63866,409,2,407,266,117,2,1,0,3
63867,884,8,876,781,26,6,5,0,1
63868,694,15,679,606,10,2,1,0,0
63869,3411,33,3378,2348,912,1,3,0,4
63870,842,48,794,538,201,0,3,0,0
63873,4349,45,4304,3525,560,5,6,0,7
63874,304,0,304,287,0,0,0,0,0
63876,2101,533,1568,1457,34,6,0,0,7
63877,3335,100,3235,2635,402,8,14,3,8
63878,70,3,67,60,0,0,0,0,0
63879,556,7,549,440,73,0,1,0,3
63880,88,0,88,85,0,0,0,0,0
63882,306,4,302,200,88,1,0,0,0
63901,34354,775,33579,28684,2325,139,295,10,96
63932,1157,26,1131,1044,37,5,0,0,0
63933,3175,72,3103,2946,23,6,0,0,2
63934,55,0,55,55,0,0,0,0,0
63935,7746,85,7661,7220,20,32,17,0,1
63936,645,13,632,592,2,1,11,2,0
63937,2609,48,2561,2428,6,9,7,1,0
63939,1277,29,1248,1141,5,4,5,0,0
63940,1207,15,1192,1115,1,13,0,1,0
63941,309,13,296,273,1,5,3,0,1
63942,461,0,461,435,3,1,1,0,0
63943,790,15,775,717,0,3,2,0,0
63944,1282,18,1264,1180,5,12,1,1,1
63945,1350,10,1340,1233,16,14,2,0,0
63950,66,5,61,51,0,2,0,0,0
63951,222,2,220,203,1,2,0,0,0
63952,311,5,306,269,0,0,0,0,0
63953,999,15,984,897,4,5,6,1,0
63954,936,18,918,794,72,10,1,0,3
63955,124,1,123,111,0,1,0,0,0
63956,757,17,740,705,2,5,2,1,0
63957,5011,78,4933,4585,27,39,11,1,0
63960,2989,42,2947,2807,8,10,13,0,5
63961,1477,18,1459,1358,6,13,1,0,1
63962,35,1,34,26,0,0,0,0,0
63964,688,13,675,633,1,4,0,0,0
63965,2166,28,2138,1992,9,3,6,0,2
63966,2169,28,2141,2035,6,4,6,3,0
63967,1867,20,1847,1746,8,0,5,0,1
64001,623,10,613,582,3,0,1,0,0
64011,3391,64,3327,3136,6,4,6,0,2
64012,28364,2460,25904,21570,1961,132,294,51,111
64014,27993,1898,26095,21483,2116,128,394,68,66
64015,33063,2071,30992,25633,2310,128,503,52,124
64016,4682,179,4503,4107,21,21,10,2,5
64017,461,6,455,440,1,0,1,0,0
64018,915,21,894,831,5,3,4,0,7
64019,2508,79,2429,2209,32,12,13,4,13
64020,3417,84,3333,3150,13,7,9,1,3
64021,674,17,657,603,6,3,1,0,2
64022,151,4,147,140,0,0,0,0,2
64024,15575,523,15052,13808,208,84,48,1,61
64028,283,7,276,252,0,1,6,0,0
64029,20054,1164,18890,16857,511,70,181,16,46
64030,26154,3445,22709,10463,9892,107,411,40,119
64034,8883,378,8505,7652,310,22,48,5,17
64035,954,13,941,890,1,9,1,0,0
64036,317,4,313,298,7,0,0,1,0
64037,6290,207,6083,5399,283,32,24,5,14
64040,6624,146,6478,5957,50,47,22,6,23
64048,4281,102,4179,3939,14,19,10,2,10
64050,22223,2508,19715,15693,1751,153,168,193,99
64052,22204,4072,18132,14069,1985,109,193,68,104
64053,5801,1283,4518,3511,529,35,38,21,11
64054,3637,430,3207,2704,130,26,42,24,19
64055,36225,3910,32315,26032,2949,160,550,238,151
64056,17373,1767,15606,12065,1578,78,129,190,71
64057,14830,1253,13577,10894,1409,58,231,74,50
64058,6880,506,6374,5420,230,43,58,104,24
64060,15340,506,14834,13889,90,48,107,5,54
64061,3367,75,3292,3037,28,8,13,4,12
64062,6300,144,6156,5745,16,29,23,3,19
64063,20965,1495,19470,15972,1705,57,278,47,69
64064,19717,857,18860,15250,1902,44,589,18,70
64065,14,0,14,11,2,0,0,0,0
64066,79,3,76,69,1,0,1,0,0
64067,5702,280,5422,4779,236,23,40,2,13
64068,37222,2066,35156,30808,1535,144,358,68,126
64070,3565,97,3468,3224,26,14,23,2,10
64071,752,16,736,653,18,1,0,0,8
64072,191,2,189,171,0,0,2,0,1
64074,607,10,597,556,0,1,2,0,0
64075,12319,476,11843,10737,159,47,67,9,22
64076,9863,266,9597,8902,85,60,28,4,14
64077,1711,64,1647,1538,4,9,2,0,3
64078,9886,373,9513,8580,187,46,55,3,28
64079,14748,725,14023,12530,388,46,195,42,84
64080,14003,503,13500,12489,105,59,55,6,38
64081,24903,1070,23833,19781,1944,46,641,49,111
64082,17973,863,17110,13821,1779,34,406,9,72
64083,24945,1234,23711,19453,2333,111,291,7,141
64084,1424,32,1392,1259,4,15,9,0,2
64085,8841,237,8604,7834,158,49,44,6,14
64086,23957,1298,22659,18683,1776,71,603,30,86
64088,1381,41,1340,1248,14,7,4,1,10
64089,13681,455,13226,12365,82,58,86,12,45
64090,97,0,97,91,2,0,0,0,0
64092,58,10,48,40,0,0,3,1,0
64093,28112,1383,26729,22495,1646,126,572,135,99
64096,1037,69,968,933,8,5,1,0,0
64097,1293,31,1262,1194,12,3,2,0,0
64098,3054,72,2982,2831,11,11,5,0,4
64101,270,20,250,141,70,8,10,0,3
64102,15,4,11,10,0,0,0,0,0
64105,6424,521,5903,4668,580,23,298,9,33
64106,10017,1292,8725,4483,3049,31,613,15,50
64108,9839,1923,7916,4952,2176,33,323,10,51
64109,10290,981,9309,3711,4689,20,180,15,50
64110,15874,1207,14667,8037,5214,48,423,10,99
64111,17112,1833,15279,11770,1829,65,596,14,89
64112,9344,533,8811,7616,232,14,548,0,47
64113,12039,465,11574,10647,160,18,184,2,16
64114,24008,1627,22381,17751,2650,75,515,6,94
64116,17670,1827,15843,11559,2217,88,807,153,65
64117,15155,1737,13418,9164,2550,69,480,65,63
64118,42897,4285,38612,29230,4540,213,1369,370,196
64119,30865,2911,27954,22315,2361,105,953,208,168
64120,880,151,729,576,74,1,52,1,0
64123,10639,4834,5805,2776,1366,41,1145,29,41
64124,12754,4993,7761,2852,2796,42,1477,32,62
64125,1988,1149,839,574,131,16,57,7,4
64126,6799,3525,3274,1344,1385,15,256,22,37
64127,17191,6383,10808,2327,7411,71,262,31,77
64128,11872,1659,10213,1042,8363,65,42,16,88
64129,8767,1338,7429,2916,3904,34,51,6,47
64130,20707,1669,19038,1699,16102,82,75,14,87
64131,21837,1376,20461,9755,8947,91,322,24,119
64132,13013,844,12169,1739,9641,45,52,12,61
64133,35259,3008,32251,17539,11772,152,417,79,202
64134,22120,2176,19944,5953,12263,73,368,24,141
64136,2164,175,1989,1022,746,5,63,9,26
64137,10041,772,9269,5104,3076,53,330,28,34
64138,25565,1942,23623,10129,11280,100,543,41,116
64139,2422,67,2355,1657,508,6,52,0,14
64145,5518,258,5260,4091,700,23,139,7,37
64146,1503,110,1393,1062,181,3,45,5,8
64147,524,38,486,149,288,0,7,1,6
64149,432,29,403,351,12,9,8,0,3
64150,4215,394,3821,2567,705,19,171,91,24
64151,28779,2167,26612,20641,3215,113,815,200,123
64152,29623,1922,27701,23340,1601,116,606,256,100
64153,6129,522,5607,4338,576,19,275,23,25
64154,12986,1085,11901,8990,1510,36,540,70,55
64155,28195,2175,26020,21107,2201,92,723,70,113
64156,7164,467,6697,5692,387,26,196,10,18
64157,23286,1310,21976,18851,1146,61,728,14,80
64158,6750,532,6218,4947,572,25,241,29,27
64161,483,49,434,355,20,3,11,0,8
64163,1003,79,924,742,65,8,22,7,12
64164,279,19,260,223,1,0,2,0,4
64165,252,18,234,208,11,0,2,0,0
64166,320,17,303,276,6,0,7,0,1
64167,451,27,424,397,1,1,3,0,0
64401,1525,22,1503,1407,9,0,4,0,2
64402,2221,43,2178,2096,1,2,2,1,7
64420,45,0,45,43,0,0,0,0,0
64421,827,21,806,761,2,0,1,0,5
64422,285,13,272,255,0,1,2,0,0
64423,760,7,753,731,0,0,2,0,1
64424,4188,119,4069,3877,13,16,19,0,8
64426,370,6,364,346,3,0,0,0,0
64427,581,11,570,552,0,0,1,0,0
64428,907,5,902,860,1,1,0,0,2
64429,11744,288,11456,10170,692,39,77,1,12
64430,766,29,737,689,1,2,2,0,1
64431,357,2,355,342,0,1,0,0,0
64432,106,3,103,100,0,0,1,0,0
64433,111,1,110,107,0,0,2,0,0
64434,447,5,442,421,0,0,2,0,0
64436,776,21,755,720,5,4,3,0,0
64437,455,12,443,414,1,8,0,0,2
64438,221,1,220,206,1,0,0,0,0
64439,1615,38,1577,1474,3,12,1,0,4
64440,757,11,746,710,3,1,2,0,1
64441,144,2,142,136,0,0,0,1,0
64442,766,4,762,743,1,2,1,1,0
64443,1125,24,1101,1021,6,10,0,1,0
64444,1473,37,1436,1346,6,5,9,0,5
64445,250,3,247,244,0,0,0,0,0
64446,1057,15,1042,986,4,4,2,0,1
64448,1108,34,1074,1022,7,1,3,0,4
64449,421,2,419,401,1,0,1,0,1
64451,373,3,370,351,0,4,2,0,0
64453,221,3,218,208,3,0,0,0,0
64454,2697,23,2674,2566,12,5,3,3,2
64455,363,1,362,351,1,0,0,0,1
64456,1415,21,1394,1350,0,4,2,4,0
64457,251,3,248,239,0,2,1,0,2
64458,140,5,135,131,0,0,0,0,0
64459,483,3,480,449,0,1,0,0,2
64461,792,10,782,738,4,4,2,0,4
64463,1371,23,1348,1295,0,3,1,0,1
64465,4526,113,4413,4138,12,18,14,0,11
64466,470,4,466,449,0,2,0,0,2
64467,178,1,177,170,2,0,1,0,0
64468,14432,356,14076,12825,355,21,376,1,35
64469,2220,30,2190,2104,0,3,4,1,6
64470,1454,34,1420,1370,1,13,0,0,9
64471,430,8,422,404,2,5,0,0,1
64473,1447,14,1433,1384,2,3,0,0,5
64474,726,12,714,660,0,1,2,0,1
64475,359,2,357,344,0,0,1,0,0
64476,400,4,396,374,0,0,1,0,0
64477,3302,88,3214,2891,132,11,8,1,15
64479,937,14,923,896,0,3,0,1,0
64480,307,2,305,289,0,1,2,0,1
64481,945,11,934,874,2,1,2,1,1
64482,1928,22,1906,1809,10,15,2,0,6
64483,678,17,661,639,0,2,6,0,1
64484,1022,13,1009,954,4,3,1,0,2
64485,8448,166,8282,7819,45,19,24,0,25
64486,332,0,332,324,1,0,0,0,0
64487,694,12,682,641,1,0,3,0,1
64489,2074,22,2052,1997,7,2,7,0,1
64490,2052,49,2003,1896,11,6,1,0,15
64491,1803,26,1777,1710,7,3,3,0,4
64492,1792,57,1735,1620,7,3,5,1,8
64493,521,19,502,466,4,3,1,0,0
64494,975,9,966,922,3,2,6,0,2
64496,186,0,186,173,0,2,0,0,1
64497,532,9,523,490,5,3,0,1,0
64498,305,10,295,280,1,0,0,0,2
64499,151,2,149,145,0,0,1,0,0
64501,11020,1002,10018,7892,1036,44,88,121,41
64503,12127,887,11240,9994,383,54,61,11,37
64504,10033,922,9111,8252,245,55,34,60,22
64505,13261,599,12662,11548,324,44,104,20,37
64506,22828,1229,21599,18154,1507,69,710,183,63
64507,14133,974,13159,11192,860,53,84,30,37
64601,12034,212,11822,10968,313,35,85,4,17
64620,495,11,484,449,1,0,1,0,0
64622,506,5,501,484,2,2,0,0,0
64623,488,7,481,450,2,0,1,0,0
64624,1519,12,1507,1443,5,3,1,0,1
64625,583,4,579,545,7,2,0,0,4
64628,5527,145,5382,5105,41,18,11,1,13
64630,547,35,512,498,2,0,0,0,2
64631,836,7,829,791,3,2,0,0,1
64632,625,9,616,596,0,1,0,0,0
64633,4924,86,4838,4557,63,5,13,0,6
64635,546,9,537,509,3,4,1,0,1
64636,259,4,255,246,3,0,2,1,0
64637,579,8,571,534,1,2,2,0,3
64638,438,5,433,417,0,3,1,1,0
64639,223,5,218,201,11,1,0,0,0
64640,3168,44,3124,2961,12,6,9,4,1
64641,521,9,512,493,1,4,2,0,1
64642,756,8,748,704,9,4,1,1,2
64643,949,11,938,897,2,5,0,0,1
64644,2977,60,2917,2783,2,13,9,5,5
64645,239,7,232,212,1,2,2,0,1
64646,306,2,304,295,0,0,0,0,0
64647,308,4,304,290,1,1,1,2,0
64648,2085,30,2055,1971,2,16,4,0,4
64649,830,9,821,792,0,6,3,0,3
64650,628,18,610,539,42,2,0,1,0
64651,519,9,510,478,5,2,0,0,0
64652,372,5,367,359,0,2,0,0,0
64653,678,13,665,626,2,3,2,0,1
64654,38,2,36,34,0,0,0,0,0
64655,202,2,200,191,2,0,0,0,0
64656,226,2,224,218,0,0,0,0,0
64657,325,2,323,307,4,2,0,0,0
64658,3193,79,3114,2963,13,4,9,5,9
64659,863,4,859,840,1,0,0,0,1
64660,470,2,468,450,1,0,0,0,0
64661,691,8,683,668,0,1,0,0,0
64664,305,0,305,293,0,0,0,0,0
64667,292,11,281,276,0,4,0,0,0
64668,1258,11,1247,1180,14,6,0,0,0
64670,1077,10,1067,1014,2,6,0,3,0
64671,2085,50,2035,1893,11,10,11,0,11
64672,255,3,252,247,0,0,0,0,0
64673,2470,142,2328,2261,0,6,0,0,7
64674,408,6,402,391,2,1,0,0,0
64676,162,3,159,155,0,0,0,0,0
64679,835,16,819,782,5,3,1,1,5
64681,198,1,197,191,0,0,0,0,0
64682,354,5,349,338,2,0,1,0,0
64683,7900,213,7687,7317,44,22,49,7,9
64686,226,6,220,206,0,1,0,0,0
64688,533,6,527,512,0,1,0,0,0
64689,604,4,600,577,3,1,0,0,0
64701,14681,498,14183,12994,176,82,80,5,56
64720,3869,58,3811,3642,15,15,8,1,7
64722,441,6,435,415,3,4,1,0,1
64723,627,9,618,571,4,3,1,0,1
64724,1755,28,1727,1639,5,15,2,2,2
64725,2349,72,2277,2128,6,4,0,1,10
64726,422,7,415,384,0,1,1,0,3
64728,523,21,502,462,1,2,0,0,2
64730,6803,187,6616,6188,109,47,24,3,6
64733,1065,20,1045,970,3,3,5,0,10
64734,1976,62,1914,1747,20,20,16,0,13
64735,13450,362,13088,12012,160,50,69,5,37
64738,1138,28,1110,1036,5,3,1,2,5
64739,1052,27,1025,960,11,7,0,1,5
64740,1768,29,1739,1656,7,4,6,0,5
64741,279,6,273,261,1,5,1,0,0
64742,2079,46,2033,1915,7,9,7,0,8
64743,301,7,294,267,0,1,1,0,1
64744,7812,132,7680,7136,14,63,26,2,27
64745,73,1,72,69,0,1,0,0,0
64746,1479,31,1448,1365,4,9,3,0,0
64747,3838,125,3713,3477,15,22,7,4,12
64748,1354,52,1302,1140,6,25,6,0,3
64750,409,1,408,397,0,1,1,0,1
64752,700,7,693,641,4,7,2,1,3
64755,2616,54,2562,2336,17,32,12,2,9
64756,742,2,740,686,0,8,1,0,1
64759,7921,193,7728,7060,21,76,33,0,12
64761,1383,25,1358,1249,1,9,10,1,6
64762,1444,13,1431,1346,0,16,2,0,0
64763,1481,30,1451,1363,2,5,1,0,0
64765,22,0,22,15,0,1,0,0,1
64767,831,15,816,778,2,4,0,0,2
64769,463,14,449,392,1,15,3,1,0
64770,953,14,939,906,4,1,1,1,0
64771,501,14,487,443,2,1,3,2,0
64772,12897,329,12568,11633,103,92,94,14,34
64776,3651,72,3579,3351,14,34,10,3,10
64778,569,8,561,532,1,1,0,0,0
64779,2337,39,2298,2184,18,13,8,5,1
64780,544,5,539,507,0,4,1,0,1
64781,73,0,73,71,0,0,0,0,1
64783,789,5,784,750,0,2,1,1,1
64784,1306,22,1284,1210,0,10,0,0,1
64788,1355,49,1306,1205,3,6,6,0,0
64790,746,5,741,689,0,9,1,0,1
64801,35234,2122,33112,27917,1007,676,518,211,114
64804,38078,2037,36041,30628,853,751,668,181,128
64830,618,21,597,507,7,17,1,0,5
64831,5910,358,5552,4765,21,147,43,134,17
64832,781,24,757,682,0,15,6,0,2
64833,103,6,97,89,0,0,3,0,1
64834,10239,321,9918,8857,81,168,78,1,17
64835,1855,76,1779,1568,20,22,12,3,11
64836,25334,6020,19314,17281,240,233,225,93,66
64840,2785,63,2722,2418,14,40,21,7,11
64841,965,41,924,774,10,16,22,0,3
64842,818,33,785,592,0,18,102,1,0
64843,3290,133,3157,2669,18,89,41,114,12
64844,4412,113,4299,3790,11,81,72,8,6
64847,371,62,309,265,0,13,1,3,4
64848,609,13,596,550,1,5,1,17,1
64849,219,2,217,203,0,2,2,0,1
64850,24586,2362,22224,19041,217,459,202,655,42
64854,4829,1250,3579,2128,353,80,156,585,19
64855,2902,87,2815,2567,12,23,17,0,12
64856,4164,130,4034,3645,12,63,25,5,17
64857,371,12,359,321,3,6,0,5,2
64858,152,3,149,130,0,10,0,0,0
64859,1377,190,1187,1070,3,18,7,4,6
64861,1227,27,1200,977,5,21,69,0,6
64862,3282,96,3186,2910,10,73,23,0,12
64863,1724,833,891,705,2,34,10,34,0
64865,5670,178,5492,4655,27,297,33,7,22
64866,1321,51,1270,1111,2,36,47,0,6
64867,1381,38,1343,1165,3,21,47,5,2
64868,85,5,80,69,2,5,0,0,0
64870,16566,986,15580,13586,242,240,175,30,47
64873,970,42,928,848,1,9,20,0,2
64874,732,50,682,599,0,9,34,9,2
65001,327,1,326,305,0,0,0,0,1
65010,7128,129,6999,6512,63,28,34,3,22
65011,2608,44,2564,2439,11,3,9,3,5
65013,3206,57,3149,2972,8,10,2,0,3
65014,2227,24,2203,2001,0,6,9,0,3
65016,1398,2,1396,1377,1,1,0,0,0
65017,1569,52,1517,1444,3,3,1,0,2
65018,7960,708,7252,6842,44,20,26,4,15
65020,14189,481,13708,12756,66,65,52,11,24
65023,1889,29,1860,1772,10,6,3,2,4
65024,1018,13,1005,961,4,5,0,6,0
65025,752,24,728,702,1,3,0,0,0
65026,11141,231,10910,10214,41,56,28,21,30
65032,1709,20,1689,1618,4,3,4,0,2
65034,720,11,709,685,2,3,1,1,2
65035,1639,9,1630,1585,0,0,0,0,0
65037,4732,83,4649,4371,15,31,14,0,13
65039,2446,58,2388,2222,13,11,7,0,20
65040,1286,10,1276,1224,2,0,1,0,2
65041,5389,55,5334,5097,12,4,17,4,11
65043,10244,293,9951,8934,322,30,48,11,39
65046,1168,16,1152,1085,18,5,0,0,6
65047,1249,39,1210,1156,14,7,12,0,0
65048,298,0,298,294,0,0,0,0,0
65049,7260,165,7095,6627,63,22,44,4,38
65050,616,1,615,606,0,0,1,0,0
65051,4705,55,4650,4454,15,11,1,3,6
65052,3331,107,3224,3051,14,21,12,4,6
65053,1506,25,1481,1352,6,9,6,0,17
65054,771,5,766,748,1,4,0,0,0
65058,963,9,954,905,0,2,0,0,6
65059,983,9,974,910,0,1,1,0,0
65061,607,9,598,566,2,0,2,0,0
65062,27,1,26,25,0,0,0,0,0
65063,3607,61,3546,3310,22,3,14,0,7
65064,572,5,567,527,7,7,1,0,0
65065,6881,410,6471,5931,104,22,89,4,11
65066,6445,97,6348,5942,10,14,27,5,12
65067,378,1,377,342,1,0,0,0,3
65068,806,9,797,742,7,1,1,0,0
65069,599,3,596,565,1,0,1,0,7
65072,1646,42,1604,1512,7,12,3,0,5
65074,3126,47,3079,2908,12,9,5,0,7
65075,889,6,883,862,3,0,1,0,1
65076,732,7,725,701,1,0,0,2,0
65077,491,6,485,433,3,1,2,0,4
65078,3809,74,3735,3459,12,28,20,3,10
65079,4417,57,4360,4125,9,15,11,2,18
65080,935,11,924,860,1,3,0,2,8
65081,3663,97,3566,3193,217,10,16,11,4
65082,1108,20,1088,1027,14,6,1,0,3
65083,379,2,377,354,1,4,1,0,2
65084,7291,179,7112,6639,80,31,17,2,22
65085,1165,11,1154,1128,1,2,1,1,1
65101,29960,808,29152,23059,4396,72,167,28,104
65109,39730,1742,37988,31373,3615,81,782,24,170
65201,48734,2544,46190,36103,4521,119,2553,27,302
65202,48239,2662,45577,32056,7905,160,1657,64,283
65203,59712,2294,57418,45073,5177,92,3444,20,285
65215,239,12,227,193,24,0,0,0,5
65216,234,5,229,185,14,3,14,0,10
65230,650,13,637,585,15,3,0,0,0
65231,3171,50,3121,2917,42,4,6,0,6
65232,245,6,239,229,0,0,0,0,0
65233,11472,249,11223,9523,877,39,55,3,48
65236,1293,23,1270,1121,87,6,0,1,0
65237,858,11,847,780,11,4,4,1,1
65239,1261,15,1246,1181,1,4,4,0,2
65240,8292,185,8107,7647,80,13,17,5,27
65243,2734,63,2671,2565,14,5,6,0,10
65244,457,3,454,418,1,3,2,0,0
65246,92,3,89,81,6,0,0,0,0
65247,640,13,627,587,3,0,0,0,4
65248,4781,158,4623,3899,413,23,19,1,34
65250,556,9,547,503,1,4,3,0,1
65251,21867,475,21392,18463,1522,90,130,17,87
65254,1778,18,1760,1598,82,2,3,2,3
65255,4487,67,4420,4124,51,8,12,1,15
65256,2052,25,2027,1914,8,10,7,0,9
65257,1429,41,1388,1299,5,7,2,2,2
65258,493,13,480,465,0,1,0,0,1
65259,2639,43,2596,2421,41,7,10,0,12
65260,576,7,569,537,5,0,0,0,3
65261,1138,20,1118,1081,9,5,1,0,0
65262,863,24,839,761,12,0,12,0,4
65263,1753,23,1730,1664,2,4,13,0,7
65264,792,13,779,735,2,0,4,0,0
65265,15238,543,14695,12656,975,45,93,2,43
65270,17565,449,17116,14674,1290,78,74,7,57
65274,1586,7,1579,1476,25,2,0,0,6
65275,2352,20,2332,2190,53,9,2,0,1
65276,1544,18,1526,1446,8,3,4,0,5
65278,104,5,99,95,1,1,0,0,0
65279,1819,41,1778,1642,31,4,23,0,4
65280,208,0,208,195,1,0,1,0,1
65281,2979,35,2944,2819,39,4,2,2,1
65282,109,1,108,101,0,0,0,0,1
65283,459,8,451,428,1,3,2,0,0
65284,2279,39,2240,2051,13,9,8,0,11
65285,652,27,625,597,1,3,0,0,4
65286,114,2,112,108,1,0,0,0,0
65287,316,15,301,277,3,2,1,2,3
65301,34987,3346,31641,27934,1321,119,265,98,97
65305,2851,406,2445,1917,226,21,70,6,8
65320,74,1,73,69,0,0,0,0,0
65321,399,8,391,369,5,3,0,0,1
65322,637,5,632,584,9,2,0,0,1
65323,919,17,902,843,1,4,2,0,5
65324,1302,25,1277,1222,5,3,4,1,7
65325,3142,26,3116,2962,8,17,6,0,1
65326,2051,40,2011,1863,10,16,6,0,6
65327,209,0,209,196,1,0,0,0,4
65329,500,13,487,467,1,2,0,0,0
65330,396,9,387,367,0,1,0,0,2
65332,1652,59,1593,1496,8,7,9,0,5
65333,760,29,731,688,1,4,0,1,3
65334,976,30,946,896,1,3,0,0,5
65335,246,1,245,223,0,4,1,1,1
65336,6136,441,5695,4779,318,28,110,53,26
65337,1882,451,1431,1276,19,6,8,16,0
65338,2913,54,2859,2703,5,16,12,0,4
65339,533,10,523,497,9,1,1,0,1
65340,16488,2688,13800,11272,982,42,153,394,208
65344,301,13,288,268,10,1,0,0,1
65345,491,13,478,447,3,1,0,0,0
65347,634,10,624,593,6,1,2,1,0
65348,1263,14,1249,1193,1,1,0,1,5
65349,2371,78,2293,2018,117,8,8,2,13
65350,1681,52,1629,1527,0,11,9,2,3
65351,2301,29,2272,2161,22,13,13,0,3
65354,547,11,536,507,6,2,1,0,0
65355,10675,184,10491,9838,43,57,27,0,30
65360,4692,132,4560,4284,9,31,10,0,25
65401,32310,969,31341,26911,924,153,1408,16,173
65409,34,4,30,10,4,0,7,0,0
65436,99,2,97,95,0,0,1,0,0
65438,2570,66,2504,2304,3,19,9,0,3
65439,227,4,223,211,0,2,0,0,0
65440,445,10,435,411,0,4,0,0,0
65441,4760,78,4682,4384,20,16,20,6,13
65443,94,2,92,88,0,1,0,0,0
65444,1027,20,1007,963,0,5,0,0,0
65446,395,3,392,353,1,1,1,0,1
65449,341,7,334,307,0,0,0,0,3
65452,2942,78,2864,2671,17,6,9,5,9
65453,7966,246,7720,7229,46,42,27,0,7
65456,460,5,455,433,0,0,4,0,0
65457,245,9,236,184,21,8,3,0,0
65459,7524,271,7253,6584,114,34,59,27,28
65461,133,6,127,103,2,3,4,0,0
65462,1395,27,1368,1282,7,13,6,0,14
65463,882,15,867,793,5,6,1,1,1
65464,366,5,361,331,0,10,0,1,0
65466,1265,19,1246,1184,2,3,1,0,0
65468,101,0,101,98,1,0,0,0,1
65470,1015,17,998,938,2,2,4,0,2
65473,15980,3093,12887,8435,2890,107,785,127,40
65479,360,5,355,342,1,1,0,0,0
65483,4607,137,4470,4225,16,29,24,0,8
65484,165,4,161,155,0,0,0,0,0
65486,3340,38,3302,3193,4,9,5,2,2
65501,215,4,211,194,0,1,4,0,0
65529,171,5,166,151,2,6,1,0,0
65534,944,30,914,824,26,0,2,4,6
65535,1517,14,1503,1415,6,11,5,1,4
65536,29550,815,28735,26522,253,159,169,15,57
65541,292,3,289,279,0,0,0,0,0
65542,6489,115,6374,5395,699,49,8,1,7
65543,404,14,390,362,2,3,2,0,0
65548,5897,125,5772,5343,14,37,24,2,9
65550,2836,63,2773,2542,10,18,19,2,22
65552,1911,86,1825,1662,31,7,10,3,8
65555,1060,17,1043,985,9,3,3,0,0
65556,5574,172,5402,4965,37,30,41,12,11
65557,209,7,202,183,1,1,2,1,0
65559,9128,222,8906,8215,74,46,67,3,27
65560,13292,256,13036,12126,58,58,50,7,45
65564,230,6,224,212,0,0,0,0,4
65565,5238,82,5156,4672,64,27,9,5,9
65566,777,13,764,710,7,13,2,1,0
65567,1199,19,1180,1111,1,6,4,0,3
65570,412,9,403,390,0,1,0,0,1
65571,1962,19,1943,1844,3,7,4,0,6
65580,858,8,850,784,1,9,2,0,1
65582,1983,46,1937,1809,9,13,3,0,3
65583,13561,1286,12275,9262,1427,83,311,103,59
65584,10714,1152,9562,6296,1506,76,569,126,65
65586,23,0,23,22,0,0,0,0,0
65588,2202,34,2168,2020,0,17,3,0,0
65589,134,0,134,123,0,1,0,0,2
65590,1616,32,1584,1480,2,10,2,2,4
65591,1328,25,1303,1259,0,3,2,0,5
65601,923,26,897,839,2,2,0,0,0
65603,172,5,167,159,4,0,0,0,0
65604,3809,78,3731,3497,9,33,13,3,13
65605,11795,911,10884,10069,47,96,26,11,23
65606,2662,33,2629,2492,9,20,0,0,0
65608,8496,172,8324,7722,29,57,21,0,26
65609,631,5,626,589,0,6,3,0,1
65610,5339,107,5232,4866,7,36,22,0,28
65611,1988,45,1943,1844,9,13,13,0,3
65612,1377,24,1353,1247,5,11,2,0,2
65613,17890,524,17366,16109,214,118,97,4,34
65614,521,8,513,486,0,2,0,0,0
65616,27562,2360,25202,22435,466,167,465,13,98
65617,1727,40,1687,1568,2,4,10,0,10
65618,107,6,101,88,0,1,0,0,0
65619,8684,421,8263,7315,151,45,140,10,13
65620,353,2,351,324,3,2,0,0,0
65622,8461,174,8287,7746,17,65,20,7,9
65623,36,12,24,24,0,0,0,0,0
65624,1662,29,1633,1542,4,6,2,0,0
65625,8298,441,7857,7151,29,68,82,13,13
65626,1637,25,1612,1513,3,12,4,0,9
65627,503,9,494,464,5,1,1,0,0
65629,646,8,638,620,0,0,0,0,0
65630,521,26,495,459,0,0,6,0,1
65631,5599,149,5450,5087,29,25,13,0,8
65632,2993,53,2940,2754,6,19,9,3,10
65633,4121,85,4036,3759,10,34,10,1,10
65634,582,12,570,525,2,2,2,0,1
65635,574,7,567,534,0,2,0,0,0
65637,917,21,896,875,1,1,2,0,0
65638,389,14,375,359,3,3,0,0,0
65640,910,10,900,841,1,7,1,0,2
65641,1294,43,1251,1135,4,17,1,0,4
65644,2805,51,2754,2551,9,15,9,0,17
65646,1888,29,1859,1756,6,15,4,0,1
65647,2310,87,2223,1908,28,26,103,0,9
65648,5784,117,5667,5296,16,32,23,2,12
65649,1649,37,1612,1518,5,6,3,0,0
65650,1423,13,1410,1309,4,9,3,0,0
65652,4068,53,4015,3713,94,15,14,0,9
65653,5806,137,5669,5286,25,49,22,2,11
65654,184,19,165,155,0,2,0,0,1
65655,2806,40,2766,2606,8,10,6,4,11
65656,4684,128,4556,4235,11,43,12,4,14
65657,106,2,104,103,0,0,0,0,0
65658,1026,14,1012,936,1,9,4,0,1
65660,243,4,239,228,0,2,0,0,2
65661,2422,54,2368,2221,13,13,9,0,0
65662,1215,16,1199,1132,13,3,4,0,4
65663,2424,37,2387,2240,2,24,6,0,10
65664,118,1,117,113,1,2,0,0,0
65666,60,0,60,60,0,0,0,0,0
65667,3404,73,3331,3131,40,14,3,1,8
65668,1631,30,1601,1501,3,5,0,0,4
65669,2531,67,2464,2287,6,27,5,4,8
65672,8548,604,7944,7122,112,58,56,27,32
65674,2909,71,2838,2649,12,19,6,1,3
65675,39,0,39,32,0,0,0,0,1
65676,361,1,360,352,0,1,0,0,0
65679,2569,125,2444,2216,35,18,13,1,6
65680,1218,27,1191,1148,2,5,4,0,0
65681,2001,26,1975,1858,4,6,1,1,14
65682,1776,29,1747,1637,5,15,6,0,0
65685,943,14,929,878,1,3,1,0,0
65686,4442,123,4319,4038,8,37,17,2,5
65688,56,4,52,51,0,1,0,0,0
65689,4185,97,4088,3843,6,24,13,0,6
65690,180,4,176,161,3,4,0,0,0
65692,965,29,936,852,2,10,3,0,9
65702,368,15,353,321,1,4,1,0,0
65704,3883,49,3834,3566,24,11,7,0,9
65705,3741,151,3590,3387,7,34,9,0,4
65706,15784,305,15479,14483,54,115,64,6,22
65707,2275,44,2231,2077,11,15,3,2,12
65708,12973,2974,9999,8822,34,88,446,45,16
65710,1253,9,1244,1187,9,5,1,0,3
65711,9278,203,9075,8543,38,46,21,4,24
65712,8464,219,8245,7682,27,72,31,3,14
65713,2562,55,2507,2317,14,26,7,0,8
65714,35109,1298,33811,30792,317,185,377,37,92
65715,83,0,83,76,1,0,0,0,1
65717,2236,38,2198,2033,7,10,10,0,14
65720,538,6,532,506,0,3,0,0,1
65721,32975,1235,31740,29246,235,167,203,17,100
65722,1833,54,1779,1663,2,11,5,2,9
65723,3673,178,3495,3151,12,44,44,2,20
65724,1283,18,1265,1205,0,8,3,0,1
65725,2441,55,2386,2235,2,17,15,0,6
65726,1696,700,996,637,161,26,3,144,1
65727,165,3,162,152,2,1,0,0,0
65728,55,1,54,47,0,2,0,0,0
65729,294,3,291,281,0,1,0,1,1
65730,177,9,168,135,5,4,0,2,0
65731,295,9,286,243,0,10,4,0,4
65732,823,6,817,771,1,5,2,0,4
65733,601,13,588,555,3,1,5,0,1
65734,3232,557,2675,2343,4,39,126,1,10
65735,188,6,182,168,0,1,1,0,4
65737,8209,313,7896,7269,29,69,50,10,24
65738,20995,718,20277,18375,233,113,160,6,54
65739,1240,51,1189,1120,2,6,5,0,7
65740,3543,235,3308,3041,16,36,16,0,16
65741,5,0,5,4,0,1,0,0,0
65742,12807,313,12494,11639,57,81,69,5,33
65744,103,2,101,94,0,0,0,0,0
65745,2590,66,2524,2293,8,41,8,1,15
65746,8667,180,8487,8138,20,33,22,0,18
65747,3364,62,3302,3115,5,30,10,5,8
65752,510,9,501,478,3,3,6,0,0
65753,4937,107,4830,4434,7,28,26,7,13
65754,990,19,971,894,4,2,2,2,0
65755,397,8,389,374,2,3,0,0,0
65756,783,35,748,676,2,18,0,5,0
65757,7962,154,7808,7336,31,26,33,2,21
65759,1158,21,1137,1053,4,6,2,0,6
65760,676,7,669,648,2,2,0,0,4
65761,1085,7,1078,1017,1,3,4,0,11
65762,397,7,390,358,1,4,0,0,3
65764,1393,21,1372,1315,3,3,0,2,1
65766,94,0,94,94,0,0,0,0,0
65767,1962,36,1926,1803,5,5,3,1,12
65768,292,7,285,267,0,0,2,0,0
65769,3017,378,2639,2459,9,23,20,6,10
65770,3044,77,2967,2756,12,22,8,3,9
65771,1375,35,1340,1238,4,8,13,0,3
65772,2028,51,1977,1752,8,32,29,1,14
65773,566,7,559,536,0,0,2,0,3
65774,767,15,752,686,0,2,4,0,8
65775,24519,556,23963,22215,141,165,156,11,68
65777,236,1,235,225,0,0,0,0,0
65778,332,7,325,309,0,4,0,0,1
65779,1768,33,1735,1627,2,7,2,0,9
65781,9609,283,9326,8580,66,59,34,4,34
65783,154,4,150,141,0,2,0,0,0
65784,44,0,44,41,0,0,0,0,0
65785,5302,110,5192,4819,36,24,15,4,14
65786,2171,42,2129,1994,2,12,5,0,7
65787,1549,51,1498,1418,6,9,2,1,14
65788,466,6,460,436,0,6,2,0,2
65789,1744,29,1715,1575,2,19,5,0,8
65790,763,20,743,691,4,7,1,0,0
65791,4085,54,4031,3786,9,22,3,0,6
65793,6304,144,6160,5669,22,27,28,4,22
65801,16,2,14,13,0,0,0,0,0
65802,48233,3062,45171,38120,2264,315,513,71,229
65803,42007,1939,40068,33858,2175,314,394,70,158
65804,40064,1758,38306,33566,987,201,1208,36,141
65806,12529,798,11731,9490,772,77,433,30,66
65807,55168,3512,51656,43649,2393,295,1566,90,205
65809,11882,282,11600,10511,94,52,372,4,31
65810,23168,855,22313,19334,434,94,1154,18,84
65897,2773,221,2552,1978,306,23,57,23,10
66002,13376,545,12831,11145,772,60,78,6,41
66006,7894,267,7627,6953,98,67,44,9,45
66007,9875,517,9358,8578,181,34,105,0,18
66008,240,4,236,226,0,0,0,0,1
66010,523,14,509,469,5,0,1,0,2
66012,10126,1159,8967,7703,541,71,60,14,27
66013,2524,104,2420,2233,14,5,44,0,10
66014,402,11,391,356,3,4,2,1,2
66015,732,14,718,671,2,2,1,0,3
66016,541,5,536,515,3,0,0,0,3
66017,301,2,299,281,0,1,0,0,0
66018,6419,1056,5363,4905,48,38,37,0,16
66020,1478,36,1442,1372,2,8,5,0,3
66021,2730,155,2575,2345,23,22,10,2,5
66023,1091,14,1077,1013,6,8,1,0,0
66024,714,22,692,583,54,2,2,2,4
66025,8037,438,7599,6943,58,91,40,8,17
66026,716,14,702,668,1,5,4,2,2
66027,6634,814,5820,4402,599,105,191,33,34
66030,25164,2451,22713,19495,915,88,408,33,121
66031,732,83,649,414,208,10,5,0,0
66032,5022,119,4903,4627,15,33,33,0,13
66033,760,11,749,703,0,5,12,0,4
66035,1169,45,1124,914,141,16,8,0,3
66039,582,3,579,541,6,5,1,0,6
66040,3463,111,3352,3130,29,26,6,2,6
66041,644,12,632,602,5,3,1,0,1
66042,689,24,665,615,12,7,3,0,0
66043,10784,770,10014,7872,1231,60,165,20,43
66044,28276,2157,26119,21412,1309,455,954,33,135
66045,1601,97,1504,1075,171,16,143,4,7
66046,19903,1890,18013,13408,1144,1215,804,10,90
66047,19396,1459,17937,14395,924,372,966,8,71
66048,36628,2697,33931,25863,4463,280,516,81,136
66049,32131,1942,30189,24759,1389,339,1690,12,145
66050,1787,54,1733,1562,22,21,18,0,7
66052,2070,114,1956,1819,15,8,8,0,2
66053,8325,294,8031,7487,41,21,49,1,23
66054,2774,82,2692,2485,16,13,5,2,2
66056,1722,46,1676,1580,10,7,1,1,2
66058,323,4,319,304,0,1,0,0,4
66060,1080,21,1059,994,3,8,0,0,0
66061,66166,10417,55749,45776,3857,215,2220,42,280
66062,77553,7215,70338,57120,4389,209,4050,70,354
66064,5783,237,5546,5034,142,47,22,1,8
66066,2681,78,2603,2445,5,9,6,1,12
66067,16011,864,15147,13780,268,118,68,7,52
66070,2519,54,2465,2305,20,17,5,12,1
66071,12416,376,12040,11094,158,54,43,5,33
66072,1023,26,997,941,8,3,7,1,4
66073,2295,60,2235,2080,13,13,11,2,2
66075,2097,42,2055,1938,8,4,0,1,1
66076,2282,70,2212,2049,6,17,3,0,7
66078,957,31,926,887,5,4,2,0,0
66079,716,15,701,653,1,7,4,0,0
66080,1005,22,983,909,4,4,11,0,4
66083,11379,512,10867,9973,174,41,83,3,43
66085,11231,487,10744,9006,176,15,992,3,28
66086,10662,522,10140,9260,121,74,57,3,16
66087,2009,42,1967,1873,12,8,7,3,7
66088,2310,78,2232,2066,20,13,4,0,2
66090,2609,79,2530,2322,56,18,13,14,11
66091,358,8,350,337,2,0,0,0,0
66092,4287,119,4168,3868,19,31,16,0,14
66093,603,6,597,584,0,3,0,0,0
66094,379,6,373,233,1,111,2,0,0
66095,875,20,855,795,3,11,5,0,1
66097,952,19,933,880,3,6,1,0,0
66101,13785,6016,7769,2805,3834,54,468,89,41
66102,30730,16480,14250,5578,5455,93,2066,65,102
66103,12741,4266,8475,5982,1306,66,469,15,60
66104,27509,9523,17986,5270,10154,96,1288,36,111
66105,2870,2063,807,648,47,11,25,7,2
66106,24085,9413,14672,10973,1888,89,555,13,65
66109,26160,3031,23129,15116,5014,120,1407,17,74
66111,10506,1766,8740,6863,1031,87,134,22,28
66112,12507,2123,10384,3855,4588,43,1151,87,64
66115,0,0,0,0,0,0,0,0,0
66118,25,3,22,11,8,0,2,0,0
66160,491,74,417,307,108,2,0,0,0
66202,16827,2214,14613,12158,935,27,525,17,73
66203,19439,2730,16709,13703,1236,68,450,12,80
66204,19381,2861,16520,13926,1036,74,471,8,88
66205,13929,1249,12680,11361,308,31,305,13,76
66206,10882,315,10567,9833,67,9,159,2,24
66207,14519,693,13826,12538,264,26,342,2,41
66208,21870,1002,20868,19325,199,40,355,2,57
66209,20056,727,19329,16756,410,25,1343,3,75
66210,19057,1263,17794,13966,972,53,1755,15,92
66211,4917,141,4776,4067,105,10,426,1,19
66212,32971,4075,28896,23433,2439,99,1034,16,200
66213,30987,1783,29204,22672,1219,56,3742,17,104
66214,12263,2050,10213,7976,1114,20,416,8,42
66215,26351,2642,23709,19620,1820,75,882,31,98
66216,25169,2210,22959,18956,1451,94,970,15,67
66217,5398,322,5076,4186,462,27,157,0,26
66218,9558,516,9042,7706,420,12,363,3,14
66219,13378,906,12472,9978,958,39,711,6,81
66220,8586,348,8238,7251,236,9,412,3,11
66221,24818,938,23880,18914,609,34,3126,3,96
66223,24843,1273,23570,16397,1058,52,4931,6,83
66224,13671,544,13127,10685,345,14,1450,4,40
66226,14844,839,14005,12298,468,51,386,4,42
66227,8476,503,7973,7005,226,25,333,3,23
66251,12,0,12,0,2,0,3,0,1
66401,1744,80,1664,1564,4,1,4,2,6
66402,3125,146,2979,2790,36,12,8,1,3
66403,756,11,745,705,4,2,7,0,0
66404,522,8,514,512,0,0,0,0,0
66406,443,9,434,411,3,5,2,0,1
66407,492,49,443,402,0,6,2,0,1
66408,417,9,408,393,1,3,0,0,0
66409,3211,156,3055,2828,28,16,18,1,12
66411,1227,24,1203,1155,1,2,0,0,6
66412,292,0,292,282,0,0,0,0,0
66413,1830,50,1780,1705,1,3,2,0,2
66414,2719,96,2623,2465,4,7,17,0,3
66415,848,25,823,787,1,5,0,0,0
66416,489,5,484,446,0,5,0,0,1
66417,442,4,438,432,0,0,0,0,0
66418,701,29,672,494,6,74,0,3,9
66419,422,6,416,373,2,19,0,0,0
66422,445,27,418,371,2,7,2,1,0
66423,855,22,833,798,0,3,2,0,0
66424,521,5,516,483,7,4,1,2,0
66425,432,8,424,401,1,3,0,0,4
66427,1328,10,1318,1285,3,3,3,0,6
66428,372,6,366,351,0,0,0,2,0
66429,564,37,527,484,3,13,2,2,1
66431,641,26,615,566,8,2,4,0,7
66432,389,12,377,357,0,2,2,0,5
66434,4783,168,4615,4118,65,109,31,1,11
66436,5824,351,5473,4957,65,146,21,5,8
66438,267,3,264,258,0,0,0,0,0
66439,2507,143,2364,1660,20,547,10,3,0
66440,1895,67,1828,1651,5,74,4,2,13
66441,26381,3949,22432,13886,4776,167,893,316,143
66442,16751,3539,13212,8755,2668,96,649,176,59
66449,807,24,783,738,6,3,1,0,3
66451,1709,33,1676,1593,2,3,1,1,0
66501,272,17,255,237,0,0,1,0,1
66502,44384,4279,40105,32838,2419,147,1905,145,196
66503,16565,1092,15473,12771,772,51,935,18,57
66506,3128,221,2907,2501,115,20,113,1,130
66507,1227,66,1161,1097,6,7,0,2,0
66508,4348,148,4200,3985,25,8,27,0,2
66509,2600,145,2455,1479,9,744,4,4,6
66510,757,10,747,717,1,2,0,0,4
66512,3390,119,3271,3009,20,38,7,8,10
66514,1692,145,1547,1270,81,14,31,20,10
66515,442,6,436,413,0,13,0,0,0
66516,343,9,334,304,0,12,0,2,0
66517,1666,211,1455,1145,121,15,46,1,1
66518,167,5,162,152,2,0,2,0,0
66520,647,14,633,596,2,0,0,0,5
66521,1521,44,1477,1396,3,12,7,2,8
66522,56,3,53,51,0,1,0,0,0
66523,3722,122,3600,3413,15,14,14,0,10
66524,2540,84,2456,2301,7,17,10,1,10
66526,798,46,752,705,4,4,0,0,4
66527,222,6,216,173,3,21,0,0,3
66528,782,7,775,722,1,2,0,0,1
66531,1359,61,1298,1169,4,11,3,0,12
66532,560,21,539,494,2,4,0,0,7
66533,1826,90,1736,1547,6,49,12,4,2
66534,3704,81,3623,3411,40,13,32,2,10
66535,3276,180,3096,2823,34,8,33,8,10
66536,4151,465,3686,3408,13,24,28,6,8
66537,1328,46,1282,1207,2,3,4,0,0
66538,3342,127,3215,3142,18,2,0,2,2
66539,2762,83,2679,2512,6,11,9,3,1
66540,509,8,501,442,0,22,0,1,0
66541,235,2,233,228,1,1,0,0,0
66542,3628,296,3332,3035,67,46,9,3,8
66543,782,22,760,718,1,0,4,1,2
66544,300,3,297,293,1,1,0,0,0
66546,1083,59,1024,934,8,13,4,0,3
66547,8825,349,8476,7942,66,37,49,6,11
66548,926,20,906,877,2,2,0,0,0
66549,1583,45,1538,1465,9,7,4,0,9
66550,555,4,551,523,1,1,2,1,0
66552,390,8,382,343,5,6,0,1,0
66554,565,15,550,517,7,1,0,2,4
66603,1569,517,1052,677,213,21,10,0,6
66604,22933,2851,20082,16129,1933,179,231,38,85
66605,19531,4761,14770,10328,2750,191,115,9,53
66606,11056,1459,9597,7894,729,99,97,10,47
66607,10414,3778,6636,3813,1943,134,44,30,40
66608,5247,583,4664,3952,206,81,25,4,14
66609,7519,914,6605,4943,944,71,66,2,38
66610,10414,635,9779,8576,320,76,278,2,28
66611,9843,1221,8622,6748,957,72,118,6,38
66612,2097,426,1671,956,497,26,21,6,14
66614,31332,2720,28612,23441,2030,226,1031,21,73
66615,3500,215,3285,2812,111,19,210,1,4
66616,5610,1663,3947,3269,178,71,21,7,22
66617,8818,436,8382,7646,92,63,64,2,38
66618,9940,487,9453,8634,149,82,70,8,24
66619,3207,293,2914,2322,254,12,17,2,13
66621,730,69,661,546,73,5,3,2,29
66622,27,1,26,24,2,0,0,0,0
66701,11642,304,11338,10026,434,70,89,2,38
66710,671,9,662,620,2,6,1,1,0
66711,582,11,571,531,1,8,0,0,2
66712,1863,46,1817,1669,13,10,6,1,17
66713,5234,148,5086,4151,19,352,32,18,5
66714,183,3,180,155,1,3,1,0,0
66716,580,10,570,517,11,1,2,0,0
66717,429,7,422,400,1,1,0,0,1
66720,10844,765,10079,9190,115,82,66,6,16
66724,913,10,903,830,0,6,0,1,0
66725,5065,150,4915,4363,19,150,9,0,10
66732,233,2,231,224,0,0,1,0,1
66733,2056,73,1983,1819,7,14,12,0,6
66734,273,3,270,264,0,0,0,0,0
66735,529,25,504,471,5,0,0,0,2
66736,3614,125,3489,3259,2,17,25,1,19
66738,373,21,352,314,1,4,1,0,0
66739,5283,142,5141,4428,36,194,18,6,16
66740,547,12,535,519,1,5,0,0,0
66741,228,4,224,216,0,0,0,0,0
66742,39,0,39,38,0,0,0,0,1
66743,4191,91,4100,3800,52,33,12,1,8
66746,222,14,208,201,0,0,0,0,0
66748,2603,131,2472,2301,25,26,4,0,4
66749,7512,311,7201,6488,143,90,52,0,23
66751,722,16,706,663,1,9,3,1,3
66753,1029,23,1006,929,6,21,2,0,0
66754,440,24,416,395,3,1,2,0,0
66755,989,25,964,890,2,10,7,1,3
66756,878,30,848,775,2,16,2,0,3
66757,3296,105,3191,2844,16,50,7,1,8
66758,212,3,209,195,0,3,0,0,0
66760,104,7,97,90,1,0,0,0,0
66761,228,10,218,204,0,7,0,0,0
66762,25309,2327,22982,19661,795,204,394,159,85
66763,3329,130,3199,2938,25,28,44,29,3
66767,466,4,462,441,2,2,1,0,0
66769,483,9,474,430,4,5,1,0,1
66770,1025,21,1004,852,2,39,0,0,1
66771,959,29,930,881,5,2,1,0,1
66772,278,5,273,262,2,0,0,0,4
66773,685,19,666,609,0,9,3,0,0
66775,155,2,153,142,1,0,0,0,1
66776,1356,26,1330,1221,2,27,1,0,0
66777,553,9,544,514,1,3,0,0,3
66778,7,0,7,6,1,0,0,0,0
66779,639,13,626,582,0,8,4,0,1
66780,555,21,534,514,0,0,2,0,0
66781,1124,18,1106,993,0,11,1,2,0
66782,159,7,152,126,2,1,2,0,2
66783,2157,52,2105,1987,7,13,0,0,4
66801,27369,7054,20315,17824,591,98,554,5,210
66830,257,23,234,226,0,6,0,0,1
66833,517,22,495,470,0,1,3,0,3
66834,878,36,842,791,5,8,4,0,2
66835,1232,60,1172,1112,1,1,2,0,4
66838,165,4,161,148,0,0,3,0,1
66839,4016,124,3892,3649,27,15,27,0,10
66840,698,14,684,642,4,1,3,0,12
66842,316,9,307,276,2,3,5,0,3
66843,190,6,184,173,0,1,0,0,2
66845,1168,169,999,934,16,4,8,1,1
66846,3348,182,3166,3024,8,8,7,1,5
66849,406,6,400,363,3,1,1,1,0
66850,211,9,202,190,0,1,0,0,0
66851,482,26,456,429,1,0,1,2,3
66852,627,20,607,581,1,4,0,1,1
66853,287,6,281,264,2,1,0,0,0
66854,751,23,728,682,3,5,2,0,1
66856,1567,42,1525,1455,4,7,5,0,1
66857,806,9,797,741,3,5,2,0,6
66858,395,21,374,361,0,0,0,0,0
66859,161,5,156,152,0,0,0,0,0
66860,1232,41,1191,1110,8,10,9,0,3
66861,3145,96,3049,2946,2,9,5,3,3
66862,135,2,133,128,0,0,0,0,5
66863,37,1,36,33,0,0,0,0,0
66864,406,22,384,364,3,5,0,0,0
66865,1029,23,1006,969,2,4,3,0,0
66866,1509,65,1444,1349,14,5,6,0,5
66868,749,38,711,682,1,3,1,0,6
66869,612,27,585,558,2,2,0,0,1
66870,157,4,153,141,1,2,1,0,1
66871,1302,31,1271,1199,7,3,12,0,2
66872,863,13,850,813,2,0,4,0,2
66873,307,5,302,293,0,0,0,0,0
66901,6294,306,5988,5621,117,27,34,4,10
66930,144,1,143,136,0,3,0,0,0
66932,139,4,135,130,0,0,1,0,2
66933,353,29,324,313,0,0,0,0,0
66935,2477,62,2415,2310,5,10,10,5,0
66936,322,8,314,299,0,1,1,0,1
66937,752,10,742,726,1,1,0,0,0
66938,984,4,980,945,1,7,1,0,0
66939,523,11,512,493,2,0,1,1,0
66940,284,4,280,272,0,0,0,0,0
66941,223,2,221,208,0,1,1,0,0
66942,211,9,202,193,1,0,0,0,0
66943,519,53,466,451,0,0,0,0,0
66944,232,6,226,216,2,0,1,0,0
66945,1065,22,1043,1020,4,0,1,1,1
66946,99,1,98,97,0,0,0,0,0
66948,468,10,458,436,1,3,1,0,0
66949,567,11,556,528,2,2,1,0,1
66951,652,7,645,619,1,3,2,0,0
66952,458,8,450,430,4,1,1,0,2
66953,633,90,543,525,0,0,0,0,1
66955,107,0,107,104,0,0,0,0,0
66956,1184,26,1158,1100,2,5,6,0,5
66958,243,3,240,237,0,0,0,0,0
66959,195,0,195,193,0,0,0,0,0
66960,157,0,157,153,0,0,0,0,0
66961,14,0,14,14,0,0,0,0,0
66962,296,1,295,292,0,0,0,0,0
66963,147,3,144,140,0,1,1,0,1
66964,141,1,140,133,1,0,0,0,0
66966,551,7,544,521,6,0,0,3,0
66967,2005,44,1961,1890,2,9,5,0,1
66968,1534,63,1471,1393,7,1,2,1,4
66970,104,2,102,100,0,0,0,0,0
67001,1909,56,1853,1809,3,0,0,0,4
67002,16518,1122,15396,13205,354,85,691,14,64
67003,2451,117,2334,2172,13,42,9,0,1
67004,733,14,719,656,3,8,0,0,0
67005,15675,2823,12852,10913,378,341,64,96,24
67008,491,18,473,439,0,6,5,0,0
67009,726,30,696,650,0,13,2,0,1
67010,13564,682,12882,11770,58,111,83,6,42
67012,44,1,43,37,0,2,0,0,0
67013,2843,138,2705,2502,13,26,2,0,12
67016,574,42,532,482,4,8,0,1,0
67017,2372,132,2240,2068,23,10,8,1,2
67018,125,4,121,109,0,0,0,0,1
67019,934,25,909,828,0,17,2,0,2
67020,1666,84,1582,1450,14,4,4,0,9
67021,58,5,53,51,0,0,0,0,0
67022,1413,53,1360,1260,2,18,6,0,5
67023,202,2,200,181,0,5,0,0,0
67024,720,25,695,592,9,60,4,0,0
67025,3953,119,3834,3650,7,24,9,2,6
67026,4980,192,4788,4449,13,39,17,0,23
67028,192,12,180,176,0,2,0,0,0
67029,918,51,867,830,5,1,0,0,1
67030,2756,105,2651,2544,5,17,6,0,0
67031,2047,31,2016,1912,2,17,1,0,3
67035,911,23,888,849,5,0,4,1,8
67036,122,4,118,111,1,0,0,0,0
67037,30005,2258,27747,24286,603,228,581,22,88
67038,504,3,501,461,0,9,0,0,0
67039,3106,110,2996,2750,7,38,23,0,2
67041,226,2,224,212,1,0,2,0,0
67042,17458,979,16479,14407,869,127,97,14,53
67045,3318,124,3194,2958,14,16,27,0,7
67047,650,20,630,584,2,5,0,0,3
67049,86,0,86,81,0,0,0,0,0
67050,2107,79,2028,1917,5,5,5,0,11
67051,428,12,416,361,3,12,1,0,9
67052,8977,600,8377,7688,78,60,67,1,16
67053,556,10,546,518,0,0,0,1,1
67054,1164,28,1136,1042,17,5,13,4,3
67055,64,3,61,52,2,0,0,0,2
67056,3056,125,2931,2778,14,5,3,2,2
67057,213,4,209,196,0,0,1,0,0
67058,1882,273,1609,1499,2,18,4,2,1
67059,1008,57,951,867,23,1,2,0,3
67060,13860,1025,12835,11428,117,152,160,6,35
67061,155,4,151,143,0,0,0,0,1
67062,3959,168,3791,3546,57,18,59,0,6
67063,3735,177,3558,3277,92,13,24,1,39
67065,194,3,191,186,0,0,0,0,2
67066,215,12,203,196,0,0,0,0,0
67067,1831,113,1718,1470,89,17,36,2,5
67068,4281,194,4087,3871,16,15,28,2,6
67070,1005,32,973,911,0,4,4,4,0
67071,79,0,79,78,0,0,0,0,0
67072,210,7,203,176,0,0,0,0,0
67073,299,10,289,270,4,2,4,0,0
67074,1614,85,1529,1374,8,17,1,0,7
67101,6015,622,5393,4703,172,52,104,4,21
67102,61,1,60,54,0,1,0,0,0
67103,274,6,268,250,0,0,0,0,0
67104,2232,108,2124,1979,7,27,9,1,8
67105,168,1,167,146,1,0,3,0,0
67106,454,18,436,420,0,2,1,0,0
67107,3022,120,2902,2761,19,4,7,1,19
67108,1744,58,1686,1582,3,19,5,0,9
67109,338,15,323,288,3,2,1,0,0
67110,8263,419,7844,7166,40,92,42,8,14
67111,349,7,342,317,2,1,1,0,1
67112,224,2,222,217,0,0,0,0,0
67114,21375,3412,17963,16165,435,131,167,4,66
67117,1827,142,1685,1538,68,11,20,1,2
67118,778,22,756,711,1,1,1,1,0
67119,1444,76,1368,1258,9,4,5,0,0
67120,1365,81,1284,1133,6,33,6,1,4
67122,191,12,179,159,0,4,0,1,0
67123,711,29,682,634,8,14,0,0,5
67124,7922,669,7253,6738,106,40,44,7,36
67127,668,47,621,591,5,1,0,1,1
67131,281,14,267,235,1,6,0,0,6
67132,332,4,328,315,0,4,0,0,1
67133,6694,259,6435,5874,37,47,67,1,28
67134,328,12,316,316,0,0,0,0,0
67135,3389,239,3150,2936,11,25,9,5,7
67137,509,5,504,477,2,2,0,0,0
67138,333,4,329,318,0,2,2,0,0
67140,724,42,682,645,1,5,2,0,6
67142,315,8,307,288,0,5,0,0,2
67143,56,2,54,46,0,1,0,0,0
67144,2753,102,2651,2441,25,25,12,0,2
67146,1727,59,1668,1522,1,28,4,3,10
67147,10715,815,9900,8905,156,77,88,5,47
67149,1092,39,1053,968,5,15,2,1,6
67150,10,0,10,7,0,0,0,0,0
67151,460,16,444,420,4,4,0,0,0
67152,9019,724,8295,7454,150,83,45,0,56
67154,1340,66,1274,1179,5,6,2,0,14
67155,149,5,144,138,0,0,0,0,1
67156,14592,1023,13569,11538,485,207,424,80,30
67159,192,0,192,187,0,0,0,0,0
67202,2435,235,2200,1685,282,28,49,9,8
67203,30498,8578,21920,17582,1877,330,472,17,102
67204,21932,8830,13102,10987,682,171,316,9,74
67205,20461,1736,18725,16224,364,90,985,7,55
67206,17076,1163,15913,12792,1174,72,936,12,45
67207,28143,3982,24161,12818,4756,204,4314,49,107
67208,17901,2307,15594,9306,4269,110,651,25,129
67209,14217,1632,12585,10759,420,102,412,17,55
67210,8705,2150,6555,3640,1176,45,1053,41,31
67211,19721,5777,13944,9483,2104,186,796,17,100
67212,43587,5773,37814,32122,1647,387,916,31,145
67213,21007,5395,15612,11795,1612,322,339,17,139
67214,15936,4903,11033,3369,5998,136,446,28,62
67215,6451,687,5764,4704,132,49,471,16,22
67216,23212,5593,17619,12128,2006,329,1399,44,90
67217,30926,5529,25397,19563,1849,375,1181,16,150
67218,23044,4965,18079,11453,3746,218,1008,59,97
67219,12905,1867,11038,6908,2940,130,239,7,32
67220,14370,1223,13147,7390,3330,87,1396,7,55
67221,402,79,323,218,63,10,12,2,1
67223,512,16,496,462,4,2,4,0,2
67226,20767,1546,19221,13826,2504,139,1510,21,91
67227,473,26,447,432,0,0,0,0,1
67228,2713,113,2600,2068,45,11,335,1,8
67230,12633,641,11992,9354,536,46,1398,4,45
67232,333,20,313,257,4,0,33,0,1
67235,14824,1118,13706,12394,168,65,385,2,35
67260,937,154,783,627,92,8,26,1,7
67301,12385,878,11507,9696,512,216,87,8,29
67330,1481,41,1440,1252,10,34,4,0,3
67332,231,2,229,204,0,6,0,0,0
67333,2603,108,2495,2040,5,147,7,5,10
67334,108,5,103,84,0,2,3,0,0
67335,3406,150,3256,2918,20,70,7,0,3
67336,1474,12,1462,1275,13,53,10,2,1
67337,11806,1243,10563,7859,987,461,88,7,26
67340,324,11,313,247,0,20,0,0,0
67341,481,10,471,445,3,2,0,1,3
67342,804,12,792,631,2,49,0,0,1
67344,781,22,759,685,3,13,0,3,3
67345,171,7,164,155,0,2,0,0,0
67346,335,8,327,302,0,7,1,0,0
67347,405,6,399,344,0,28,1,0,0
67349,863,37,826,766,0,14,2,0,0
67351,379,12,367,308,2,3,1,0,0
67352,446,10,436,412,0,9,0,0,0
67353,561,30,531,489,1,12,0,0,0
67354,717,16,701,627,4,17,0,0,0
67355,237,3,234,175,0,25,0,0,0
67356,2689,81,2608,2327,29,79,3,3,7
67357,12033,757,11276,9106,776,173,75,3,29
67360,257,9,248,228,0,6,0,0,0
67361,1764,92,1672,1473,14,86,11,0,2
67363,49,2,47,43,1,0,1,0,0
67364,177,2,175,150,2,10,0,0,0
67401,50338,6477,43861,37932,1704,223,1094,25,155
67410,9754,477,9277,8774,69,29,35,10,14
67416,1066,39,1027,989,5,0,2,0,1
67417,188,0,188,185,1,0,0,0,0
67418,175,3,172,160,0,0,0,0,0
67420,4281,142,4139,3988,16,12,10,0,1
67422,1254,19,1235,1174,2,4,1,0,3
67423,285,10,275,261,0,3,0,0,3
67425,756,34,722,688,0,4,3,0,0
67427,340,18,322,294,0,4,0,0,0
67428,1389,18,1371,1319,13,3,1,0,0
67430,571,4,567,548,2,0,1,0,0
67431,2424,135,2289,2145,17,8,9,4,9
67432,5796,156,5640,5364,39,29,36,0,7
67436,563,14,549,528,3,4,0,0,1
67437,995,24,971,924,0,11,3,0,0
67438,289,10,279,268,0,2,1,0,1
67439,3608,235,3373,2951,245,36,14,0,6
67441,943,46,897,827,0,5,3,1,3
67442,241,8,233,216,1,1,1,0,0
67443,1778,42,1736,1670,5,4,4,0,2
67444,519,21,498,474,2,1,1,0,0
67445,608,3,605,580,1,1,4,0,1
67446,534,8,526,512,0,0,1,0,1
67447,256,1,255,244,0,1,2,0,0
67448,1266,35,1231,1148,20,1,4,1,6
67449,2770,151,2619,2432,14,18,12,3,30
67450,505,14,491,459,2,1,2,0,0
67451,816,31,785,746,1,5,4,0,5
67452,215,3,212,206,0,0,1,0,0
67454,534,45,489,474,0,0,2,0,0
67455,1722,103,1619,1553,5,4,8,0,9
67456,4886,247,4639,4307,96,12,17,1,13
67457,794,22,772,746,2,6,0,0,0
67458,236,5,231,216,0,3,1,0,1
67459,244,21,223,196,3,0,3,0,1
67460,16113,1104,15009,13608,328,65,182,3,93
67464,963,33,930,899,2,1,0,0,0
67466,699,2,697,659,3,2,0,0,0
67467,2822,82,2740,2575,19,5,8,0,8
67468,304,6,298,285,0,0,0,0,0
67470,536,38,498,462,0,5,6,0,0
67473,1645,34,1611,1549,1,7,9,0,1
67474,194,4,190,185,0,0,1,0,0
67475,161,6,155,148,0,2,0,0,1
67476,66,1,65,64,0,0,0,0,0
67478,90,3,87,85,0,0,0,0,0
67480,1707,69,1638,1537,6,7,7,2,8
67481,633,10,623,596,1,6,0,0,2
67482,78,4,74,68,0,0,2,0,0
67483,329,10,319,303,4,0,0,0,1
67484,784,22,762,703,5,8,1,0,3
67485,355,2,353,340,1,0,0,0,0
67487,1350,57,1293,1199,10,1,9,0,2
67490,1140,36,1104,1051,4,1,2,0,1
67491,374,10,364,345,1,0,0,1,0
67492,255,13,242,223,3,4,1,0,1
67501,24779,3705,21074,18170,1298,187,125,13,67
67502,23770,1752,22018,20246,354,137,170,18,65
67505,2538,178,2360,2177,51,18,12,1,9
67510,257,8,249,242,0,1,0,0,1
67511,287,13,274,266,0,1,0,0,0
67512,201,5,196,182,1,3,1,0,0
67513,70,11,59,56,1,0,1,0,0
67514,698,25,673,631,3,3,1,0,9
67515,19,0,19,19,0,0,0,0,0
67516,367,87,280,258,0,2,0,0,3
67518,94,5,89,88,0,0,0,0,0
67519,199,79,120,113,0,1,0,0,1
67520,311,11,300,293,0,0,4,0,0
67521,140,4,136,129,0,0,0,0,1
67522,2131,101,2030,1917,13,10,8,1,2
67523,359,14,345,333,0,0,3,0,1
67524,547,56,491,451,2,1,1,0,0
67525,980,29,951,919,1,0,1,0,4
67526,2639,105,2534,2418,6,9,6,0,10
67529,328,29,299,282,0,3,0,0,0
67530,17901,3750,14151,13092,256,54,60,3,37
67543,2018,67,1951,1831,10,9,9,1,4
67544,3196,209,2987,2769,29,25,11,0,10
67545,193,1,192,184,0,2,1,0,0
67546,2530,39,2491,2369,13,6,5,2,15
67547,1699,299,1400,1319,13,7,1,0,0
67548,1382,61,1321,1286,4,0,5,0,0
67550,5270,464,4806,4261,248,19,25,0,25
67552,679,202,477,455,0,6,0,0,1
67553,92,5,87,79,0,0,1,0,0
67554,4150,982,3168,2918,35,12,9,0,14
67556,272,10,262,260,0,0,1,0,0
67557,615,159,456,419,1,4,2,0,1
67559,59,0,59,58,0,0,0,0,0
67560,1557,197,1360,1320,2,7,0,0,3
67561,1489,80,1409,1325,2,4,0,4,0
67563,331,38,293,278,1,2,0,1,0
67564,259,3,256,249,0,0,0,0,1
67565,445,23,422,402,1,3,1,0,0
67566,580,19,561,542,2,0,2,2,0
67567,466,30,436,421,1,1,1,0,1
67568,254,6,248,234,1,0,0,0,1
67570,1366,44,1322,1229,6,5,6,0,0
67572,390,11,379,370,0,0,2,0,0
67573,173,8,165,150,4,0,2,0,0
67574,189,6,183,175,0,2,1,0,1
67575,374,11,363,358,0,0,1,0,0
67576,1809,244,1565,1479,2,8,3,0,1
67578,1305,101,1204,1130,9,6,6,0,0
67579,2959,185,2774,2546,84,17,15,1,0
67581,392,12,380,346,1,3,0,0,6
67583,898,86,812,756,0,11,0,0,0
67584,233,2,231,227,0,0,0,0,1
67601,24428,1886,22542,20923,311,48,247,0,74
67621,331,15,316,302,1,4,0,0,0
67622,540,30,510,477,4,1,4,0,1
67623,237,3,234,224,0,0,0,0,2
67625,264,6,258,209,23,4,0,0,2
67626,160,2,158,152,0,2,0,0,1
67627,97,1,96,94,0,1,0,0,0
67628,79,0,79,77,0,0,0,0,0
67629,137,1,136,128,1,2,1,0,0
67631,221,6,215,208,1,0,0,0,0
67632,199,1,198,185,0,0,0,0,0
67634,237,1,236,224,0,0,2,0,1
67635,130,1,129,124,0,0,0,1,0
67637,2576,94,2482,2360,2,7,19,0,0
67638,207,2,205,197,5,1,0,0,0
67639,145,1,144,139,0,0,0,0,0
67640,574,17,557,531,5,0,2,0,0
67642,1661,44,1617,1509,31,2,14,0,11
67643,206,5,201,191,2,3,0,0,0
67644,216,4,212,192,0,3,0,0,0
67645,435,11,424,410,1,1,0,0,1
67646,589,28,561,541,0,2,2,0,0
67647,243,11,232,227,1,0,1,0,0
67648,491,16,475,443,1,0,4,0,3
67649,243,2,241,228,0,2,2,0,0
67650,215,7,208,201,0,1,0,0,1
67651,438,3,435,412,0,0,2,0,0
67653,272,16,256,242,1,0,2,0,0
67654,4333,265,4068,3664,192,30,30,2,7
67656,156,2,154,151,0,0,0,0,0
67657,314,15,299,274,3,0,0,1,0
67658,98,3,95,94,0,0,0,0,0
67659,103,1,102,101,0,1,0,0,0
67660,59,1,58,57,0,0,0,0,0
67661,3171,82,3089,2941,17,9,13,1,0
67663,2424,42,2382,2285,9,0,5,3,5
67664,253,1,252,244,0,4,0,0,0
67665,5011,193,4818,4491,54,27,20,0,6
67667,170,3,167,146,1,5,0,0,0
67669,1843,56,1787,1678,17,1,0,4,2
67671,1550,32,1518,1468,5,4,0,0,8
67672,2210,52,2158,2065,2,4,11,0,0
67673,99,2,97,95,0,0,1,0,0
67674,62,1,61,61,0,0,0,0,0
67675,183,1,182,175,0,1,0,1,0
67701,6561,492,6069,5736,98,13,36,0,15
67730,1717,133,1584,1480,13,2,7,0,8
67731,659,84,575,530,0,1,3,0,4
67732,528,36,492,471,3,0,1,0,6
67733,120,2,118,116,0,0,0,0,0
67734,190,14,176,164,1,0,3,0,1
67735,5467,711,4756,4422,101,12,13,1,15
67736,224,4,220,208,0,0,0,0,2
67737,473,13,460,433,0,0,0,0,1
67738,487,17,470,458,0,0,0,0,0
67739,226,1,225,214,0,0,1,0,0
67740,1732,112,1620,1555,0,6,7,1,0
67741,305,60,245,230,2,0,0,0,0
67743,183,3,180,171,3,0,0,0,1
67744,195,2,193,174,3,0,2,0,1
67745,281,11,270,249,2,0,0,0,3
67747,144,5,139,128,1,0,1,0,4
67748,2541,180,2361,2268,2,0,17,2,5
67749,2158,64,2094,2001,7,3,7,0,3
67751,199,7,192,186,1,0,1,0,2
67752,1384,32,1352,1271,2,3,12,1,8
67753,472,106,366,347,1,0,0,0,2
67756,1917,151,1766,1657,6,6,9,0,0
67757,420,20,400,385,0,1,5,0,0
67758,1021,59,962,896,2,1,0,1,3
67761,258,2,256,249,0,0,0,0,0
67762,286,21,265,251,1,0,0,1,0
67764,395,16,379,366,0,0,0,0,0
67801,31090,19401,11689,9690,864,82,384,5,86
67831,971,85,886,823,0,7,11,1,7
67834,876,59,817,767,2,4,4,0,2
67835,2837,533,2304,2181,14,10,10,0,2
67836,104,30,74,65,1,4,0,0,0
67837,808,71,737,719,0,3,0,0,3
67838,903,437,466,433,4,2,2,0,0
67839,1281,115,1166,1116,0,4,0,2,3
67840,81,4,77,70,0,3,0,0,0
67841,320,78,242,231,0,0,0,0,1
67842,394,29,365,343,2,3,0,0,1
67843,96,8,88,81,1,1,1,1,0
67844,804,154,650,612,15,1,2,0,2
67846,35205,18840,16365,12506,1338,129,1503,3,151
67849,382,21,361,356,0,2,1,0,0
67850,330,41,289,272,0,4,0,0,0
67851,2798,927,1871,1691,22,27,9,0,4
67853,780,123,657,624,7,2,3,0,0
67854,1191,68,1123,1052,14,5,7,1,2
67855,1865,867,998,913,7,18,2,0,0
67857,157,28,129,122,2,0,1,0,0
67859,547,173,374,341,4,0,6,0,3
67860,2961,940,2021,1845,30,8,3,1,2
67861,1875,620,1255,1159,1,6,2,2,7
67862,246,49,197,178,0,5,0,0,0
67863,317,23,294,280,2,2,0,0,0
67864,1949,167,1782,1651,21,8,13,0,2
67865,1042,121,921,865,3,12,13,0,0
67867,1591,131,1460,1428,0,0,1,0,3
67868,211,53,158,152,0,1,0,0,0
67869,1346,492,854,813,2,2,0,0,3
67870,1534,590,944,909,0,3,1,0,4
67871,5148,1015,4133,3901,12,20,15,2,3
67876,1224,88,1136,1073,11,4,4,0,1
67877,2039,511,1528,1482,9,3,0,0,2
67878,2331,1036,1295,1236,7,8,4,0,2
67879,1277,197,1080,1031,0,4,5,0,10
67880,7359,3862,3497,3223,10,52,8,3,10
67882,390,54,336,320,3,3,0,0,0
67901,21242,14215,7027,5437,606,65,509,1,38
67950,2058,453,1605,1472,13,9,24,6,10
67951,4688,1835,2853,2654,20,17,22,0,14
67952,597,188,409,384,0,3,2,0,2
67953,88,4,84,75,0,1,0,2,0
67954,549,135,414,385,4,0,7,1,2
68001,71,7,64,62,0,1,1,0,0
68002,2181,38,2143,2057,4,3,5,0,3
68003,5291,148,5143,4823,20,26,36,4,17
68004,867,20,847,803,2,15,1,2,2
68005,23236,3369,19867,16168,1424,111,563,47,104
68007,16250,662,15588,13889,530,41,421,2,71
68008,12597,425,12172,11652,40,12,76,1,22
68010,410,51,359,232,99,14,5,2,0
68014,263,2,261,259,0,0,0,0,0
68015,1039,20,1019,979,3,2,1,0,5
68016,498,9,489,465,5,0,0,0,0
68017,1702,35,1667,1589,7,4,3,0,8
68018,534,14,520,496,1,2,1,0,5
68019,524,20,504,477,2,5,2,0,0
68020,624,10,614,550,3,34,3,2,2
68022,30996,1181,29815,26812,313,50,1393,9,82
68023,2740,73,2667,2543,8,6,11,0,11
68025,31301,5724,25577,24177,199,117,171,9,84
68028,15954,529,15425,14571,74,30,138,8,20
68029,860,23,837,797,1,0,2,0,2
68030,809,32,777,735,1,24,1,0,0
68031,1628,40,1588,1558,5,2,6,0,0
68033,435,17,418,376,0,6,2,0,5
68034,939,22,917,857,4,1,4,0,0
68036,401,9,392,367,0,1,1,1,2
68037,2615,74,2541,2423,12,6,6,0,7
68038,1321,66,1255,1197,3,6,6,7,0
68039,1355,12,1343,37,0,1290,1,0,6
68040,339,5,334,316,0,1,4,0,1
68041,991,42,949,908,1,2,5,0,0
68042,111,2,109,103,1,0,0,0,0
68044,692,78,614,588,1,2,2,1,0
68045,1919,68,1851,1718,9,25,15,8,6
68046,32242,2328,29914,26407,986,82,631,22,128
68047,1709,82,1627,1535,3,47,8,3,4
68048,12991,607,12384,11712,44,32,59,5,45
68050,597,4,593,575,0,0,1,0,2
68055,279,21,258,182,0,66,1,0,1
68056,6,0,6,6,0,0,0,0,0
68057,1525,40,1485,1412,10,4,8,1,3
68058,249,8,241,234,0,0,0,0,0
68059,3408,95,3313,3152,11,25,17,0,16
68061,2414,27,2387,2309,2,8,8,0,3
68062,267,8,259,239,1,16,0,0,1
68063,253,19,234,225,0,4,0,0,1
68064,3872,133,3739,3499,35,18,21,1,15
68065,1414,18,1396,1341,8,6,5,0,7
68066,6065,221,5844,5615,23,25,17,1,14
68067,1098,50,1048,323,3,708,1,0,0
68068,129,1,128,124,0,0,0,0,0
68069,2854,101,2753,2600,21,9,30,3,6
68070,783,11,772,743,1,4,1,0,5
68071,2011,76,1935,144,17,1718,0,1,6
68072,19,0,19,18,0,0,0,0,0
68073,2182,41,2141,2058,12,6,7,0,0
68102,9130,905,8225,5684,1569,95,416,10,80
68104,36706,2892,33814,16643,9958,229,4653,25,221
68105,22669,7365,15304,12089,1511,142,604,11,96
68106,21871,2718,19153,16136,1051,99,858,16,69
68107,31064,20351,10713,7525,1943,202,135,6,119
68108,15623,8412,7211,5624,745,106,130,8,56
68110,9665,1568,8097,2563,4313,111,545,13,47
68111,25048,4359,20689,4511,12902,236,1401,15,177
68112,11095,1250,9845,5920,2820,108,215,6,79
68113,841,114,727,502,105,2,36,1,12
68114,18078,1125,16953,13542,1706,54,816,5,53
68116,34003,1584,32419,26775,1615,47,2386,11,91
68117,8387,3225,5162,4560,183,61,59,14,33
68118,9802,362,9440,8436,138,6,493,0,26
68122,12999,1094,11905,6548,3110,52,1448,10,58
68123,32203,3644,28559,22806,2188,106,911,78,136
68124,15503,899,14604,12833,538,36,485,17,71
68127,22507,3771,18736,15673,1344,90,668,23,70
68128,19160,2047,17113,14567,830,49,661,17,82
68130,21501,894,20607,18319,298,27,1092,11,68
68131,13609,1741,11868,7493,2688,134,868,21,72
68132,13729,1072,12657,9874,1245,65,765,7,52
68133,13705,1080,12625,10943,391,21,534,11,57
68134,28996,2284,26712,18323,5085,162,1357,23,117
68135,30728,1454,29274,25969,444,47,1481,17,102
68136,20984,1084,19900,18026,290,29,691,0,47
68137,26537,2635,23902,20605,929,83,945,60,89
68138,12327,915,11412,10159,311,34,227,31,47
68142,5511,373,5138,4061,341,10,388,0,18
68144,24994,2019,22975,20224,878,106,651,15,66
68147,11387,3604,7783,6388,520,45,193,8,41
68152,6615,298,6317,4424,1231,38,312,6,40
68154,23383,1345,22038,18557,1131,68,1211,14,84
68157,5525,1502,4023,3429,152,22,124,0,26
68164,28314,2225,26089,20453,2855,99,1067,17,77
68178,2267,184,2083,1624,74,5,221,12,10
68182,803,78,725,603,25,2,55,1,1
68183,0,0,0,0,0,0,0,0,0
68301,1654,25,1629,1581,4,2,12,0,3
68303,261,11,250,239,1,1,0,0,0
68304,329,5,324,297,0,10,1,0,3
68305,4368,113,4255,4097,2,13,28,0,5
68307,440,6,434,419,1,0,0,0,0
68309,90,1,89,86,0,1,0,0,0
68310,14134,518,13616,12860,113,50,91,1,26
68313,938,25,913,878,7,2,0,0,6
68314,342,7,335,317,2,0,0,0,1
68315,121,2,119,118,0,0,0,0,0
68316,396,7,389,383,0,1,0,0,1
68317,2044,61,1983,1882,5,3,7,2,3
68318,407,0,407,396,0,0,0,0,0
68319,540,21,519,494,0,0,0,0,5
68320,393,7,386,370,0,3,1,0,0
68321,309,8,301,296,0,0,0,0,0
68322,420,10,410,401,0,0,0,0,0
68323,240,2,238,233,0,0,0,0,1
68324,153,4,149,141,1,0,0,0,1
68325,207,0,207,207,0,0,0,0,0
68326,258,3,255,251,0,0,0,0,0
68327,329,7,322,317,1,2,0,0,0
68328,447,14,433,419,0,1,4,0,0
68329,580,22,558,540,0,0,4,0,0
68330,63,0,63,63,0,0,0,0,0
68331,1016,22,994,946,0,3,0,0,7
68332,115,6,109,106,0,0,0,0,0
68333,8484,3572,4912,4304,91,23,249,45,21
68335,535,14,521,512,0,0,0,0,0
68336,504,13,491,478,1,2,2,0,2
68337,322,3,319,298,0,7,1,0,2
68338,241,2,239,231,0,1,0,0,1
68339,1645,40,1605,1511,8,6,17,0,5
68340,933,31,902,864,3,1,1,2,0
68341,966,60,906,857,0,8,1,0,1
68342,528,21,507,492,1,0,1,0,0
68343,1012,166,846,824,3,0,3,0,0
68344,399,7,392,369,0,0,1,0,0
68345,215,7,208,201,0,0,0,0,0
68346,459,21,438,405,1,1,3,0,1
68347,2551,81,2470,2356,13,7,6,0,11
68348,209,9,200,191,0,0,3,0,1
68349,1132,35,1097,1046,4,6,5,1,2
68350,166,3,163,153,0,1,0,0,0
68351,724,11,713,693,1,5,0,0,0
68352,5075,301,4774,4517,19,38,14,0,15
68354,866,29,837,811,4,1,5,0,0
68355,4930,103,4827,4376,14,163,33,0,6
68357,382,7,375,372,0,0,1,0,2
68358,1935,99,1836,1757,10,2,6,0,4
68359,1401,38,1363,1300,16,0,6,0,5
68360,570,7,563,553,0,2,0,0,0
68361,2483,81,2402,2289,12,9,5,1,0
68362,33,0,33,32,0,0,0,0,0
68364,183,9,174,165,0,0,3,0,0
68365,227,7,220,215,1,0,1,0,0
68366,1110,26,1084,1025,0,4,7,0,4
68367,472,9,463,451,0,0,0,0,0
68368,574,25,549,524,1,0,1,0,5
68370,1954,56,1898,1844,4,5,8,3,3
68371,1531,15,1516,1483,1,4,7,0,0
68372,3813,94,3719,3595,19,5,12,0,1
68375,108,3,105,102,0,0,1,0,0
68376,1322,19,1303,1250,0,12,1,0,0
68377,369,21,348,338,0,0,0,0,3
68378,644,8,636,624,1,1,1,0,1
68379,58,8,50,49,0,0,0,0,0
68380,61,2,59,56,0,0,0,0,0
68381,177,4,173,167,0,1,0,0,0
68382,35,8,27,24,1,0,0,0,0
68401,730,10,720,701,0,1,2,0,0
68402,1330,26,1304,1277,1,1,0,0,0
68403,180,5,175,173,0,0,1,0,0
68404,1043,36,1007,955,3,3,2,0,5
68405,3378,87,3291,3119,14,16,12,1,14
68406,370,3,367,356,0,0,1,0,0
68407,789,8,781,751,3,3,0,0,2
68409,900,35,865,801,4,6,9,0,8
68410,8620,1067,7553,7109,60,22,64,0,25
68413,550,13,537,515,2,0,1,1,0
68414,251,12,239,228,0,2,0,0,0
68415,534,6,528,513,0,5,0,0,1
68416,233,23,210,209,1,0,0,0,0
68417,298,12,286,272,0,2,0,0,3
68418,1220,33,1187,1115,5,2,11,0,4
68419,247,3,244,228,1,0,3,0,0
68420,1301,22,1279,1248,4,7,0,0,2
68421,987,54,933,815,53,8,1,0,7
68422,535,4,531,504,0,2,1,0,1
68423,1007,24,983,955,2,3,1,1,0
68424,670,6,664,648,0,0,0,0,0
68428,1570,22,1548,1481,2,1,14,0,7
68429,68,2,66,65,0,0,0,0,0
68430,2063,55,2008,1929,10,3,9,2,0
68431,341,3,338,273,1,32,0,0,1
68433,193,2,191,185,0,3,0,0,1
68434,9209,314,8895,8513,74,19,32,3,16
68436,548,27,521,501,1,4,1,0,0
68437,290,10,280,270,0,0,0,0,0
68438,136,2,134,126,2,0,3,0,0
68439,482,0,482,469,0,1,1,0,0
68440,90,2,88,85,0,0,0,0,1
68441,231,3,228,223,0,0,0,0,0
68442,275,8,267,259,0,2,0,0,1
68443,1029,29,1000,985,0,0,0,0,1
68444,88,1,87,87,0,0,0,0,0
68445,125,3,122,117,0,1,0,0,0
68446,2799,56,2743,2622,13,9,4,0,4
68447,459,5,454,445,0,0,1,1,0
68448,378,17,361,346,0,0,0,0,0
68450,3369,561,2808,2290,311,52,68,0,6
68452,82,1,81,80,0,0,0,0,0
68453,317,24,293,284,0,0,1,1,0
68454,748,19,729,706,0,0,1,0,0
68455,733,37,696,620,7,8,4,0,3
68456,1070,18,1052,999,0,1,8,1,6
68457,296,7,289,277,0,4,0,0,0
68458,170,3,167,161,0,1,0,0,0
68460,905,33,872,843,2,0,8,0,4
68461,708,17,691,656,5,0,6,0,2
68462,4886,135,4751,4546,25,6,42,0,8
68463,1488,32,1456,1390,5,3,1,1,2
68464,465,10,455,445,0,3,1,0,0
68465,2522,208,2314,2196,23,12,18,0,0
68466,1755,35,1720,1642,8,8,0,0,1
68467,9663,743,8920,8317,164,65,73,2,21
68502,27238,3082,24156,19302,2105,268,997,7,109
68503,15064,2053,13011,8989,1424,190,1420,10,79
68504,17155,1773,15382,12387,1009,136,799,14,63
68505,17475,1169,16306,14225,539,44,610,8,76
68506,28203,1652,26551,23804,601,103,729,26,123
68507,15680,998,14682,13082,365,58,286,7,52
68508,17249,2002,15247,12173,1077,124,1047,6,308
68510,20669,1783,18886,15905,824,143,906,26,68
68512,13492,710,12782,11146,390,26,665,4,43
68514,266,10,256,243,1,1,0,0,4
68516,47448,1983,45465,40710,897,103,1714,16,151
68517,517,6,511,476,0,1,0,0,5
68520,2024,50,1974,1844,18,4,54,0,0
68521,37251,4405,32846,25910,1994,166,2891,16,97
68522,14496,1647,12849,9938,1162,168,852,9,45
68523,1882,73,1809,1738,3,1,21,0,1
68524,5843,797,5046,4140,320,68,77,7,24
68526,7788,278,7510,6794,130,12,341,2,9
68527,1849,52,1797,1610,17,6,105,0,2
68528,6929,648,6281,5158,387,42,319,7,44
68531,80,2,78,69,1,0,1,0,0
68532,683,13,670,643,1,3,3,1,1
68588,21,7,14,5,1,1,0,0,0
68601,30189,7201,22988,21647,341,91,190,4,98
68620,2941,64,2877,2821,13,9,4,0,0
68621,434,15,419,404,2,1,0,0,0
68622,293,6,287,281,0,0,0,0,0
68623,235,0,235,227,0,1,1,0,0
68624,1012,48,964,933,1,6,0,0,5
68626,627,14,613,591,4,1,2,0,3
68627,633,25,608,590,0,0,2,0,0
68628,803,41,762,736,2,1,4,0,0
68629,1275,38,1237,1219,2,0,2,0,2
68631,432,14,418,407,0,1,2,0,2
68632,3966,318,3648,3515,14,13,6,0,10
68633,1111,89,1022,999,3,2,0,1,0
68634,459,28,431,416,0,3,2,1,0
68635,487,7,480,471,1,0,0,0,2
68636,1287,17,1270,1237,0,3,6,0,4
68637,291,8,283,273,0,2,0,0,0
68638,1586,26,1560,1508,1,3,2,0,1
68640,1443,36,1407,1345,2,3,3,0,0
68641,1028,45,983,956,3,7,3,2,0
68642,1788,17,1771,1733,1,3,0,0,2
68643,968,45,923,896,3,0,1,2,0
68644,737,7,730,725,0,0,0,0,1
68647,612,9,603,578,3,1,1,0,1
68648,449,4,445,433,0,0,2,0,1
68649,1910,95,1815,1770,0,2,4,0,7
68651,1342,24,1318,1262,2,5,1,0,5
68652,660,17,643,626,1,1,0,0,0
68653,781,22,759,726,1,1,2,4,2
68654,601,21,580,547,0,1,0,0,0
68655,147,5,142,139,0,0,0,0,0
68658,691,31,660,648,3,0,0,0,0
68659,179,18,161,155,0,0,0,0,0
68660,1134,71,1063,1017,8,5,1,0,6
68661,7482,4831,2651,2148,367,19,45,1,13
68662,1202,175,1027,998,0,4,1,1,0
68663,660,16,644,625,2,3,2,0,0
68664,254,13,241,225,1,0,0,0,2
68665,751,12,739,726,1,1,3,0,3
68666,1521,31,1490,1415,6,3,0,0,3
68667,108,8,100,97,0,0,0,0,0
68669,395,10,385,367,5,0,0,0,0
68701,31257,4396,26861,24790,395,347,313,4,100
68710,707,46,661,644,1,2,0,0,0
68711,128,2,126,126,0,0,0,0,0
68713,2235,77,2158,2095,8,8,11,0,7
68714,1065,16,1049,1029,3,1,0,0,2
68715,1621,23,1598,1530,2,13,5,0,8
68716,925,41,884,847,4,3,6,2,2
68717,186,2,184,178,1,1,0,1,0
68718,1672,86,1586,1427,3,104,3,0,2
68719,126,4,122,119,0,0,0,0,2
68720,317,26,291,283,0,1,0,0,0
68722,472,13,459,442,0,7,0,0,1
68723,503,18,485,470,1,4,0,0,0
68724,140,7,133,108,0,11,2,0,1
68725,491,8,483,476,0,1,1,0,0
68726,712,48,664,649,1,1,4,0,0
68727,723,20,703,677,2,3,0,0,0
68728,192,4,188,178,1,0,1,0,0
68729,1739,23,1716,1640,7,20,9,0,2
68730,1919,16,1903,1839,5,11,4,0,5
68731,2899,927,1972,1608,24,100,123,10,10
68732,209,2,207,198,0,3,0,0,2
68733,1258,96,1162,1041,2,71,6,0,3
68734,161,3,158,150,0,1,0,0,0
68735,833,11,822,809,7,0,0,0,0
68736,601,3,598,582,3,0,0,0,0
68739,2844,69,2775,2730,7,2,3,1,3
68740,804,15,789,766,2,5,1,0,0
68741,651,33,618,594,2,4,4,0,1
68742,216,5,211,206,0,4,0,0,0
68743,588,18,570,549,1,3,2,4,0
68745,1523,37,1486,1447,4,3,7,0,0
68746,415,3,412,404,0,3,1,0,0
68747,155,3,152,148,1,0,0,0,0
68748,3020,1196,1824,1608,19,12,125,1,10
68749,48,2,46,40,0,2,0,0,0
68751,58,0,58,56,0,0,0,0,0
68752,820,19,801,789,3,1,0,1,1
68753,36,0,36,35,0,0,0,0,0
68755,268,7,261,250,0,2,0,0,0
68756,1974,96,1878,1829,5,8,9,0,0
68757,639,9,630,617,0,1,0,0,0
68758,1047,83,964,946,0,1,4,1,1
68759,252,7,245,238,0,0,0,0,0
68760,1394,25,1369,540,0,762,6,0,0
68761,425,14,411,386,5,1,0,0,0
68763,4701,396,4305,4140,26,19,35,1,5
68764,721,10,711,693,2,1,1,0,0
68765,1373,31,1342,1293,8,2,5,0,9
68766,426,5,421,412,0,1,1,0,0
68767,3327,62,3265,3169,9,10,3,2,3
68768,568,39,529,514,0,0,2,0,0
68769,1793,41,1752,1691,11,4,4,0,1
68770,1603,33,1570,1517,15,6,3,0,0
68771,1459,34,1425,1390,8,3,0,0,0
68773,165,3,162,156,0,0,1,0,0
68774,315,12,303,300,0,0,0,0,0
68776,16007,7763,8244,5313,1572,375,468,140,20
68777,664,9,655,636,0,1,0,0,1
68778,596,15,581,570,0,1,0,0,0
68779,2342,79,2263,2172,5,7,10,3,5
68780,966,12,954,945,0,2,1,0,0
68781,1442,43,1399,1347,12,13,4,1,4
68783,959,8,951,890,0,32,1,1,0
68784,2169,786,1383,1330,2,4,4,0,4
68785,284,14,270,255,0,0,7,0,2
68786,985,18,967,942,0,2,3,2,3
68787,6862,795,6067,5272,342,17,120,8,60
68788,4861,915,3946,3846,13,7,8,3,12
68789,134,7,127,123,1,0,0,0,0
68790,713,18,695,672,4,1,0,0,0
68791,1798,113,1685,1619,2,0,0,2,4
68792,468,5,463,456,0,0,0,0,0
68801,30440,13064,17376,15119,1139,113,269,17,94
68803,26487,5467,21020,19141,663,94,410,7,78
68810,1101,296,805,767,5,1,2,0,2
68812,783,24,759,739,3,3,2,0,1
68813,544,7,537,514,4,0,0,0,0
68814,923,16,907,888,2,5,2,0,0
68815,566,10,556,543,0,0,1,0,3
68816,145,5,140,129,1,0,0,0,0
68817,351,6,345,335,0,1,0,0,1
68818,5702,218,5484,5288,21,18,12,0,9
68820,399,5,394,389,2,0,0,0,0
68821,102,1,101,95,0,0,0,0,0
68822,4700,242,4458,4271,26,21,11,2,10
68823,2190,41,2149,2107,3,0,0,0,2
68824,1407,76,1331,1287,4,2,3,0,2
68825,1012,28,984,952,3,2,1,0,1
68826,4044,157,3887,3670,25,17,23,1,0
68827,634,45,589,566,1,2,0,1,0
68828,173,3,170,168,0,0,1,0,0
68831,838,25,813,792,2,0,0,0,0
68832,1932,53,1879,1851,1,3,0,0,3
68833,203,5,198,185,1,0,1,0,0
68834,228,23,205,194,5,0,0,0,0
68835,430,7,423,411,1,0,0,0,1
68836,1789,80,1709,1633,2,4,3,0,7
68837,93,0,93,90,0,0,0,0,0
68838,297,9,288,276,0,3,0,1,0
68840,2946,785,2161,2076,12,3,1,1,2
68841,658,17,641,621,0,2,1,0,0
68842,613,13,600,586,0,1,1,0,5
68843,785,15,770,741,5,0,0,0,4
68844,197,4,193,183,0,0,0,0,0
68845,20304,1588,18716,17351,328,64,331,18,45
68846,287,7,280,272,1,3,0,0,0
68847,18458,2055,16403,15385,189,54,184,10,30
68849,1433,239,1194,996,41,16,125,2,0
68850,12489,7531,4958,3507,1141,19,125,18,23
68852,474,9,465,454,0,1,0,0,0
68853,1573,52,1521,1458,0,10,5,2,0
68854,819,28,791,757,0,5,1,0,6
68855,402,6,396,388,1,3,1,0,0
68856,600,20,580,553,6,1,0,0,3
68858,263,19,244,231,8,0,2,0,3
68859,458,13,445,434,0,0,0,0,0
68860,336,8,328,320,0,0,0,0,0
68861,121,7,114,105,1,0,0,0,2
68862,2908,92,2816,2723,15,4,4,5,7
68863,1132,101,1031,980,3,6,5,0,10
68864,1068,39,1029,989,6,4,0,0,0
68865,960,33,927,903,0,2,0,0,0
68866,1000,13,987,971,1,0,2,1,1
68869,2216,77,2139,2065,8,4,7,0,3
68870,561,26,535,509,3,2,1,0,4
68871,230,7,223,218,0,3,0,0,0
68872,908,25,883,858,3,2,1,0,0
68873,3476,69,3407,3311,5,7,11,0,7
68874,838,18,820,796,2,0,1,0,0
68875,559,22,537,532,0,0,0,1,0
68876,1502,187,1315,1266,6,1,2,1,1
68878,400,27,373,366,0,0,0,0,0
68879,284,9,275,260,0,0,1,0,0
68881,49,1,48,46,1,0,0,0,0
68882,439,8,431,424,0,1,2,0,2
68883,2194,305,1889,1808,6,3,5,2,9
68901,26269,3511,22758,21153,241,105,397,9,60
68920,1330,33,1297,1264,1,1,6,0,0
68922,1290,66,1224,1181,5,3,5,0,1
68923,106,5,101,96,0,0,0,0,3
68924,1204,39,1165,1121,0,3,1,0,2
68925,422,5,417,414,0,0,0,0,0
68926,709,39,670,623,0,2,0,0,0
68927,1104,92,1012,978,1,5,3,1,1
68928,379,20,359,335,2,2,0,0,0
68929,157,3,154,148,1,1,0,0,1
68930,1217,26,1191,1153,3,1,3,0,0
68932,400,9,391,383,1,0,1,0,0
68933,895,44,851,815,1,1,0,0,2
68934,186,3,183,183,0,0,0,0,0
68935,678,20,658,631,0,0,0,0,5
68936,188,3,185,175,0,3,0,0,1
68937,1683,65,1618,1580,1,2,8,0,0
68938,507,13,494,476,1,1,0,0,0
68939,1187,43,1144,1119,1,0,8,0,0
68940,453,15,438,422,2,1,4,0,1
68941,718,9,709,687,1,5,1,0,0
68942,447,27,420,402,1,4,0,0,0
68943,227,7,220,212,0,0,1,0,0
68944,1210,221,989,931,2,2,3,0,5
68945,233,12,221,214,0,2,2,0,0
68946,66,5,61,61,0,0,0,0,0
68947,569,12,557,548,4,1,1,0,0
68948,339,12,327,317,0,0,0,0,0
68949,6519,410,6109,5913,26,14,19,0,14
68950,298,4,294,289,0,0,1,0,1
68952,142,4,138,135,1,0,0,0,1
68954,82,4,78,72,0,0,2,0,0
68955,2084,93,1991,1897,4,8,7,0,3
68956,1246,30,1216,1185,1,2,9,0,1
68957,545,13,532,523,0,0,2,0,1
68958,613,32,581,561,2,1,3,0,1
68959,4047,288,3759,3600,3,6,6,2,8
68960,177,1,176,172,0,1,0,0,1
68961,700,21,679,654,0,0,0,0,2
68964,134,3,131,128,0,0,0,0,0
68966,614,19,595,586,0,0,0,0,0
68967,1042,69,973,935,1,8,3,0,2
68970,1248,72,1176,1123,6,8,5,0,1
68971,379,7,372,368,0,1,0,0,0
68972,176,2,174,171,0,0,2,0,0
68973,461,12,449,440,1,1,0,0,1
68974,183,7,176,171,1,0,0,0,1
68975,137,9,128,127,0,0,0,0,0
68976,173,12,161,156,1,0,1,0,0
68977,284,12,272,256,0,2,2,0,0
68978,2215,63,2152,2063,4,4,1,0,6
68979,1823,193,1630,1587,1,6,3,0,6
68980,369,15,354,341,3,0,1,0,0
68981,296,14,282,268,0,0,2,0,2
68982,572,16,556,541,0,2,3,0,1
69001,9347,644,8703,8263,108,32,36,12,14
69020,398,4,394,379,0,1,1,0,0
69021,1130,53,1077,1039,5,4,0,3,4
69022,1489,52,1437,1397,2,3,1,0,0
69023,439,45,394,375,1,0,4,0,0
69024,1040,44,996,968,0,1,1,0,1
69025,1102,52,1050,993,14,4,0,1,4
69026,193,7,186,178,0,0,1,0,0
69027,137,5,132,127,0,0,1,0,0
69028,726,13,713,692,1,0,0,2,0
69029,363,13,350,344,0,0,0,0,1
69030,283,46,237,223,1,2,1,0,0
69032,436,52,384,367,0,3,2,0,0
69033,2574,451,2123,2048,11,1,3,0,2
69034,808,25,783,768,3,4,1,0,0
69036,58,6,52,48,1,0,0,0,0
69037,82,4,78,71,1,3,0,0,0
69038,408,13,395,375,2,1,0,0,0
69039,152,7,145,137,1,1,0,0,0
69040,516,6,510,494,0,0,0,2,0
69041,102,3,99,97,0,0,0,0,0
69042,11,2,9,9,0,0,0,0,0
69043,493,23,470,455,0,0,1,1,0
69044,792,23,769,751,0,0,0,1,0
69045,867,56,811,787,5,1,3,0,0
69046,182,2,180,174,1,1,0,0,0
69101,28589,2620,25969,24192,367,138,310,6,92
69120,954,39,915,894,3,0,2,0,0
69121,315,6,309,298,3,0,0,0,0
69122,671,48,623,600,0,7,1,0,3
69123,863,24,839,802,2,1,4,0,0
69125,258,29,229,215,1,4,0,0,2
69127,723,55,668,642,0,3,4,2,0
69128,319,9,310,293,0,5,0,0,1
69129,1271,55,1216,1186,1,0,6,0,4
69130,5178,723,4455,4192,27,9,54,23,11
69131,543,13,530,518,0,0,0,0,0
69132,105,13,92,85,0,1,1,0,1
69133,305,24,281,271,0,3,0,0,1
69134,321,4,317,302,5,0,1,0,0
69135,16,0,16,16,0,0,0,0,0
69138,4323,225,4098,3928,12,11,9,0,15
69140,1674,93,1581,1530,4,2,1,1,1
69141,334,22,312,296,1,1,0,0,1
69142,113,12,101,100,0,0,0,0,0
69143,1420,89,1331,1290,2,4,5,0,0
69144,204,9,195,189,0,1,0,0,0
69145,2841,234,2607,2484,1,16,17,0,7
69146,313,10,303,284,0,2,3,0,0
69147,643,28,615,570,3,1,2,0,8
69148,203,10,193,184,2,0,1,0,1
69149,655,15,640,622,2,0,0,0,3
69150,504,20,484,461,4,1,1,2,0
69151,709,29,680,659,2,0,2,0,0
69152,880,11,869,832,4,1,1,0,0
69153,5914,602,5312,5074,15,13,28,5,12
69154,1168,68,1100,1068,0,2,1,1,4
69155,984,62,922,872,0,0,0,0,1
69156,682,26,656,629,3,2,0,0,0
69157,98,2,96,94,0,0,0,0,0
69161,103,16,87,80,0,2,0,0,1
69162,7414,683,6731,6323,45,26,75,0,35
69163,853,29,824,772,0,0,5,0,0
69165,1746,100,1646,1591,1,2,2,0,4
69166,587,8,579,571,0,1,0,0,1
69167,292,2,290,276,0,4,1,0,0
69168,259,34,225,222,0,0,0,0,1
69169,590,72,518,489,5,0,0,0,10
69170,381,42,339,314,2,1,1,0,4
69171,25,4,21,20,0,0,0,0,0
69201,4143,126,4017,3267,10,542,7,0,4
69210,2197,157,2040,1968,2,7,5,0,0
69211,286,8,278,259,0,5,0,0,0
69212,540,11,529,212,1,280,4,0,1
69214,242,6,236,231,0,0,1,0,0
69216,178,0,178,133,0,32,0,0,0
69217,526,15,511,490,0,0,0,0,2
69218,251,7,244,217,1,9,0,0,0
69219,72,3,69,63,0,6,0,0,0
69220,77,5,72,63,0,3,0,0,0
69221,114,2,112,111,0,1,0,0,0
69301,9632,1191,8441,7591,64,287,68,0,14
69331,95,5,90,85,1,0,0,0,0
69333,291,5,286,283,0,1,1,0,0
69334,2111,254,1857,1760,8,26,8,0,5
69335,50,0,50,48,0,0,0,0,0
69336,2216,373,1843,1774,7,8,13,0,6
69337,6541,268,6273,5399,162,338,51,6,18
69339,1339,54,1285,1229,1,9,2,0,3
69340,100,2,98,87,0,0,0,0,0
69341,11091,2099,8992,8292,75,153,64,7,42
69343,2359,119,2240,1844,6,252,14,2,3
69345,433,32,401,385,0,5,0,0,0
69346,546,20,526,506,0,1,4,0,0
69347,1330,25,1305,1198,3,42,7,0,4
69348,1430,58,1372,1300,2,10,3,0,3
69350,346,9,337,327,1,5,0,0,0
69351,195,4,191,184,0,3,1,0,1
69352,572,118,454,430,0,6,4,0,3
69353,42,4,38,38,0,0,0,0,0
69354,76,3,73,72,1,0,0,0,0
69355,108,13,95,91,0,0,1,0,0
69356,1718,332,1386,1316,1,9,2,1,2
69357,3465,520,2945,2758,2,13,25,0,13
69358,1870,219,1651,1585,1,5,8,3,1
69360,1212,72,1140,869,6,201,7,0,2
69361,17526,4891,12635,11504,155,281,172,16,41
69365,53,4,49,26,0,22,0,0,0
69366,234,6,228,216,4,6,0,0,1
69367,245,5,240,223,0,3,0,0,0
70001,40068,7207,32861,24238,5819,81,1146,8,231
70002,19857,4167,15690,10882,2800,38,1248,4,124
70003,40068,7962,32106,24382,4662,84,1336,5,222
70005,25431,3647,21784,19386,891,18,659,5,120
70006,16540,4178,12362,9223,1445,20,1067,2,106
70030,4365,124,4241,3735,312,48,6,0,5
70031,1290,61,1229,654,532,7,0,1,2
70032,4533,645,3888,2739,721,15,133,0,40
70036,1057,41,1016,891,43,8,1,0,1
70037,16262,1813,14449,11152,1835,114,481,35,108
70038,197,24,173,97,34,1,11,0,1
70039,2800,186,2614,910,1604,7,14,0,5
70040,1200,116,1084,408,637,1,3,0,9
70041,2675,174,2501,1322,440,43,466,3,32
70043,21596,3244,18352,10975,5573,90,633,6,182
70047,12783,1114,11669,8458,2514,35,166,11,50
70049,1975,13,1962,93,1763,1,1,1,3
70050,28,13,15,4,8,0,0,0,0
70051,1777,34,1743,859,819,3,0,0,1
70052,3162,48,3114,1611,1400,7,12,0,7
70053,16509,3231,13278,6438,5742,81,375,6,112
70056,41498,8994,32504,12929,15309,76,2548,22,273
70057,4201,187,4014,1602,2297,16,19,0,7
70058,41377,5258,36119,8866,22826,98,2949,10,222
70062,16627,4542,12085,5167,6054,54,278,9,99
70065,51484,15688,35796,22382,8524,68,2890,14,359
70067,2823,151,2672,2311,28,60,38,0,9
70068,33213,3004,30209,10952,17762,93,311,4,143
70070,13769,1079,12690,9778,2127,57,158,5,53
70071,3205,43,3162,1437,1660,4,8,0,9
70072,56924,6060,50864,22661,22465,360,3155,7,226
70075,5382,699,4683,3519,751,29,128,0,15
70076,276,13,263,92,167,0,0,0,0
70079,2970,177,2793,2431,208,4,15,0,7
70080,1417,137,1280,1049,163,10,12,1,4
70082,832,23,809,124,663,0,4,0,2
70083,2307,105,2202,633,1243,93,67,2,40
70084,6411,333,6078,2699,3200,24,14,2,6
70085,4576,789,3787,3115,463,31,19,0,14
70086,1782,37,1745,129,1575,3,3,0,1
70087,7244,971,6273,2889,2968,13,153,2,22
70090,7152,133,7019,2893,3962,9,1,0,13
70091,180,12,168,125,13,4,9,0,2
70092,7502,584,6918,2716,3850,49,59,0,31
70094,30638,3730,26908,11252,13498,175,918,5,134
70112,4988,365,4623,1850,2230,18,346,0,40
70113,8569,826,7743,1550,5670,19,151,3,27
70114,23127,2022,21105,3999,16041,35,177,16,105
70115,31736,2512,29224,19528,7690,64,644,7,149
70116,10676,712,9964,4771,4539,38,89,4,84
70117,28528,1602,26926,7599,17879,61,167,9,180
70118,35635,4821,30814,18211,10328,88,813,32,179
70119,38048,4622,33426,14522,16648,85,489,15,233
70121,11523,1551,9972,6981,2358,26,156,5,44
70122,34986,2182,32804,6655,23966,58,540,6,311
70123,27346,2620,24726,19463,3434,54,758,3,93
70124,22777,2065,20712,18240,833,25,704,7,88
70125,17457,1474,15983,5999,8976,39,263,3,98
70126,30397,1444,28953,1293,26718,38,153,6,117
70127,24332,682,23650,460,22309,41,308,7,104
70128,18260,460,17800,315,15914,20,1104,0,67
70129,10884,1865,9019,837,4926,17,3016,1,43
70130,14521,1260,13261,8667,3315,41,454,1,80
70131,27473,1989,25484,6245,17193,49,1072,8,144
70139,0,0,0,0,0,0,0,0,0
70148,1603,114,1489,644,701,25,83,0,26
70163,0,0,0,0,0,0,0,0,0
70301,46661,1964,44697,31167,11483,361,309,17,95
70310,383,22,361,13,341,0,1,0,0
70339,5332,160,5172,5057,13,9,10,0,0
70340,81,9,72,7,64,0,1,0,0
70341,3239,90,3149,1009,2097,2,2,0,0
70342,4806,396,4410,3623,516,45,26,3,7
70343,5059,237,4822,4089,81,369,23,1,1
70344,5218,154,5064,4246,345,234,30,0,9
70345,9119,834,8285,7273,114,364,167,1,17
70346,10342,395,9947,2850,6871,1,18,0,21
70352,233,9,224,213,4,3,1,0,0
70353,1106,70,1036,502,37,394,25,0,0
70354,4396,559,3837,3294,105,242,25,0,0
70355,920,25,895,859,16,7,0,0,0
70356,2298,80,2218,1042,1032,56,4,0,7
70357,2419,140,2279,1886,31,230,12,0,1
70358,1005,30,975,929,2,15,6,0,4
70359,9591,539,9052,5697,2489,332,50,1,47
70360,28014,1530,26484,19719,4404,685,472,12,91
70363,25319,2588,22731,11994,6809,2217,399,8,54
70364,29559,2345,27214,20017,4317,1141,281,20,90
70372,2323,118,2205,1566,574,12,7,0,3
70373,6490,604,5886,4926,283,269,143,2,13
70374,6699,388,6311,5658,251,111,18,1,1
70375,198,7,191,188,2,0,0,0,0
70377,3702,64,3638,2494,76,776,10,2,2
70380,21079,3289,17790,12931,3279,230,482,7,46
70390,6593,256,6337,3458,2709,22,11,0,6
70391,104,1,103,81,15,0,0,0,0
70392,8406,440,7966,4518,2905,90,61,1,51
70393,421,23,398,218,169,0,3,0,1
70394,13932,574,13358,9778,2907,192,57,5,17
70395,4843,256,4587,3573,660,117,23,0,10
70397,1240,44,1196,942,33,134,3,0,5
70401,21014,1329,19685,10273,8419,66,267,5,49
70402,1634,71,1563,661,832,2,9,0,6
70403,29737,1760,27977,16283,10205,99,290,7,95
70420,8030,700,7330,6429,403,20,55,3,53
70422,13863,519,13344,6968,5904,28,61,2,33
70426,6094,153,5941,3914,1870,21,4,0,4
70427,17941,564,17377,10508,6072,49,108,0,39
70431,5173,255,4918,4693,36,13,11,5,19
70433,41423,3596,37827,31455,3856,95,640,13,194
70435,20828,1522,19306,16600,1618,59,123,6,62
70436,450,1,449,86,359,1,0,0,0
70437,7575,504,7071,6140,624,15,15,0,34
70438,19652,677,18975,13957,4285,54,53,0,42
70441,5006,102,4904,1672,3031,24,9,2,15
70442,468,16,452,408,14,5,2,0,0
70443,10229,787,9442,5870,3144,23,21,3,26
70444,9667,190,9477,5625,3503,26,26,1,20
70445,10866,870,9996,7087,1944,67,78,4,124
70446,7255,323,6932,5821,789,13,15,1,14
70447,17120,1231,15889,14358,631,39,172,0,78
70448,25670,2258,23412,20810,991,51,296,10,121
70449,3470,77,3393,3183,93,10,12,0,11
70450,2778,75,2703,1950,664,16,2,0,2
70451,192,22,170,72,86,2,3,0,0
70452,13187,780,12407,10782,773,69,78,6,40
70453,1122,16,1106,761,298,3,3,1,3
70454,32154,1671,30483,23904,4864,104,201,5,116
70455,2017,168,1849,1543,165,9,13,0,10
70456,2741,43,2698,1142,1465,8,8,0,1
70457,221,70,151,133,2,2,3,3,0
70458,37798,2850,34948,24831,7196,157,768,22,185
70460,22429,2010,20419,11766,6908,104,182,15,174
70461,30740,2290,28450,17610,8354,108,887,7,185
70462,5490,191,5299,4315,744,4,25,1,18
70463,98,2,96,73,20,1,1,0,0
70464,220,17,203,177,4,3,2,0,0
70465,425,9,416,34,362,1,1,0,0
70466,8856,731,8125,5450,2262,34,38,0,19
70471,23334,1871,21463,19409,574,74,497,11,81
70501,28721,926,27795,6101,20661,66,140,8,86
70503,27497,1554,25943,21461,2227,107,1235,13,97
70506,39801,3858,35943,23736,9174,105,1386,8,162
70507,17791,1044,16747,8012,7913,41,160,5,83
70508,40343,2594,37749,30066,4950,102,1132,6,148
70510,24074,1155,22919,15573,5662,76,872,4,89
70512,10146,184,9962,7993,1709,18,21,2,16
70513,134,8,126,107,9,1,0,0,1
70514,1843,37,1806,661,1031,22,9,0,4
70515,3407,396,3011,2449,388,9,48,0,10
70516,1579,72,1507,1291,168,6,3,0,5
70517,26434,1049,25385,16621,7577,105,239,2,104
70518,16683,889,15794,11952,2584,72,532,10,81
70519,122,10,112,40,53,0,11,0,1
70520,20017,949,19068,11785,6471,60,121,8,75
70522,234,4,230,121,84,9,1,0,3
70523,744,19,725,271,222,188,1,0,1
70524,217,8,209,102,98,0,1,0,2
70525,13232,569,12663,9516,2667,24,29,0,29
70526,17333,534,16799,11887,4310,35,72,0,22
70528,2255,129,2126,1746,256,22,1,0,5
70529,11842,1129,10713,8101,2062,27,62,1,42
70531,1373,21,1352,1326,2,5,2,0,4
70532,2560,86,2474,1431,600,237,17,0,14
70533,7282,285,6997,6309,334,31,116,0,12
70534,725,20,705,654,32,6,0,0,1
70535,17292,451,16841,12121,4036,30,112,0,59
70537,452,13,439,434,2,0,0,0,0
70538,12604,520,12084,5561,5850,137,73,2,65
70541,733,21,712,229,466,1,0,0,0
70542,3063,46,3017,2790,179,0,1,3,9
70543,3883,130,3753,3550,115,10,3,0,3
70544,10775,350,10425,4089,5642,268,81,1,28
70546,16277,381,15896,12233,2967,59,70,3,48
70548,10004,290,9714,8520,767,25,66,1,24
70549,3836,68,3768,3261,341,7,7,1,9
70550,222,13,209,77,116,1,0,0,0
70551,336,3,333,169,158,1,0,0,2
70552,1226,46,1180,979,149,6,2,0,2
70554,5540,154,5386,3404,1692,6,22,0,25
70555,8925,352,8573,7488,645,12,157,1,19
70556,545,8,537,433,72,2,0,0,0
70558,140,16,124,110,4,0,2,0,0
70559,2250,28,2222,2145,27,6,2,0,1
70560,39457,2425,37032,19519,14804,121,1263,2,153
70563,19145,1019,18126,13877,3269,81,293,0,44
70570,38746,967,37779,13493,22915,65,220,5,158
70575,48,5,43,31,0,0,9,0,0
70576,1422,314,1108,966,111,2,2,0,2
70577,4424,83,4341,3416,780,9,11,0,15
70578,16201,389,15812,11946,3239,43,60,3,51
70580,202,8,194,154,29,2,0,0,0
70581,934,29,905,738,130,1,2,0,5
70582,19088,396,18692,11666,6384,34,149,1,48
70583,11981,1533,10448,7792,2085,46,77,2,43
70584,7471,329,7142,4680,2188,29,17,1,18
70585,243,7,236,232,0,1,0,0,0
70586,19589,398,19191,12393,6136,26,107,2,42
70589,3464,60,3404,2370,936,7,3,1,4
70591,5529,112,5417,4377,785,11,13,0,19
70592,28975,1625,27350,22765,2639,108,715,6,87
70601,34571,1481,33090,9484,21889,129,264,19,183
70605,39903,2545,37358,29457,4213,159,1907,57,198
70607,30339,1988,28351,14169,11950,132,665,29,168
70609,260,25,235,121,75,2,24,0,0
70611,22457,974,21483,18577,1602,110,226,3,64
70615,14949,635,14314,6029,7696,31,65,2,65
70629,19,0,19,8,8,0,0,0,1
70630,1370,75,1295,1196,30,4,5,0,13
70631,823,16,807,758,22,8,1,1,1
70632,315,10,305,285,17,1,0,0,0
70633,8989,189,8800,7120,1313,63,25,2,5
70634,25039,1060,23979,18719,3557,188,225,29,76
70637,554,5,549,522,5,3,1,0,3
70638,798,17,781,701,16,21,4,0,1
70639,575,26,549,499,5,12,4,1,0
70640,155,6,149,60,75,0,0,0,1
70643,224,13,211,206,2,0,0,0,0
70644,254,3,251,227,0,4,0,0,3
70645,926,22,904,879,0,5,1,0,0
70646,837,26,811,783,10,4,0,0,1
70647,11386,331,11055,8274,2189,48,52,6,57
70648,7198,723,6475,4956,971,165,78,2,10
70650,452,7,445,414,12,2,0,0,1
70651,287,4,283,265,1,3,0,0,0
70652,2557,65,2492,2358,18,21,5,2,6
70653,3005,74,2931,2563,172,22,5,0,7
70654,207,1,206,195,1,1,0,0,0
70655,2414,104,2310,1436,716,32,17,3,10
70656,3824,142,3682,3316,52,84,12,1,21
70657,5533,135,5398,5075,106,42,9,0,8
70658,888,18,870,822,11,6,5,0,1
70659,1350,125,1225,1048,96,18,7,2,0
70660,1648,49,1599,1505,17,9,1,0,6
70661,2179,22,2157,2024,56,15,1,0,0
70662,485,18,467,399,11,9,3,1,2
70663,29325,1850,27475,23821,2079,116,229,9,49
70665,12532,603,11929,10720,522,54,247,8,36
70668,6576,379,6197,5062,767,47,31,0,21
70669,9830,520,9310,7651,1215,24,72,2,19
70706,22476,978,21498,19002,1354,68,127,9,41
70710,6749,276,6473,3426,2678,9,106,2,12
70711,5243,267,4976,4366,393,3,6,0,8
70712,5627,424,5203,4252,864,74,0,0,0
70714,18954,652,18302,4816,12939,31,52,5,63
70715,899,66,833,451,362,6,0,0,4
70719,4396,236,4160,2543,1479,3,21,0,16
70721,643,5,638,56,558,0,0,0,7
70722,5569,88,5481,3304,2008,14,21,0,14
70723,1335,21,1314,387,898,3,2,0,0
70725,1743,46,1697,416,1234,2,3,0,3
70726,59586,5227,54359,44064,6815,165,701,19,179
70729,967,41,926,645,229,3,1,1,3
70730,3613,45,3568,2110,1340,11,4,1,9
70732,1110,12,1098,895,174,0,3,0,2
70733,1670,39,1631,1519,18,6,19,0,7
70734,8384,677,7707,5004,2193,26,148,0,25
70736,513,16,497,319,153,0,1,0,2
70737,47332,4950,42382,27963,12348,118,418,18,135
70739,12890,602,12288,10490,1166,21,107,1,30
70740,1181,16,1165,945,190,8,3,0,0
70743,397,6,391,384,1,1,0,0,0
70744,5667,283,5384,4888,202,16,8,1,9
70747,194,8,186,51,129,0,2,0,3
70748,6564,203,6361,3790,2379,25,11,6,12
70749,1339,53,1286,1062,175,1,0,0,1
70750,1321,28,1293,1224,7,5,2,0,2
70752,763,48,715,573,108,2,0,0,4
70753,730,26,704,347,344,3,2,0,2
70754,11966,379,11587,10798,284,26,50,1,17
70755,1715,59,1656,1452,143,1,3,0,5
70756,510,24,486,312,147,3,0,0,1
70757,3056,66,2990,1343,1583,4,1,0,0
70759,1239,83,1156,716,398,1,3,0,6
70760,6509,87,6422,2173,4051,4,42,1,18
70761,806,5,801,426,353,1,1,0,4
70762,1034,38,996,908,63,1,1,0,2
70763,4129,71,4058,3317,666,3,2,0,2
70764,15616,531,15085,8386,6232,34,53,9,29
70767,15309,699,14610,7598,6425,46,92,6,39
70769,46671,3667,43004,33433,6668,83,1065,11,146
70770,3816,105,3711,3377,135,21,14,0,5
70772,635,1,634,370,244,1,4,0,1
70773,119,10,109,61,41,0,0,0,2
70774,9900,449,9451,8986,127,29,9,2,19
70775,9405,222,9183,6200,2599,20,30,5,32
70776,5891,680,5211,2852,2153,5,59,1,29
70777,4387,76,4311,3052,1071,13,12,2,7
70778,2950,236,2714,1645,955,10,23,1,9
70780,957,29,928,469,435,1,3,0,0
70782,191,5,186,111,68,1,0,0,0
70783,2422,54,2368,1839,450,10,2,0,5
70785,22569,987,21582,19343,1086,53,161,5,55
70786,12,2,10,10,0,0,0,0,0
70787,86,0,86,21,58,0,0,0,0
70788,3692,123,3569,1196,2299,8,0,3,9
70789,405,9,396,100,281,0,3,0,2
70791,29432,832,28600,14240,12977,54,325,7,75
70801,340,16,324,213,64,0,36,0,3
70802,26519,1098,25421,5987,18131,42,489,18,82
70803,3587,196,3391,2643,539,7,137,3,1
70805,26025,460,25565,843,24058,47,44,1,56
70806,27898,1600,26298,12307,12803,55,324,7,94
70807,16091,208,15883,361,15229,15,10,0,16
70808,32510,1891,30619,22861,5397,45,1145,8,105
70809,25302,1723,23579,16671,4756,41,1204,4,80
70810,42472,3662,38810,23148,11986,68,2248,1,161
70811,13116,419,12697,1233,11152,8,36,0,23
70812,10976,413,10563,314,10068,12,4,5,14
70813,1753,25,1728,24,1676,0,0,0,20
70814,14061,659,13402,1128,11818,20,172,0,31
70815,29376,3114,26262,8768,14330,55,2315,9,128
70816,45232,6107,39125,16733,18308,76,2322,14,246
70817,35025,2159,32866,23630,6388,58,1439,9,145
70818,10492,542,9950,7453,2012,23,95,2,41
70819,5104,891,4213,1163,2700,14,188,0,30
70820,23470,3090,20380,11265,6492,56,1626,12,109
70825,0,0,0,0,0,0,0,0,0
70836,535,52,483,316,104,0,50,0,0
71001,4159,98,4061,1443,2455,14,17,2,12
71002,194,6,188,165,18,2,0,0,0
71003,857,16,841,600,213,0,5,0,1
71004,526,17,509,291,207,1,0,0,1
71006,15268,668,14600,11989,1606,81,147,11,38
71007,908,12,896,611,242,2,2,0,10
71008,592,4,588,384,177,0,1,0,1
71009,201,7,194,160,6,5,0,0,1
71016,1929,23,1906,1530,251,18,5,2,1
71018,1330,31,1299,795,425,19,2,0,5
71019,7362,185,7177,4035,2814,39,0,1,19
71021,471,10,461,69,384,0,0,0,2
71023,3235,95,3140,2609,379,19,18,0,2
71024,1207,47,1160,780,307,4,2,0,1
71027,1861,32,1829,1178,536,16,7,0,5
71028,1351,31,1320,392,878,2,0,0,0
71029,188,13,175,101,68,2,0,0,0
71030,1514,46,1468,805,557,26,4,0,0
71031,995,23,972,922,16,9,0,1,4
71032,1996,58,1938,1259,596,15,4,0,5
71033,3581,176,3405,2197,929,28,31,0,48
71034,278,4,274,202,58,6,0,0,0
71037,21469,1307,20162,15779,2943,145,155,10,93
71038,3321,54,3267,1562,1568,13,2,0,7
71039,1716,37,1679,1196,399,11,0,0,1
71040,8288,378,7910,3730,3948,24,29,0,3
71043,412,3,409,297,92,3,0,0,2
71044,684,4,680,579,81,1,1,1,0
71045,656,9,647,582,45,3,3,1,1
71046,1183,50,1133,741,328,8,1,0,3
71047,10698,331,10367,7681,2084,93,40,5,17
71048,106,1,105,49,55,0,0,0,0
71049,3108,93,3015,2111,742,19,2,0,20
71051,2025,71,1954,1596,223,10,8,1,12
71052,9409,218,9191,2733,6112,54,41,0,16
71055,18626,302,18324,9889,7703,53,70,11,39
71060,2919,137,2782,2320,222,24,8,6,10
71061,1518,20,1498,1034,380,9,3,1,4
71063,659,15,644,367,254,3,3,0,3
71064,4262,78,4184,2208,1851,5,5,0,5
71065,1072,27,1045,679,310,19,0,0,5
71066,38,3,35,2,31,0,0,0,0
71067,3435,354,3081,2116,697,18,16,1,12
71068,3292,58,3234,1903,1160,13,2,0,2
71069,519,26,493,352,106,5,4,0,3
71070,1358,14,1344,1029,248,2,0,2,3
71071,2335,33,2302,2116,105,8,1,0,0
71072,1383,14,1369,1232,69,0,3,0,3
71073,2154,57,2097,1381,624,20,6,1,0
71075,5844,86,5758,3578,1921,11,36,0,25
71078,6958,247,6711,5763,519,93,37,0,21
71079,173,1,172,108,58,1,0,0,0
71082,4395,80,4315,2727,1340,19,31,0,5
71101,6560,311,6249,1343,4565,26,43,2,44
71103,6362,109,6253,465,5620,4,7,1,10
71104,13680,955,12725,7262,4360,57,325,15,69
71105,21308,1054,20254,14829,3734,89,609,24,81
71106,34906,1247,33659,17987,13752,108,651,13,89
71107,31311,954,30357,13693,15300,114,120,15,89
71108,17727,401,17326,1728,14909,42,69,4,64
71109,18414,279,18135,961,16548,55,55,2,47
71110,1951,304,1647,1113,253,9,53,16,14
71111,44476,3716,40760,24768,12652,140,1173,23,150
71112,32561,3529,29032,17845,8446,151,641,47,144
71115,15436,595,14841,10163,3110,59,916,24,54
71118,24582,795,23787,9111,13523,88,249,9,100
71119,10724,387,10337,2910,7020,24,82,2,50
71129,13198,668,12530,4164,7729,51,76,0,70
71201,21565,573,20992,11650,8105,35,577,3,67
71202,27535,1118,26417,2483,22922,39,257,4,63
71203,37438,856,36582,16122,18478,67,694,8,94
71209,1091,35,1056,629,355,8,31,1,0
71212,10,0,10,3,5,0,0,0,0
71218,62,2,60,51,9,0,0,0,0
71219,1148,10,1138,1031,81,1,2,0,1
71220,21154,299,20855,9503,10452,68,83,2,26
71222,3050,314,2736,1647,989,7,7,1,4
71223,358,19,339,156,168,1,2,0,1
71225,8179,148,8031,7216,381,24,29,0,18
71226,1493,16,1477,1044,374,7,7,0,0
71227,4127,149,3978,3475,316,9,22,0,4
71229,1924,30,1894,1171,658,9,5,1,2
71230,4,0,4,2,2,0,0,0,0
71232,6073,137,5936,3097,2686,21,12,0,9
71233,254,9,245,214,23,0,0,0,0
71234,4298,128,4170,3861,152,15,11,1,7
71235,4309,102,4207,3466,574,13,12,0,3
71237,1028,33,995,672,283,7,1,0,1
71238,2924,66,2858,2566,137,10,7,0,0
71241,9535,534,9001,6206,2504,24,17,3,11
71242,23,3,20,20,0,0,0,0,0
71243,157,5,152,126,21,1,0,0,0
71245,4849,28,4821,22,4702,5,4,0,4
71247,847,18,829,383,384,1,12,0,2
71250,138,9,129,86,30,1,0,0,0
71251,8286,333,7953,4753,2805,14,115,5,14
71253,281,2,279,247,20,1,0,0,0
71254,6755,86,6669,1573,4967,2,17,0,2
71256,568,13,555,272,258,0,0,0,0
71259,1686,26,1660,1266,329,5,3,0,5
71260,2653,93,2560,1791,673,15,7,0,6
71261,1449,19,1430,848,530,4,0,1,1
71263,7103,240,6863,5905,774,18,6,0,0
71264,947,9,938,703,177,1,0,0,5
71266,1588,60,1528,1121,343,13,6,0,0
71268,2737,37,2700,2310,279,10,9,0,3
71269,12343,242,12101,7303,4364,33,36,0,47
71270,31513,1284,30229,16677,11836,71,586,5,93
71272,2400,90,2310,1650,549,30,56,0,0
71275,2367,128,2239,1268,823,22,1,0,7
71276,219,10,209,88,115,0,0,0,0
71277,1564,60,1504,1031,409,5,4,1,0
71279,45,0,45,21,24,0,0,0,0
71280,4708,139,4569,3611,714,4,33,0,22
71282,9131,192,8939,2658,6075,24,6,5,4
71286,443,16,427,348,70,0,0,0,3
71291,34670,1311,33359,26736,4605,107,514,8,87
71292,22774,1428,21346,16790,3229,108,126,5,55
71295,14069,195,13874,8216,5269,19,30,0,12
71301,20454,691,19763,7127,11472,74,357,2,69
71302,13415,187,13228,2314,10399,35,46,6,52
71303,22797,990,21807,12617,7496,87,737,9,78
71316,66,0,66,65,0,0,0,0,0
71320,156,2,154,150,0,0,2,0,0
71322,5913,186,5727,2905,2517,22,16,0,18
71323,1048,19,1029,989,5,2,2,0,0
71325,1008,20,988,523,424,1,0,0,5
71326,1131,28,1103,513,554,5,3,0,0
71327,5676,851,4825,2544,1886,30,237,1,31
71328,7891,146,7745,7254,46,50,19,0,13
71330,76,2,74,66,1,0,0,0,0
71331,974,11,963,935,3,0,2,0,0
71333,576,20,556,353,154,6,3,0,2
71334,8518,227,8291,2990,5049,19,57,0,4
71336,1499,13,1486,1202,214,0,0,0,0
71339,75,0,75,61,6,3,2,0,0
71340,847,34,813,722,67,1,1,2,0
71341,3096,68,3028,2597,296,20,8,0,6
71342,8100,1061,7039,5515,1093,67,108,7,14
71343,7260,540,6720,4724,1772,33,22,4,6
71345,74,3,71,12,54,0,0,0,1
71346,2598,128,2470,1553,761,26,15,0,7
71350,4228,49,4179,2473,1437,32,15,1,5
71351,11068,171,10897,6960,3101,187,41,0,39
71353,1500,13,1487,1005,441,2,0,3,4
71354,1587,12,1575,1521,21,3,1,0,0
71355,2537,51,2486,1898,463,17,5,1,7
71356,345,11,334,224,102,1,2,0,0
71357,1595,29,1566,731,783,0,1,1,5
71358,967,17,950,395,510,2,5,0,4
71359,29,2,27,7,14,0,1,0,1
71360,36026,1186,34840,25237,6986,234,425,12,141
71362,2221,53,2168,2027,62,16,6,0,2
71366,1579,20,1559,730,787,0,4,0,5
71367,1222,34,1188,1058,79,0,1,0,12
71368,1287,17,1270,662,562,4,3,0,4
71369,2308,29,2279,1187,1002,14,8,0,3
71371,2055,15,2040,1912,47,28,1,1,2
71373,6700,207,6493,4503,1727,12,54,0,12
71375,968,18,950,267,657,0,1,0,1
71378,2149,36,2113,1300,763,0,5,0,4
71401,73,2,71,68,0,0,0,0,0
71403,4348,136,4212,3801,56,74,36,7,11
71404,828,17,811,624,113,12,2,0,2
71405,5652,236,5416,4396,611,37,33,1,21
71406,193,6,187,159,4,7,4,0,0
71407,876,16,860,788,9,6,3,2,6
71409,6262,192,6070,4529,1215,72,27,0,10
71410,153,0,153,107,38,3,0,0,0
71411,2536,62,2474,1423,870,42,0,0,8
71414,249,0,249,24,216,3,0,0,0
71415,308,12,296,192,94,4,1,0,0
71416,724,21,703,393,189,22,2,0,40
71417,4691,86,4605,3050,1384,12,5,0,13
71418,5625,146,5479,4422,844,10,30,2,6
71419,2049,49,2000,1690,63,143,2,2,4
71422,1469,15,1454,1282,100,7,6,0,0
71423,5207,109,5098,4700,96,57,12,0,7
71424,1219,37,1182,1103,14,13,3,0,4
71425,189,2,187,183,0,0,0,0,0
71426,134,3,131,88,32,3,0,0,0
71427,329,6,323,290,7,8,0,0,3
71428,20,0,20,14,3,0,0,0,0
71429,2988,63,2925,2418,337,37,6,1,10
71430,2423,688,1735,1572,60,15,33,0,3
71432,1042,23,1019,961,8,10,0,0,0
71433,4149,386,3763,3103,360,78,73,2,24
71434,45,2,43,37,3,2,0,0,0
71435,3801,63,3738,3075,553,6,8,0,1
71438,1595,36,1559,1454,11,22,8,0,6
71439,1712,21,1691,1613,14,9,1,4,0
71441,701,7,694,620,38,1,4,1,0
71446,22095,1498,20597,15046,3424,211,405,90,140
71447,1296,33,1263,924,170,97,7,1,10
71449,9354,237,9117,6365,1991,287,30,4,41
71450,929,36,893,783,50,22,1,0,2
71452,42,0,42,13,13,1,0,0,9
71454,2251,31,2220,1804,277,19,2,2,2
71455,178,7,171,140,11,4,2,0,3
71456,1058,25,1033,418,519,4,3,0,41
71457,25506,888,24618,10807,12436,152,113,11,175
71459,10086,1871,8215,5456,1584,51,250,168,65
71461,2144,214,1930,783,837,27,116,9,23
71462,1599,90,1509,809,23,508,6,1,2
71463,9630,1007,8623,5812,2237,106,72,2,39
71465,2894,55,2839,2653,58,21,1,2,5
71466,503,3,500,481,5,0,1,0,0
71467,8232,1069,7163,5486,1321,86,47,2,13
71468,536,28,508,422,39,9,0,0,6
71469,2953,105,2848,2460,205,32,4,1,5
71472,328,15,313,281,9,1,0,0,6
71473,452,8,444,424,5,2,2,0,0
71474,601,21,580,510,24,8,4,2,4
71475,5,1,4,3,0,0,0,0,0
71479,656,7,649,618,10,9,0,0,0
71480,1157,267,890,630,85,4,143,0,4
71483,9944,968,8976,5428,3021,46,161,16,20
71485,2545,60,2485,2178,182,25,13,1,6
71486,3962,200,3762,1887,788,777,14,4,6
71497,1509,319,1190,720,340,0,43,2,5
71601,13881,219,13662,1315,12003,24,30,3,27
71602,16112,416,15696,10093,4522,76,351,81,48
71603,30236,526,29710,9687,18871,88,256,5,82
71630,398,7,391,212,163,1,0,0,1
71631,621,18,603,440,143,1,0,0,0
71635,10907,258,10649,7333,2947,15,32,3,23
71638,3544,107,3437,1317,1992,13,13,0,15
71639,5603,475,5128,2023,2901,8,28,2,9
71640,2577,99,2478,619,1789,4,0,6,6
71642,524,16,508,387,102,0,2,0,3
71643,4614,184,4430,1798,2560,6,6,1,5
71644,543,70,473,129,325,0,1,0,1
71646,6220,725,5495,4473,830,9,9,3,6
71647,1684,300,1384,1079,239,5,1,0,1
71651,121,6,115,107,7,0,0,0,0
71652,974,39,935,800,99,4,1,0,4
71653,4443,315,4128,2270,1675,11,25,2,9
71654,4302,189,4113,1957,1941,23,31,0,2
71655,14458,551,13907,9182,4103,59,96,8,45
71658,534,80,454,239,195,0,1,0,0
71659,37,4,33,2,31,0,0,0,0
71660,853,19,834,693,106,6,1,0,0
71661,261,8,253,112,137,0,0,0,0
71662,93,21,72,36,22,0,1,0,0
71663,572,111,461,308,138,1,0,1,1
71665,5274,111,5163,4534,462,11,3,1,7
71666,43,4,39,32,7,0,0,0,0
71667,7203,352,6851,5682,796,16,16,6,10
71670,1168,71,1097,741,305,3,2,0,2
71671,8210,1242,6968,4187,2531,22,26,0,13
71674,587,26,561,456,79,4,0,0,1
71675,1751,61,1690,1180,453,3,1,1,6
71676,543,19,524,159,346,0,0,0,0
71677,175,6,169,34,125,4,0,0,0
71678,16,0,16,8,4,0,0,0,0
71701,17824,424,17400,9280,7229,33,108,8,33
71720,2195,56,2139,1354,630,7,6,1,4
71721,15,0,15,15,0,0,0,0,0
71722,42,3,39,16,22,0,0,0,0
71724,341,9,332,240,75,0,1,0,2
71725,430,11,419,146,247,0,3,0,4
71726,1139,20,1119,698,361,4,8,0,7
71728,64,3,61,43,18,0,0,0,0
71730,31103,1564,29539,17686,10512,69,257,9,92
71740,1526,35,1491,1129,304,4,3,0,1
71742,4639,140,4499,2229,2072,10,5,0,13
71743,3386,359,3027,1990,883,12,2,1,0
71744,3016,89,2927,2216,569,0,1,3,3
71745,119,0,119,52,67,0,0,0,0
71747,828,20,808,362,391,4,0,2,5
71748,112,3,109,98,9,0,0,0,0
71749,2368,59,2309,1710,498,13,5,1,9
71751,817,9,808,637,119,3,0,0,4
71752,878,9,869,449,372,0,3,0,2
71753,16000,617,15383,8785,5921,52,152,0,58
71758,389,16,373,284,66,2,5,0,0
71759,340,9,331,290,27,0,1,0,0
71762,2288,69,2219,1609,475,13,3,4,11
71763,1332,50,1282,977,263,2,0,0,3
71764,1743,21,1722,970,659,14,4,0,6
71765,1666,29,1637,841,742,6,2,0,1
71766,573,10,563,444,104,0,2,0,0
71770,2991,61,2930,1633,1205,1,0,0,8
71772,22,2,20,19,1,0,0,0,0
71801,14991,2569,12422,7207,4578,53,61,4,33
71820,67,7,60,52,1,0,1,0,0
71822,8035,241,7794,5708,1599,65,12,8,13
71823,66,2,64,58,0,2,0,0,0
71825,600,93,507,433,46,2,2,0,0
71826,1005,35,970,610,333,0,6,0,0
71827,632,14,618,432,157,11,0,0,0
71831,124,5,119,67,51,0,0,0,0
71832,10372,4651,5721,4529,311,171,48,240,13
71833,1948,109,1839,1711,12,33,0,0,0
71834,1363,29,1334,1139,119,9,2,0,0
71835,1162,44,1118,897,151,4,10,0,4
71836,2701,115,2586,1970,361,69,5,1,6
71837,5389,143,5246,4930,7,34,13,0,12
71838,851,50,801,414,347,8,6,0,0
71839,248,5,243,84,149,1,1,0,0
71841,898,174,724,626,1,34,3,0,4
71842,2046,473,1573,1362,40,45,5,1,4
71845,1842,37,1805,937,810,3,6,5,2
71846,2516,212,2304,1880,199,52,5,0,0
71847,582,42,540,464,52,1,0,1,0
71851,1919,241,1678,735,856,6,0,0,4
71852,9856,1240,8616,6355,1753,48,64,4,25
71853,363,9,354,199,135,6,0,0,0
71854,35580,1401,34179,21426,10647,202,189,4,127
71855,557,37,520,286,208,6,2,0,0
71857,5723,295,5428,3342,1821,21,39,0,9
71858,1526,46,1480,1051,355,10,5,0,3
71859,304,9,295,205,76,0,2,0,0
71860,2098,38,2060,1186,774,10,16,0,4
71861,2368,77,2291,2043,142,15,7,0,0
71862,600,35,565,322,211,8,2,0,4
71864,68,1,67,56,6,0,0,0,0
71865,231,19,212,125,67,5,0,0,0
71866,618,18,600,530,0,16,0,0,1
71901,29363,2367,26996,20905,3696,178,315,14,92
71909,17935,542,17393,16295,245,54,97,11,45
71913,46801,3747,43054,35288,3927,305,536,36,154
71921,3532,187,3345,3111,18,28,15,0,8
71922,128,11,117,96,5,0,0,0,1
71923,14138,519,13619,9171,3637,37,119,5,53
71929,4826,220,4606,4267,25,29,24,1,10
71933,1365,82,1283,1146,10,13,9,0,5
71935,810,64,746,694,0,11,5,1,0
71937,1895,61,1834,1617,1,52,4,2,0
71940,1417,27,1390,1211,116,8,1,0,3
71941,1888,38,1850,1759,4,12,4,0,1
71942,115,0,115,108,0,0,0,0,0
71943,4403,680,3723,3450,13,37,19,0,12
71944,660,172,488,426,0,14,0,0,2
71945,1302,43,1259,1156,5,29,1,0,0
71949,1844,18,1826,1713,6,9,2,0,3
71950,684,27,657,602,2,9,0,0,3
71952,94,9,85,82,0,1,0,0,0
71953,14090,535,13555,12166,32,236,104,6,46
71956,1826,86,1740,1459,112,4,2,6,3
71957,2966,89,2877,2680,9,37,12,3,7
71958,2327,84,2243,2025,82,16,2,0,1
71959,728,41,687,649,0,2,0,0,0
71960,1128,57,1071,989,2,9,5,1,1
71961,868,20,848,793,0,6,6,0,3
71962,685,32,653,447,170,1,0,0,0
71964,4179,187,3992,3624,58,44,19,0,4
71965,282,8,274,253,0,3,6,0,0
71968,4564,198,4366,3927,59,48,13,11,6
71969,290,6,284,252,0,8,1,0,0
71970,705,22,683,652,0,5,0,0,0
71971,440,36,404,373,5,6,0,0,1
71972,296,14,282,235,1,10,0,1,2
71973,1236,450,786,688,3,23,3,0,5
71998,802,37,765,570,155,8,13,2,3
71999,781,51,730,429,222,6,10,8,30
72001,445,7,438,402,1,1,1,0,6
72002,18477,2479,15998,11993,2908,79,126,7,60
72003,715,8,707,662,19,1,1,0,0
72004,956,75,881,162,705,1,3,0,0
72005,140,1,139,132,2,0,0,1,1
72006,2281,54,2227,1199,909,4,4,0,15
72007,9792,379,9413,8604,119,41,89,7,20
72010,5958,188,5770,5300,109,20,17,0,17
72011,4671,266,4405,4105,71,20,15,3,18
72012,13407,465,12942,11429,554,65,83,5,35
72013,1889,31,1858,1726,12,15,0,0,3
72014,54,1,53,47,1,0,1,0,0
72015,28597,1808,26789,22541,2523,152,195,16,87
72016,2967,98,2869,2638,76,6,10,0,14
72017,574,2,572,434,123,0,1,0,0
72019,28097,1254,26843,23688,1381,107,394,15,45
72020,3788,72,3716,3504,15,7,8,0,19
72021,3586,63,3523,1785,1550,6,22,1,17
72022,18206,1139,17067,12713,2938,70,437,7,64
72023,37321,1973,35348,31386,869,159,501,32,103
72024,3406,149,3257,2766,309,8,10,3,3
72025,816,22,794,725,0,6,0,0,0
72026,260,0,260,214,40,0,0,0,1
72027,1256,32,1224,1094,48,5,10,0,0
72028,19,0,19,19,0,0,0,0,0
72029,1758,79,1679,1018,578,17,4,2,7
72030,645,23,622,559,12,6,2,0,0
72031,7087,348,6739,6291,38,48,31,0,4
72032,34316,2591,31725,23566,5586,161,377,24,141
72034,47873,2938,44935,33444,7589,159,915,22,159
72035,1979,118,1861,897,216,3,41,1,37
72036,703,7,696,260,404,0,1,0,3
72038,104,1,103,95,7,0,0,0,0
72039,2254,52,2202,1911,166,14,3,0,1
72040,2804,44,2760,2378,277,5,3,0,3
72041,1243,12,1231,985,200,2,1,0,2
72042,4764,145,4619,3749,651,6,23,1,9
72044,868,8,860,803,3,8,3,1,5
72045,1163,36,1127,1030,10,7,9,1,3
72046,3965,177,3788,2476,1138,8,4,0,8
72047,1051,25,1026,954,8,4,0,0,1
72048,115,2,113,104,1,0,0,0,0
72051,499,7,492,473,1,2,0,0,0
72052,135,38,97,83,1,0,0,0,3
72053,183,2,181,5,175,0,0,0,0
72055,752,32,720,638,62,0,0,0,0
72057,1035,11,1024,909,55,2,0,0,0
72058,18525,514,18011,16600,197,92,69,8,24
72059,15,1,14,11,3,0,0,0,0
72060,703,37,666,610,9,3,8,0,3
72061,100,4,96,76,1,10,0,0,0
72063,1529,23,1506,1374,43,4,3,2,0
72064,2359,41,2318,1931,292,11,12,2,4
72065,5305,138,5167,4326,475,22,100,2,8
72066,126,1,125,113,11,0,0,0,0
72067,2503,35,2468,2349,7,16,7,0,2
72068,513,51,462,406,17,0,2,0,2
72069,1077,20,1057,435,593,4,1,2,5
72070,1842,54,1788,1674,27,10,2,0,3
72072,434,3,431,359,50,0,0,0,1
72073,1012,25,987,765,194,4,0,0,0
72074,127,0,127,118,5,0,0,0,2
72075,26,1,25,25,0,0,0,0,0
72076,38443,2518,35925,19653,12660,152,599,69,143
72079,599,33,566,504,21,2,3,0,1
72080,709,14,695,626,6,6,1,2,0
72081,7511,409,7102,6587,71,31,12,0,7
72082,1579,263,1316,970,226,6,10,0,4
72083,182,8,174,146,23,2,0,0,0
72084,1059,120,939,811,49,6,4,0,4
72085,296,5,291,266,0,3,0,0,0
72086,10673,637,10036,7932,1485,36,61,3,12
72087,1575,46,1529,1412,16,14,5,3,4
72088,2148,42,2106,1991,14,14,15,0,2
72099,753,137,616,444,96,16,30,0,3
72101,3008,31,2977,2554,251,2,12,1,4
72102,2557,99,2458,2286,18,7,5,2,5
72103,13739,2224,11515,7909,2672,60,154,9,42
72104,23456,903,22553,17684,3405,88,70,10,60
72106,5206,126,5080,4349,388,21,13,1,13
72107,170,11,159,23,126,1,1,0,0
72108,44,13,31,24,6,0,0,0,0
72110,11507,579,10928,8630,1388,80,50,3,19
72111,1369,25,1344,1245,10,17,5,0,7
72112,11065,373,10692,7523,2637,30,57,2,32
72113,25930,1116,24814,15983,6755,77,654,11,103
72114,10957,600,10357,2483,7214,26,82,9,32
72116,21715,845,20870,15404,3933,97,399,5,47
72117,13730,935,12795,3193,8940,31,88,9,61
72118,22582,2770,19812,10377,7898,99,107,7,101
72119,4,1,3,1,2,0,0,0,0
72120,34784,1661,33123,22609,7761,104,630,16,142
72121,2550,57,2493,2300,6,9,4,0,4
72122,1248,23,1225,1131,2,5,9,2,0
72123,308,5,303,245,36,2,5,0,0
72125,888,20,868,813,4,2,1,0,1
72126,3649,96,3553,3337,8,18,5,0,8
72127,2190,143,2047,1534,398,14,17,0,1
72128,785,12,773,736,17,1,1,0,0
72129,1283,18,1265,1135,78,0,2,0,2
72130,385,6,379,364,0,0,0,0,1
72131,4519,103,4416,4126,11,28,9,1,19
72132,3577,119,3458,2978,270,20,23,3,5
72133,29,2,27,25,0,0,0,0,0
72134,296,4,292,240,34,3,0,2,2
72135,2647,77,2570,2309,102,8,7,2,5
72136,1936,24,1912,1744,14,19,3,1,7
72137,2339,87,2252,2122,4,4,3,0,6
72139,184,8,176,166,0,0,1,0,1
72140,276,3,273,258,2,3,0,0,0
72141,519,8,511,481,2,7,0,0,1
72142,2385,75,2310,1509,676,15,12,1,3
72143,35111,1734,33377,28218,2631,131,460,16,110
72150,12218,247,11971,11123,233,61,62,2,12
72152,304,8,296,165,127,0,1,0,0
72153,2527,33,2494,2334,9,22,7,0,2
72156,557,10,547,507,15,1,0,0,1
72157,1508,35,1473,1250,129,11,2,1,0
72160,9422,440,8982,5272,3222,22,70,8,25
72165,77,2,75,72,0,0,0,0,0
72166,229,1,228,224,1,0,0,0,0
72167,1634,23,1611,1529,1,9,0,0,1
72168,1903,66,1837,937,860,1,6,0,0
72169,111,4,107,102,0,2,0,0,0
72170,199,19,180,170,2,0,1,0,3
72173,9888,356,9532,8764,85,74,37,4,31
72175,246,15,231,57,170,0,0,0,0
72176,9418,299,9119,8260,118,49,43,2,27
72178,40,0,40,36,0,1,0,0,0
72179,425,18,407,396,2,1,0,0,0
72180,90,3,87,4,71,3,8,0,0
72181,52,0,52,48,0,1,0,0,0
72182,68,1,67,66,0,0,0,0,0
72183,912,39,873,504,355,2,3,4,0
72199,61,17,44,19,9,1,2,0,0
72201,961,40,921,579,251,9,27,0,5
72202,10340,368,9972,4381,4947,31,221,4,29
72204,31564,4148,27416,4868,20900,75,432,17,148
72205,22888,1059,21829,13690,6398,50,636,2,108
72206,22974,1692,21282,9470,10716,74,168,8,66
72207,11036,306,10730,9043,1042,19,161,3,22
72209,31641,9020,22621,2848,18789,58,111,14,99
72210,16348,1822,14526,7406,6087,35,338,4,71
72211,24338,1243,23095,13722,5968,56,2233,7,88
72212,12612,367,12245,9520,1493,25,698,4,46
72223,25465,831,24634,17402,4003,83,2061,6,66
72227,11090,520,10570,7349,2505,23,226,9,51
72301,24479,570,23909,7007,16075,54,101,7,40
72311,90,0,90,62,26,0,0,0,0
72313,15,1,14,10,0,0,0,0,1
72315,20311,827,19484,9525,8943,39,166,3,69
72320,1625,44,1581,691,864,3,6,0,0
72322,87,4,83,60,23,0,0,0,0
72324,2097,29,2068,1882,71,12,2,4,6
72325,22,2,20,15,5,0,0,0,0
72326,2231,58,2173,1600,496,4,6,0,3
72327,1407,79,1328,709,569,9,2,0,0
72328,50,6,44,12,31,0,0,0,0
72329,4,0,4,2,2,0,0,0,0
72330,524,61,463,444,5,0,0,0,0
72331,2409,35,2374,611,1704,2,5,1,1
72332,74,0,74,13,59,0,0,0,0
72333,424,8,416,137,272,0,1,0,0
72335,16624,517,16107,5705,9954,56,91,0,26
72338,75,8,67,50,3,2,1,0,0
72339,116,8,108,24,80,0,0,0,0
72340,56,0,56,18,38,0,0,0,0
72341,197,8,189,68,117,0,0,0,0
72342,3977,72,3905,1193,2580,18,22,3,7
72346,486,25,461,305,122,0,12,0,3
72347,592,14,578,561,0,0,1,0,1
72348,2006,47,1959,908,968,9,3,2,3
72350,966,40,926,537,362,1,3,0,0
72351,784,16,768,673,66,3,0,0,2
72352,30,4,26,13,9,0,0,0,0
72353,71,3,68,59,8,1,0,0,0
72354,2088,107,1981,1648,233,6,0,0,4
72355,2117,45,2072,1165,845,5,4,0,2
72358,1565,63,1502,751,693,2,2,0,1
72359,405,19,386,23,353,0,0,0,0
72360,5301,116,5185,1703,3257,11,7,1,14
72364,16394,618,15776,8813,6072,38,206,7,49
72365,2817,76,2741,1920,687,1,0,0,2
72366,1729,17,1712,761,892,5,5,0,0
72367,60,1,59,41,12,1,0,0,1
72368,939,30,909,651,233,3,0,0,0
72369,8,0,8,5,2,0,0,0,0
72370,7717,243,7474,3230,3918,7,49,0,12
72372,1563,20,1543,1120,376,1,4,0,0
72373,974,22,952,349,560,3,0,0,0
72374,716,15,701,404,272,2,2,0,3
72376,1781,55,1726,980,672,5,5,0,0
72377,23,0,23,22,0,0,0,0,0
72379,33,3,30,21,7,0,0,0,0
72383,20,0,20,19,1,0,0,0,0
72384,761,32,729,174,523,2,1,0,0
72386,1600,41,1559,1394,104,1,2,0,1
72387,21,2,19,15,4,0,0,0,0
72389,241,7,234,92,141,0,0,0,0
72390,7351,106,7245,1748,5324,6,30,1,6
72391,33,4,29,29,0,0,0,0,0
72392,395,14,381,250,103,0,1,0,1
72394,425,8,417,188,205,1,6,0,1
72395,947,24,923,719,172,3,0,0,4
72396,12898,291,12607,9024,2990,23,101,1,35
72401,43127,3903,39224,25436,10858,103,617,13,132
72404,29344,1246,28098,21465,4537,67,810,29,68
72405,17109,832,16277,12835,2400,26,210,8,49
72410,421,21,400,392,0,0,0,1,0
72411,2406,53,2353,2142,72,10,7,2,3
72412,571,8,563,539,3,0,0,0,0
72413,578,3,575,524,2,8,2,1,0
72414,390,34,356,346,3,1,0,0,0
72415,1244,26,1218,1141,4,8,1,1,0
72416,5661,161,5500,5078,131,12,6,1,14
72417,5720,154,5566,5127,183,22,10,0,6
72419,1601,49,1552,1502,1,4,0,0,0
72421,547,22,525,487,1,8,1,0,1
72422,4377,96,4281,4058,8,13,6,0,2
72424,61,3,58,54,0,0,0,2,0
72425,375,9,366,349,0,1,1,1,1
72426,179,4,175,167,0,0,1,0,0
72427,109,8,101,96,1,1,0,0,0
72428,77,1,76,72,0,0,0,0,0
72429,311,7,304,297,0,1,1,0,0
72430,381,4,377,363,0,3,0,0,1
72431,319,1,318,302,5,0,0,0,0
72432,6135,133,6002,5633,103,40,8,1,14
72433,2708,29,2679,2505,15,9,3,2,4
72434,1984,40,1944,1856,9,8,4,0,4
72435,289,3,286,265,0,2,0,0,0
72436,936,5,931,888,4,4,1,0,1
72437,3486,112,3374,3166,50,14,9,2,2
72438,2399,283,2116,1988,16,3,2,0,4
72440,245,1,244,241,0,1,0,0,0
72441,67,2,65,63,0,1,0,0,0
72442,4859,192,4667,4467,33,6,18,0,8
72443,2991,61,2930,2797,11,4,2,0,5
72444,1742,10,1732,1670,2,2,2,0,0
72445,82,0,82,78,0,0,0,0,0
72447,1798,127,1671,1626,9,1,0,0,1
72449,192,5,187,175,2,1,1,0,0
72450,39945,1501,38444,35095,906,128,174,285,95
72453,177,4,173,156,0,0,0,0,0
72454,4857,122,4735,4558,14,8,3,0,15
72455,13328,325,13003,11652,125,58,64,593,19
72456,595,7,588,571,2,4,1,0,0
72457,150,2,148,142,1,0,0,0,0
72458,624,6,618,599,1,2,0,0,1
72459,1310,8,1302,1237,4,15,2,1,2
72460,738,8,730,695,0,3,0,0,4
72461,3499,85,3414,3247,16,13,4,3,2
72462,375,5,370,343,1,1,0,1,0
72464,52,0,52,51,0,0,0,0,0
72466,1461,17,1444,1382,6,8,6,0,3
72467,609,27,582,452,87,2,17,0,0
72469,1115,15,1100,1056,7,1,0,2,1
72470,278,3,275,261,0,0,0,0,0
72471,986,13,973,906,22,4,0,0,3
72472,9164,424,8740,7480,682,41,44,0,28
72473,2196,39,2157,1993,89,6,1,0,3
72476,7065,212,6853,6355,103,8,29,3,22
72478,390,15,375,344,1,1,0,0,0
72479,1269,59,1210,1138,16,2,2,0,1
72482,1302,23,1279,1154,1,9,4,7,10
72501,26444,2903,23541,21031,763,78,314,24,75
72512,2507,79,2428,2236,11,17,10,3,5
72513,2873,49,2824,2657,10,27,12,0,6
72515,60,0,60,55,0,0,0,0,0
72517,361,6,355,341,0,0,2,0,0
72519,3243,78,3165,2803,208,23,5,0,0
72520,267,6,261,243,0,2,1,0,3
72521,4989,112,4877,4544,87,28,12,8,2
72522,393,13,380,361,0,4,2,1,0
72523,900,20,880,827,2,5,1,0,1
72524,369,15,354,321,5,2,1,0,0
72526,267,9,258,239,0,1,2,0,0
72527,524,24,500,476,2,0,1,0,2
72528,203,5,198,192,0,0,0,0,0
72529,4806,79,4727,4420,19,28,34,2,3
72530,1853,23,1830,1746,1,8,9,6,3
72531,792,11,781,741,1,3,3,0,0
72532,1554,41,1513,1408,1,16,1,0,3
72533,367,10,357,342,2,3,0,0,2
72534,1302,23,1279,1216,5,6,3,0,6
72536,402,14,388,365,0,4,1,2,1
72537,828,16,812,745,3,4,1,0,2
72538,422,4,418,401,1,2,1,0,0
72539,371,7,364,339,0,3,0,0,1
72540,118,4,114,103,1,2,0,0,0
72542,3681,91,3590,3351,8,25,5,0,5
72543,12175,368,11807,11146,30,59,62,3,14
72544,565,9,556,530,0,0,1,0,2
72546,121,4,117,106,1,0,0,0,4
72550,876,28,848,794,1,7,1,0,1
72553,133,8,125,105,4,0,0,0,1
72554,2749,36,2713,2564,5,8,4,0,1
72555,228,4,224,213,0,4,1,1,0
72556,3362,83,3279,3058,20,17,6,3,11
72560,8834,195,8639,8116,16,56,18,0,23
72561,788,18,770,715,3,1,0,0,1
72562,2208,91,2117,2005,17,10,0,1,2
72564,474,17,457,412,12,1,0,1,1
72565,885,11,874,774,7,6,1,0,7
72566,542,9,533,497,2,6,0,0,0
72567,278,5,273,252,1,1,0,0,0
72568,1698,54,1644,1572,0,7,2,1,3
72569,410,10,400,378,1,4,2,1,1
72571,393,9,384,355,3,1,1,0,0
72572,189,5,184,181,0,0,0,0,0
72573,383,14,369,341,1,1,1,1,6
72576,3934,58,3876,3608,11,18,8,0,7
72577,727,20,707,657,2,4,2,2,0
72578,150,2,148,148,0,0,0,0,0
72579,1457,39,1418,1317,9,11,7,2,0
72581,965,19,946,900,0,1,1,0,2
72583,1678,13,1665,1568,4,12,7,0,1
72584,589,9,580,541,0,0,2,0,1
72585,221,6,215,201,1,0,0,0,0
72587,54,0,54,51,0,0,0,0,0
72601,30483,853,29630,27480,89,195,202,21,70
72611,1639,102,1537,1405,3,8,5,14,0
72615,24,0,24,21,0,0,0,0,0
72616,10625,1822,8803,7713,27,73,139,297,34
72617,206,0,206,201,0,0,0,0,0
72619,1941,55,1886,1768,5,9,8,0,2
72623,689,14,675,638,0,2,2,0,0
72624,368,5,363,337,0,5,2,0,0
72626,1141,24,1117,1023,1,8,4,0,0
72628,769,8,761,710,0,6,6,0,7
72629,588,12,576,543,1,4,1,0,1
72630,143,4,139,124,0,4,0,0,0
72631,4036,171,3865,3615,22,57,19,0,12
72632,4704,223,4481,4046,20,57,44,1,29
72633,1886,32,1854,1736,1,11,10,1,8
72634,4888,115,4773,4501,6,39,16,0,2
72635,3717,93,3624,3348,6,26,10,0,5
72636,25,1,24,21,0,1,0,2,0
72638,7273,1985,5288,4420,17,62,358,122,16
72639,572,4,568,539,1,3,0,0,2
72640,394,2,392,367,0,0,2,0,0
72641,2011,28,1983,1856,4,19,7,1,3
72642,1945,38,1907,1808,0,12,10,0,3
72644,2383,64,2319,2139,1,31,10,2,8
72645,1679,48,1631,1485,3,16,8,0,8
72648,493,1,492,447,0,13,1,0,1
72650,4168,78,4090,3782,2,35,8,3,6
72651,1258,21,1237,1159,1,5,5,0,0
72653,28758,790,27968,26276,73,144,195,9,76
72655,463,2,461,433,0,2,2,0,2
72658,1599,23,1576,1497,2,7,4,0,6
72660,484,16,468,421,1,4,2,0,0
72661,557,8,549,512,2,2,2,0,0
72662,3018,47,2971,2752,5,22,12,1,3
72663,325,9,316,299,0,2,2,1,2
72666,402,4,398,380,0,7,0,0,0
72668,451,4,447,428,0,2,4,0,0
72669,63,1,62,62,0,0,0,0,0
72670,163,0,163,150,0,2,0,0,0
72672,358,13,345,317,0,4,0,0,0
72675,1543,17,1526,1402,0,16,4,0,1
72677,632,14,618,577,0,3,0,0,0
72679,83,4,79,69,1,2,0,0,1
72680,844,17,827,771,0,12,3,0,1
72682,279,5,274,233,0,5,1,0,0
72683,360,0,360,344,1,1,0,0,1
72685,1248,13,1235,1146,0,10,2,0,4
72686,203,8,195,172,1,1,0,0,0
72687,5935,124,5811,5454,6,53,19,0,4
72701,48269,3817,44452,36882,2488,479,1239,210,176
72703,33767,2625,31142,25366,1983,290,1114,189,114
72704,31145,2706,28439,22943,1730,337,898,174,113
72712,38053,3919,34134,26966,898,350,3350,130,133
72713,25076,2265,22811,14715,871,226,5404,111,100
72714,13393,712,12681,11516,103,154,110,22,19
72715,17012,683,16329,15002,113,144,106,3,50
72717,893,33,860,729,2,17,6,0,3
72718,4914,305,4609,4105,67,43,51,2,2
72719,16248,2161,14087,11411,576,189,739,29,65
72721,350,7,343,319,1,4,0,0,0
72722,3087,676,2411,1907,15,84,100,41,8
72727,6434,357,6077,5484,36,65,32,7,21
72729,236,2,234,199,0,16,1,0,0
72730,9624,653,8971,7790,202,129,82,26,47
72732,4990,436,4554,4040,12,60,26,3,22
72734,7905,924,6981,5650,36,307,352,4,18
72736,7046,422,6624,5726,33,206,67,4,30
72738,2509,196,2313,2073,3,30,25,0,9
72739,439,27,412,350,4,14,4,0,0
72740,10026,614,9412,8364,24,136,62,237,40
72742,404,10,394,351,0,10,3,1,0
72744,5227,403,4824,3941,19,123,162,5,8
72745,13371,3413,9958,8433,158,129,261,206,18
72747,216,11,205,144,2,19,25,0,1
72749,105,5,100,90,0,4,3,0,0
72751,8361,666,7695,6935,61,87,42,7,15
72752,305,9,296,262,0,0,1,0,0
72753,10525,577,9948,8724,63,211,84,2,18
72756,41875,13053,28822,24663,437,388,585,571,136
72758,45105,12484,32621,27417,691,323,1518,480,162
72760,276,6,270,246,0,0,0,0,2
72761,23731,5082,18649,14923,210,963,517,39,54
72762,42175,9814,32361,26106,786,340,978,1773,71
72764,60786,26555,34231,21870,1217,356,1214,7270,156
72768,1241,74,1167,982,5,35,12,8,3
72769,1226,122,1104,810,0,49,100,1,0
72773,1102,39,1063,1010,2,4,3,0,2
72774,6309,261,6048,5353,33,83,48,11,22
72776,747,18,729,660,2,10,8,0,6
72801,18510,2877,15633,12856,1332,122,283,14,57
72802,22752,2728,20024,17659,607,137,295,3,67
72821,1629,73,1556,1417,3,19,12,1,2
72823,6404,193,6211,5668,72,44,20,3,25
72824,1719,260,1459,1264,15,21,57,1,3
72826,31,6,25,22,0,0,0,0,0
72827,170,5,165,152,0,2,6,0,0
72828,106,2,104,95,0,2,3,0,0
72829,150,21,129,115,2,6,0,0,0
72830,15461,2834,12627,10559,401,99,815,24,43
72832,700,23,677,614,2,8,8,1,2
72833,3818,1169,2649,2452,23,14,36,3,2
72834,10189,2327,7862,7206,172,48,73,4,20
72835,838,19,819,750,0,5,17,0,0
72837,7897,209,7688,7036,23,97,24,0,13
72838,118,8,110,105,0,0,0,0,0
72839,305,9,296,268,1,3,0,0,1
72840,1985,149,1836,1681,4,20,32,0,2
72841,175,9,166,141,1,6,6,0,0
72842,1247,115,1132,1040,3,8,12,0,0
72843,2302,56,2246,2078,3,17,10,2,3
72845,1116,58,1058,989,6,10,11,0,2
72846,4033,281,3752,3424,24,51,35,3,5
72847,2800,121,2679,2460,14,24,12,0,4
72851,679,37,642,555,1,11,25,1,0
72852,333,11,322,272,1,3,2,0,0
72853,1980,249,1731,1600,12,11,9,0,4
72854,621,23,598,534,6,5,1,0,0
72855,5914,192,5722,5127,135,50,99,2,4
72856,292,2,290,273,1,0,0,0,1
72857,1033,51,982,918,1,3,5,3,0
72858,3476,259,3217,2948,30,21,27,0,10
72860,299,20,279,267,0,0,3,0,0
72863,1597,37,1560,1446,3,7,31,1,0
72865,1028,21,1007,936,8,4,26,0,3
72901,20973,3776,17197,12553,1853,447,578,8,61
72903,25225,2838,22387,17193,1682,453,1173,21,70
72904,22402,9283,13119,6747,2959,262,1860,28,31
72905,0,0,0,0,0,0,0,0,0
72908,14310,1139,13171,9966,845,320,693,4,34
72916,10250,551,9699,7697,318,139,862,6,38
72921,13770,520,13250,11732,173,242,91,3,26
72923,4811,543,4268,3428,108,90,213,4,14
72926,522,25,497,442,0,2,4,0,0
72927,8449,285,8164,7390,63,139,101,3,22
72928,680,24,656,591,2,11,22,0,5
72930,451,11,440,383,0,6,16,6,0
72932,1481,58,1423,1213,8,39,5,0,3
72933,4942,122,4820,4351,28,79,45,0,6
72934,942,34,908,834,2,12,0,0,4
72935,449,29,420,380,6,3,4,0,0
72936,14515,637,13878,12266,56,298,177,5,19
72937,3530,83,3447,2972,5,101,24,3,12
72938,1160,40,1120,970,6,32,25,1,0
72940,2303,71,2232,1945,12,71,27,1,4
72941,5079,236,4843,4306,15,91,35,5,13
72943,2526,47,2479,2279,8,25,34,0,5
72944,2620,85,2535,2251,29,49,50,4,7
72945,336,16,320,295,0,3,0,1,0
72946,3288,78,3210,2872,5,100,6,2,3
72947,3973,64,3909,3546,23,55,11,2,9
72948,371,5,366,318,0,9,3,0,0
72949,9725,315,9410,8633,53,106,80,3,17
72950,399,11,388,336,1,13,8,0,1
72951,825,10,815,745,4,8,6,2,5
72952,2512,78,2434,2085,4,84,13,2,7
72955,443,8,435,375,0,24,2,0,2
72956,33870,3699,30171,25178,640,804,810,18,75
72958,6866,665,6201,5491,23,112,205,4,18
72959,2827,59,2768,2473,5,35,6,4,8
73001,64,0,64,55,0,2,0,0,1
73002,967,65,902,763,1,61,2,0,1
73003,22648,2246,20402,15037,2033,550,673,34,55
73004,886,29,857,727,2,32,2,0,2
73005,8072,889,7183,2874,307,3144,31,2,5
73006,3136,227,2909,1905,34,688,10,7,8
73007,2931,193,2738,2190,143,116,43,2,16
73008,21592,5102,16490,12136,1731,556,304,19,86
73009,861,61,800,647,20,86,0,1,1
73010,20744,1254,19490,16288,128,1045,64,13,42
73011,377,16,361,313,0,25,0,0,0
73012,41289,2986,38303,27371,3588,822,2841,35,164
73013,56972,3636,53336,38540,4792,1108,3864,77,259
73014,1419,95,1324,1101,6,110,3,1,1
73015,2282,282,2000,1313,7,510,0,1,1
73016,2053,111,1942,1661,22,87,4,0,6
73017,1692,85,1607,1338,9,119,4,2,5
73018,19806,1714,18092,14012,1124,1081,89,13,28
73019,2,0,2,0,0,0,0,0,1
73020,24627,1373,23254,18479,852,1123,248,15,114
73021,293,17,276,233,2,20,0,0,0
73022,16,1,15,4,2,8,0,0,0
73024,724,78,646,592,6,6,3,0,1
73025,15524,931,14593,12465,245,381,262,9,36
73026,11940,806,11134,8857,174,777,129,12,20
73027,1199,73,1126,885,54,39,9,4,10
73028,3194,122,3072,2591,78,136,14,0,3
73029,1474,108,1366,1034,9,188,2,2,4
73030,4777,272,4505,3258,89,680,16,4,7
73031,27,2,25,24,0,0,0,0,0
73032,189,8,181,127,2,33,0,0,2
73033,375,126,249,233,0,3,0,0,2
73034,47553,3584,43969,35226,2067,1135,1402,48,153
73036,19602,2926,16676,12239,1043,1825,80,12,30
73038,1621,82,1539,1171,22,216,2,3,4
73040,1571,132,1439,1070,14,228,0,0,0
73041,324,17,307,266,2,17,0,1,1
73042,883,70,813,635,0,102,2,0,2
73043,152,5,147,119,0,7,0,0,0
73044,24603,1894,22709,18006,1500,745,107,6,154
73045,11272,526,10746,8772,133,629,85,5,26
73047,6441,2337,4104,3223,260,333,27,1,9
73048,2056,179,1877,1718,13,37,0,1,0
73049,6717,436,6281,4844,330,314,75,7,14
73050,1482,35,1447,66,1225,81,11,1,1
73051,9541,860,8681,6621,603,746,10,5,23
73052,6226,524,5702,4667,24,479,30,3,6
73053,677,74,603,534,2,42,0,0,2
73054,4636,361,4275,3402,199,221,11,3,23
73055,9529,461,9068,7714,36,471,37,1,30
73056,431,28,403,352,0,23,0,0,0
73057,2149,120,2029,1691,5,153,4,2,0
73058,322,30,292,231,11,15,0,3,5
73059,2677,165,2512,2123,5,122,0,0,11
73061,1499,68,1431,1152,14,97,4,0,1
73062,1249,62,1187,885,8,190,5,1,1
73063,710,22,688,582,6,25,5,2,2
73064,25137,2355,22782,18679,423,930,376,20,83
73065,9725,663,9062,7326,91,577,52,4,25
73066,114,12,102,74,11,5,0,0,0
73067,1783,90,1693,1434,8,106,0,4,6
73068,12368,698,11670,9575,109,625,65,2,43
73069,26464,3163,23301,17618,1021,1133,587,20,158
73070,121,8,113,80,18,11,0,0,0
73071,43379,4161,39218,27549,3059,1781,1843,34,188
73072,51062,4309,46753,35255,2022,1856,2522,35,916
73073,610,34,576,490,5,31,3,0,1
73074,1123,87,1036,794,4,130,0,0,3
73075,8974,1444,7530,5809,287,587,60,5,12
73077,6534,272,6262,5298,109,257,37,0,14
73078,12069,924,11145,9355,200,389,147,5,31
73079,603,28,575,515,1,12,0,0,1
73080,10108,1347,8761,6958,95,724,51,13,27
73082,2618,65,2553,2106,8,136,4,2,6
73084,6595,672,5923,1542,3609,183,34,7,33
73086,8470,642,7828,5690,63,1175,26,14,7
73089,13696,699,12997,10874,60,722,67,13,39
73090,1008,49,959,769,43,48,3,0,2
73092,831,49,782,638,19,72,1,0,0
73093,3415,233,3182,2583,19,212,13,3,13
73095,1831,135,1696,1318,16,174,8,2,5
73096,14520,1899,12621,10281,370,800,200,1,23
73097,290,52,238,190,0,7,1,0,2
73098,3774,274,3500,2598,149,355,8,1,12
73099,83213,7872,75341,58882,3111,2614,3152,59,292
73102,3072,322,2750,1585,793,102,103,2,10
73103,5046,376,4670,3493,342,148,237,6,26
73104,3545,264,3281,1892,689,60,320,3,20
73105,5835,367,5468,1520,3139,78,334,5,26
73106,12956,3606,9350,6121,1099,382,802,15,139
73107,26318,10299,16019,10907,1798,805,687,22,98
73108,14451,9234,5217,2994,927,531,106,19,54
73109,20148,13152,6996,4284,1185,647,134,24,50
73110,33156,2894,30262,16204,8530,1231,550,72,156
73111,11451,703,10748,1214,8502,201,27,1,47
73112,31113,5924,25189,16225,3643,804,1754,29,128
73114,18694,3554,15140,4708,8086,334,335,18,112
73115,20880,2692,18188,10513,4270,791,366,51,67
73116,9531,640,8891,6987,604,212,352,5,42
73117,5859,504,5355,1014,3669,94,88,4,32
73118,13521,1668,11853,8349,1031,382,925,6,40
73119,31216,19937,11279,6801,1884,1028,174,34,67
73120,36530,2715,33815,21247,7670,733,817,56,121
73121,3218,199,3019,758,1955,44,37,0,13
73122,13326,3755,9571,6126,1713,294,356,1,49
73127,27007,9385,17622,9634,4548,782,647,44,106
73128,5950,1205,4745,3074,420,146,635,2,16
73129,19971,11193,8778,4755,2113,689,158,8,61
73130,21536,1590,19946,12702,3898,742,370,29,69
73131,3453,285,3168,2334,327,103,122,6,7
73132,28394,3501,24893,13635,6243,594,1790,45,130
73134,7078,661,6417,3888,1416,110,450,17,32
73135,21562,2683,18879,8523,6495,563,1070,82,108
73139,18781,6298,12483,7834,1971,678,542,122,86
73141,2671,339,2332,1213,691,108,23,6,18
73142,16461,1131,15330,10123,2273,333,1202,14,57
73145,2096,373,1723,1234,226,18,78,10,11
73149,5726,1938,3788,2279,438,289,305,13,24
73150,5166,425,4741,3663,281,166,83,4,30
73151,1920,81,1839,1485,95,35,66,0,1
73159,32981,10865,22116,13657,2663,1198,1812,159,126
73160,60511,7517,52994,38650,3691,2282,1593,47,273
73162,28867,2111,26756,17601,4019,597,1960,25,136
73165,7791,605,7186,5656,259,281,178,5,27
73169,4295,695,3600,2453,591,143,88,2,18
73170,41343,3964,37379,26418,1863,1313,3888,30,114
73173,4363,442,3921,2968,97,141,244,5,3
73179,7575,1196,6379,4267,392,235,824,16,15
73401,36744,3180,33564,22926,2478,3215,569,42,554
73425,129,3,126,91,0,18,0,0,0
73430,1323,80,1243,1021,18,68,5,0,16
73432,967,30,937,717,0,131,2,0,4
73433,2654,88,2566,2145,64,176,6,0,3
73434,558,15,543,459,3,31,1,0,0
73435,92,7,85,73,0,4,2,0,0
73436,113,8,105,65,7,18,0,0,8
73437,48,0,48,40,1,0,0,0,0
73438,2888,133,2755,2235,22,215,8,0,11
73439,7267,357,6910,5494,31,708,11,1,47
73440,227,10,217,179,0,25,0,0,3
73441,148,5,143,111,0,5,1,0,0
73442,482,28,454,376,5,30,0,0,1
73443,3170,170,3000,2222,73,350,8,2,28
73444,126,6,120,76,17,2,0,0,0
73446,7873,2241,5632,4110,138,683,33,3,35
73447,882,65,817,617,2,70,0,0,37
73448,6145,1429,4716,3731,146,377,42,0,34
73449,2995,153,2842,2129,12,389,13,0,1
73450,1156,48,1108,807,14,173,1,0,0
73453,654,34,620,527,5,51,2,0,2
73455,574,30,544,388,4,99,0,0,1
73456,1747,65,1682,1324,3,132,14,2,3
73458,734,28,706,482,56,42,1,0,47
73459,1449,118,1331,1091,22,94,18,0,3
73460,4661,292,4369,2925,207,704,47,5,12
73461,825,41,784,563,7,135,0,0,0
73463,3365,90,3275,2684,16,263,1,0,10
73481,899,15,884,679,20,89,1,0,3
73487,187,4,183,38,141,0,0,0,2
73488,29,1,28,19,0,4,0,0,0
73491,704,33,671,543,0,39,0,0,2
73501,19158,2700,16458,9312,4023,1225,328,107,46
73503,11796,2280,9516,6159,1922,113,478,123,47
73505,46881,6834,40047,22362,9227,1911,1552,371,238
73507,21605,2769,18836,11784,3119,1227,431,140,80
73520,101,6,95,88,2,5,0,0,0
73521,20209,5227,14982,11487,1540,252,290,72,51
73523,261,46,215,141,31,2,14,1,0
73526,2108,235,1873,1681,21,71,6,1,3
73527,5403,535,4868,3430,172,628,40,18,22
73528,694,39,655,555,17,18,4,3,1
73529,4721,221,4500,3734,18,315,1,0,7
73530,368,101,267,244,1,6,0,0,0
73531,311,16,295,261,5,4,3,0,0
73532,532,59,473,439,3,9,0,0,0
73533,27396,2737,24659,19991,739,1176,207,13,103
73537,459,105,354,312,6,15,0,1,3
73538,6771,787,5984,4562,242,430,111,31,38
73539,173,16,157,143,1,2,2,0,0
73540,494,41,453,362,9,30,3,0,4
73541,3362,218,3144,2579,52,224,17,0,35
73542,3995,1280,2715,2097,296,120,23,0,19
73543,1715,198,1517,1165,45,156,10,6,4
73544,217,33,184,175,1,1,0,0,0
73546,1114,268,846,644,73,37,1,0,0
73547,1843,128,1715,1292,226,117,1,0,3
73548,439,25,414,360,7,20,0,0,0
73549,316,46,270,227,1,12,0,0,0
73550,2149,686,1463,1132,146,50,7,0,0
73551,48,2,46,39,2,1,0,0,0
73552,1393,115,1278,846,14,279,4,2,2
73553,34,7,27,23,2,0,0,0,1
73554,3371,502,2869,2493,125,46,5,1,9
73555,193,25,168,129,21,5,0,0,4
73556,162,65,97,88,0,2,0,0,0
73557,295,14,281,228,3,13,9,1,0
73559,457,49,408,370,2,7,2,0,0
73560,631,159,472,407,12,18,8,2,0
73562,579,44,535,496,2,6,0,0,0
73564,528,58,470,417,2,19,0,0,0
73565,885,155,730,643,1,29,0,1,2
73566,1514,192,1322,1127,75,37,7,0,1
73567,704,33,671,571,3,40,0,1,2
73568,1057,95,962,743,49,70,0,1,1
73569,391,63,328,276,0,11,1,1,2
73570,1052,227,825,670,75,19,2,0,1
73571,60,7,53,51,0,2,0,0,0
73572,3405,200,3205,2434,14,399,25,5,7
73573,2226,287,1939,1645,17,100,16,1,8
73601,9756,3169,6587,4802,399,701,89,0,34
73620,1106,108,998,846,10,78,5,0,0
73622,286,19,267,226,2,12,1,0,1
73624,1960,230,1730,1472,33,56,10,0,8
73625,431,28,403,374,0,14,0,0,0
73626,1085,73,1012,917,3,25,2,0,1
73627,554,46,508,482,2,10,2,0,0
73628,1530,145,1385,1290,3,18,3,1,1
73632,3354,232,3122,2810,13,84,0,0,4
73638,117,3,114,102,1,1,0,0,0
73639,683,65,618,470,7,26,0,0,0
73641,671,74,597,548,3,8,0,0,1
73642,194,7,187,168,0,3,0,0,0
73644,14198,1960,12238,10539,295,419,103,8,30
73645,1358,103,1255,1126,5,39,4,0,0
73646,363,8,355,316,0,19,0,0,1
73647,598,52,546,501,1,12,1,0,0
73650,1008,77,931,763,1,94,0,0,0
73651,3853,540,3313,2617,220,174,35,1,9
73654,754,38,716,651,0,21,0,0,0
73655,809,47,762,664,10,40,0,0,5
73658,236,5,231,198,0,9,0,0,0
73659,150,5,145,138,0,1,0,0,0
73660,373,24,349,315,0,2,0,0,0
73661,421,8,413,394,0,8,1,0,0
73662,6385,566,5819,4472,817,307,19,4,8
73663,1282,100,1182,977,0,140,2,0,2
73664,981,178,803,700,3,30,2,0,1
73666,344,14,330,303,1,4,2,0,0
73667,451,16,435,404,0,7,2,0,0
73668,57,5,52,44,0,2,0,0,0
73669,1557,90,1467,1275,4,86,1,0,0
73673,302,28,274,239,2,4,1,0,3
73701,24744,5704,19040,13828,898,551,137,1907,52
73703,30376,2776,27600,22689,709,592,507,1004,83
73705,313,40,273,208,28,6,11,0,5
73716,476,19,457,424,2,3,0,0,1
73717,6964,522,6442,5589,224,207,71,1,12
73718,531,49,482,438,0,15,0,0,0
73719,94,2,92,79,0,3,0,0,0
73720,215,10,205,188,0,3,4,0,0
73722,405,22,383,361,0,4,0,0,0
73724,995,74,921,753,2,101,6,0,1
73726,458,22,436,401,0,9,1,0,0
73727,194,18,176,165,0,4,0,0,1
73728,1840,107,1733,1581,5,33,3,0,4
73729,586,43,543,505,1,7,0,0,1
73730,660,27,633,569,1,23,1,0,1
73731,169,6,163,155,0,1,1,0,0
73733,234,15,219,198,2,2,2,0,1
73734,926,206,720,647,14,14,2,0,1
73735,732,120,612,547,8,8,1,0,2
73736,426,14,412,362,1,11,0,1,2
73737,3525,182,3343,3064,9,72,19,0,1
73738,1055,62,993,887,2,22,5,2,2
73739,435,12,423,384,0,8,0,0,0
73741,1702,102,1600,1190,224,131,3,0,3
73742,3909,1316,2593,2326,29,77,10,0,3
73743,75,2,73,68,0,3,0,0,0
73744,277,25,252,231,0,5,2,0,0
73746,22,0,22,22,0,0,0,0,0
73747,324,20,304,299,0,3,0,0,0
73749,440,7,433,409,0,3,0,0,0
73750,7232,1026,6206,5412,104,226,28,0,19
73753,474,10,464,408,2,6,0,0,1
73754,1083,77,1006,919,2,9,7,3,0
73755,744,28,716,596,4,65,5,0,3
73756,279,18,261,239,3,5,1,0,0
73757,133,5,128,115,0,4,0,0,0
73758,176,5,171,164,3,2,0,0,0
73759,1364,82,1282,1159,14,33,7,2,5
73760,445,85,360,342,2,4,0,0,2
73761,354,6,348,327,0,4,1,0,2
73762,2257,157,2100,1894,10,47,3,1,1
73763,1443,175,1268,1162,8,23,5,3,4
73764,128,9,119,105,0,1,0,0,0
73766,1064,44,1020,909,16,18,1,4,6
73768,1493,355,1138,1067,2,14,16,0,3
73770,45,4,41,40,0,0,0,0,0
73771,472,15,457,419,4,10,0,2,0
73772,3574,541,3033,2228,214,308,10,1,6
73773,1768,85,1683,1492,6,42,11,3,0
73801,15671,2649,13022,11651,89,346,116,0,42
73832,897,69,828,764,8,7,2,0,2
73834,1403,289,1114,1043,0,6,0,0,1
73835,319,7,312,270,2,16,0,0,0
73838,573,39,534,486,0,12,1,0,0
73840,643,60,583,535,2,21,4,0,0
73841,1351,119,1232,820,258,116,7,0,3
73842,353,16,337,311,0,12,2,0,0
73843,785,44,741,682,3,12,1,0,1
73844,192,25,167,157,0,2,1,0,2
73848,1811,427,1384,1299,4,16,0,0,1
73851,101,5,96,88,0,2,0,0,0
73852,1985,143,1842,1698,4,37,0,0,6
73853,508,31,477,428,0,15,0,0,5
73855,149,23,126,120,0,1,0,0,0
73857,615,39,576,545,0,13,0,0,0
73858,1540,182,1358,1249,2,30,4,0,0
73859,1369,96,1273,1187,6,23,0,2,2
73860,1150,64,1086,986,3,23,1,0,1
73901,148,102,46,43,0,2,0,0,0
73931,399,28,371,346,0,1,1,0,0
73932,1825,391,1434,1348,3,12,6,3,0
73933,1574,446,1128,1073,1,4,0,0,6
73937,195,48,147,141,0,0,0,0,0
73938,719,148,571,540,0,3,2,1,0
73939,1429,334,1095,922,81,27,15,0,0
73942,14409,8150,6259,4427,875,88,419,0,64
73944,377,155,222,198,0,4,0,0,0
73945,2745,1191,1554,1414,1,24,9,0,1
73946,50,3,47,46,0,0,0,0,0
73947,438,65,373,353,0,0,0,0,1
73949,1162,435,727,669,5,12,2,0,0
73950,1771,721,1050,950,6,13,2,2,1
73951,1076,439,637,579,7,2,2,0,3
73960,35,13,22,22,0,0,0,0,0
74001,296,4,292,232,0,37,0,0,1
74002,2001,40,1961,1307,7,366,5,1,1
74003,13751,996,12755,8680,653,1462,114,6,37
74006,27795,1915,25880,19154,578,2225,806,2,65
74008,31745,2522,29223,22147,640,2013,869,11,88
74010,10449,401,10048,7275,425,1097,38,7,15
74011,31803,2258,29545,22243,1212,1612,771,15,93
74012,63918,7031,56887,39468,3785,3097,3816,51,245
74014,41284,4300,36984,26961,1355,2743,1151,12,115
74015,8270,675,7595,5213,86,1037,91,3,8
74016,5919,156,5763,3540,20,1342,25,0,8
74017,29083,1681,27402,18393,449,4188,213,14,146
74019,20333,1054,19279,13533,159,2487,247,10,48
74020,7207,222,6985,5571,34,630,30,0,8
74021,21567,1400,20167,14122,290,2135,809,6,84
74022,1628,49,1579,1207,2,215,1,0,3
74023,12117,733,11384,8710,766,859,40,0,31
74026,971,57,914,749,17,44,0,0,0
74027,760,22,738,477,1,128,0,2,0
74028,1761,49,1712,1336,50,188,5,1,0
74029,4990,232,4758,3459,63,627,2,2,5
74030,3529,86,3443,2791,48,305,5,2,6
74032,2298,111,2187,1717,14,127,16,2,6
74033,13254,1013,12241,7692,413,1634,787,15,30
74034,147,8,139,127,0,5,0,0,0
74035,4288,210,4078,2285,481,870,8,0,1
74036,7182,260,6922,4980,48,938,132,1,9
74037,23727,1642,22085,15107,745,1269,2464,10,78
74038,2172,62,2110,1669,5,188,15,3,19
74039,3760,122,3638,2814,31,389,10,0,12
74041,2680,197,2483,1799,38,345,17,3,7
74042,446,12,434,260,14,91,0,0,0
74044,7363,250,7113,5645,31,495,31,4,8
74045,301,5,296,240,2,35,1,0,0
74046,87,6,81,63,2,2,0,0,0
74047,6931,441,6490,4791,83,856,24,2,14
74048,5537,144,5393,3345,71,1017,5,2,7
74050,431,49,382,272,0,38,2,0,0
74051,1928,59,1869,1303,6,298,3,0,1
74052,1021,24,997,869,9,63,3,2,2
74053,4962,148,4814,3368,16,629,182,1,8
74054,749,16,733,600,0,66,0,0,2
74055,48776,3936,44840,32984,1649,3257,1455,63,137
74056,4857,222,4635,2462,89,1442,8,1,2
74058,3727,95,3632,2444,28,834,3,0,7
74059,5724,233,5491,4507,81,329,16,6,26
74060,463,10,453,374,6,45,0,0,2
74061,2125,80,2045,1382,12,330,14,0,9
74062,993,41,952,795,2,50,2,0,2
74063,30630,1493,29137,22139,493,2643,117,12,85
74066,31255,1720,29535,21633,694,3297,116,39,77
74068,57,0,57,43,0,6,0,0,0
74070,15407,627,14780,10613,84,2181,53,5,40
74071,118,2,116,87,1,11,0,0,0
74072,1651,50,1601,1083,2,217,0,1,1
74073,5366,285,5081,3653,65,683,64,2,16
74074,32326,2064,30262,24152,917,1044,1065,21,131
74075,25033,1934,23099,16767,1243,1035,1488,22,103
74077,1286,119,1167,926,52,76,18,0,0
74078,450,58,392,262,32,31,11,0,3
74079,4532,137,4395,3449,88,341,27,2,11
74080,2713,85,2628,1808,15,406,33,0,3
74081,1790,62,1728,1355,8,159,8,0,11
74082,144,9,135,99,1,10,1,0,1
74083,1024,20,1004,706,20,121,0,0,0
74084,452,15,437,324,3,59,1,0,0
74085,2357,86,2271,1867,10,148,3,2,2
74103,3082,336,2746,1769,582,179,45,1,11
74104,12395,1637,10758,7750,726,596,362,10,49
74105,26640,2126,24514,17603,2625,1230,385,36,98
74106,16805,1811,14994,2210,10492,479,86,72,47
74107,19453,1854,17599,10833,2075,1714,253,223,66
74108,7545,1924,5621,3469,516,551,369,21,12
74110,15197,6608,8589,3576,2969,763,114,86,49
74112,20810,4027,16783,11109,1901,1214,230,40,89
74114,15843,1100,14743,11821,479,684,207,12,58
74115,24461,10624,13837,7215,3226,1332,125,49,86
74116,4069,1402,2667,1508,385,302,97,8,6
74117,129,40,89,44,15,14,5,0,3
74119,3445,230,3215,2314,322,162,91,1,11
74120,5037,609,4428,3274,323,210,60,3,12
74126,10338,1123,9215,2204,5340,533,61,8,53
74127,15669,1362,14307,7160,4246,1012,69,14,50
74128,12982,5305,7677,4153,1468,586,400,48,56
74129,18755,6675,12080,6574,2441,774,605,61,86
74130,2212,411,1801,698,758,103,40,4,3
74131,2988,221,2767,2156,61,233,13,1,4
74132,10968,749,10219,7331,478,598,741,4,24
74133,48331,5427,42904,28355,4650,1843,3201,19,187
74134,23505,6233,17272,10036,2628,963,1575,30,62
74135,20173,1651,18522,13047,1754,1027,497,13,76
74136,30416,3001,27415,16140,4801,1222,2322,47,123
74137,28354,2080,26274,19907,1276,1011,1538,22,108
74145,18055,3692,14363,8662,2320,834,569,11,93
74146,16427,8373,8054,3800,2125,494,455,20,62
74171,1992,311,1681,1025,436,31,94,3,17
74301,10612,344,10268,6077,366,2174,69,2,14
74330,2668,99,2569,1760,6,452,7,3,4
74331,6590,149,6441,4718,26,902,33,3,10
74332,1874,31,1843,1291,7,320,8,0,0
74333,1179,23,1156,734,6,245,1,0,3
74337,4671,163,4508,3095,22,696,10,2,12
74338,4928,234,4694,2702,12,1222,98,2,8
74339,2296,558,1738,1196,11,320,4,1,1
74340,222,7,215,135,0,57,1,0,0
74342,2647,59,2588,1550,3,615,48,0,8
74343,2999,68,2931,2006,17,504,16,5,1
74344,14923,637,14286,10708,51,1864,67,25,27
74346,7679,388,7291,3883,19,2300,158,3,21
74347,2836,93,2743,1452,14,902,15,3,6
74349,805,18,787,605,6,104,3,0,0
74350,790,34,756,480,0,157,2,1,0
74352,6070,103,5967,3347,21,1695,23,3,5
74354,17281,829,16452,10817,235,3025,102,218,41
74358,235,18,217,141,0,52,0,0,2
74359,320,20,300,65,0,198,7,0,1
74360,26,0,26,14,0,7,0,0,0
74361,16699,801,15898,10114,97,2947,113,17,17
74363,2715,72,2643,1733,16,669,8,1,1
74364,1811,56,1755,850,5,590,64,0,11
74365,4081,94,3987,1965,10,1404,26,0,7
74366,1329,30,1299,731,0,397,4,0,2
74367,567,9,558,372,0,106,0,0,1
74368,50,0,50,15,0,28,0,0,0
74369,1767,46,1721,1220,6,322,4,0,11
74370,3617,139,3478,2290,3,804,9,5,1
74401,16181,984,15197,7088,3839,2098,114,8,35
74403,29419,2789,26630,15545,1669,5371,309,18,76
74421,4737,271,4466,2931,284,610,7,0,5
74422,733,21,712,379,128,102,3,2,0
74423,905,12,893,595,0,190,0,0,0
74425,932,20,912,709,3,85,5,3,1
74426,9446,244,9202,6336,256,1542,51,2,33
74427,1250,26,1224,761,3,320,2,0,0
74428,899,27,872,623,16,136,1,0,3
74429,15974,776,15198,10669,385,1818,139,8,64
74430,463,7,456,337,0,68,2,0,1
74431,886,20,866,534,7,188,0,0,5
74432,9012,220,8792,6396,221,1232,13,1,21
74434,8889,356,8533,4857,119,2174,29,6,31
74435,2826,49,2777,1638,17,746,17,2,9
74436,4664,238,4426,2956,233,614,21,3,16
74437,9098,326,8772,5747,215,1711,40,17,13
74438,399,8,391,260,1,74,1,0,0
74441,5245,195,5050,2522,15,1733,14,3,14
74442,803,27,776,522,2,151,4,0,0
74445,2788,82,2706,1742,81,484,2,0,12
74446,550,16,534,328,3,119,0,0,1
74447,15534,719,14815,8045,2096,2614,94,4,37
74450,1624,33,1591,994,27,433,12,0,3
74451,3613,158,3455,1967,25,939,8,0,2
74452,424,15,409,223,0,148,1,0,0
74454,2839,115,2724,1740,155,477,9,0,4
74455,2559,46,2513,1676,4,560,13,1,7
74456,123,5,118,65,16,22,0,0,0
74457,479,22,457,202,0,181,3,0,0
74458,213,7,206,104,57,29,0,0,1
74459,52,4,48,7,24,6,0,0,0
74460,374,12,362,262,1,60,0,0,2
74462,7437,417,7020,4955,24,1277,15,2,15
74463,2138,127,2011,1146,511,319,10,4,0
74464,31256,2874,28382,12223,423,10948,262,15,111
74467,13981,422,13559,9031,622,2058,55,4,30
74468,226,1,225,156,0,50,0,0,0
74469,2402,72,2330,1441,79,511,9,0,4
74470,1267,28,1239,747,4,319,5,2,6
74471,1463,54,1409,648,15,473,9,0,5
74472,579,22,557,404,0,83,1,0,1
74477,19,0,19,14,0,2,0,0,0
74501,28566,1742,26824,18209,1118,3930,213,30,47
74521,58,6,52,29,1,19,0,0,2
74522,138,1,137,87,0,33,0,0,0
74523,5908,232,5676,4008,49,988,30,1,6
74525,10314,466,9848,6600,554,1554,47,3,47
74528,166,4,162,93,0,29,0,0,0
74530,178,15,163,117,1,32,0,0,1
74531,949,49,900,702,4,132,8,0,1
74533,850,13,837,628,0,124,0,0,0
74534,223,0,223,143,0,44,0,0,3
74535,79,3,76,60,0,9,0,0,0
74536,1335,20,1315,936,6,275,7,0,5
74538,3771,161,3610,2433,19,743,12,0,13
74540,196,1,195,96,0,70,0,0,3
74543,364,7,357,260,0,35,0,0,0
74546,722,9,713,484,7,120,0,0,1
74547,3196,112,3084,1994,43,641,28,1,7
74549,114,1,113,60,0,33,0,0,0
74552,989,18,971,614,37,195,3,1,2
74553,1197,31,1166,735,6,262,1,0,1
74554,1831,129,1702,1180,31,245,13,0,3
74555,647,14,633,475,2,86,0,0,0
74556,317,7,310,198,2,36,1,0,28
74557,511,21,490,394,1,37,12,0,2
74558,401,8,393,310,1,58,1,0,2
74560,602,19,583,395,0,110,0,0,0
74561,1905,70,1835,1227,7,388,4,0,2
74562,746,44,702,478,5,127,0,0,0
74563,1786,32,1754,1120,3,479,7,0,5
74565,595,10,585,402,3,87,7,0,0
74567,138,7,131,93,2,16,0,0,1
74569,537,7,530,369,5,93,0,1,0
74570,1084,48,1036,771,3,148,1,5,5
74571,3301,81,3220,1643,18,1262,21,2,2
74572,742,22,720,451,2,156,1,0,2
74574,1067,25,1042,669,3,278,2,0,3
74576,181,3,178,115,0,42,0,0,0
74577,235,3,232,152,0,62,0,0,0
74578,5760,269,5491,3710,34,1041,48,4,8
74601,18962,1987,16975,11913,635,2288,97,257,28
74604,12248,649,11599,9470,125,765,99,10,29
74630,785,9,776,669,17,47,5,0,1
74631,6713,574,6139,5143,36,388,39,4,16
74632,444,12,432,392,0,14,0,0,0
74633,420,17,403,263,4,33,3,0,0
74636,225,10,215,198,5,0,2,0,1
74637,1619,61,1558,888,9,444,2,1,3
74640,359,18,341,297,2,11,1,0,0
74641,625,15,610,508,0,33,0,0,0
74643,476,25,451,418,2,14,1,0,1
74644,453,23,430,289,1,92,0,0,1
74646,185,13,172,150,0,4,0,1,2
74647,3563,205,3358,2612,30,404,12,1,1
74650,583,10,573,410,0,94,1,0,0
74651,741,24,717,252,1,391,2,0,6
74652,758,10,748,584,1,58,2,1,0
74653,3677,308,3369,2611,39,437,14,7,5
74701,25823,2340,23483,16058,475,3711,227,3,38
74720,408,13,395,289,5,62,0,0,0
74721,25,2,23,14,0,1,0,0,0
74722,203,3,200,129,0,57,0,0,0
74723,1539,73,1466,995,2,320,2,1,0
74724,191,1,190,119,0,48,0,0,0
74726,2191,79,2112,1577,14,321,2,1,7
74727,1984,84,1900,1203,83,405,3,0,5
74728,11010,781,10229,6565,395,1691,57,317,3
74729,2829,155,2674,1972,8,419,9,1,11
74730,5191,302,4889,3357,54,845,29,1,4
74731,1534,111,1423,1170,14,136,3,0,6
74733,2719,130,2589,1959,109,293,2,1,3
74734,864,20,844,631,28,85,1,0,1
74735,1821,39,1782,1243,26,275,4,0,9
74736,951,51,900,616,21,145,5,0,9
74737,71,1,70,40,0,18,0,0,0
74738,445,11,434,250,75,86,0,0,2
74740,1969,70,1899,1302,193,188,8,0,4
74741,850,45,805,624,21,82,0,3,3
74743,8307,406,7901,4373,1152,1402,20,3,32
74745,9609,835,8774,4949,1712,970,37,143,11
74747,252,9,243,177,0,48,0,0,2
74748,727,56,671,453,1,129,0,3,4
74750,205,6,199,148,12,20,0,0,0
74753,61,2,59,38,1,14,0,0,0
74754,383,11,372,243,3,70,1,0,1
74755,113,3,110,79,0,10,0,0,0
74756,725,10,715,515,9,97,1,0,8
74759,1043,56,987,594,20,266,1,0,0
74760,199,3,196,149,4,26,0,0,2
74761,74,2,72,51,0,9,0,0,1
74764,3252,51,3201,2231,134,374,14,0,10
74766,1209,45,1164,668,39,339,1,0,1
74801,22000,1373,20627,14170,779,3159,92,12,66
74804,22301,1539,20762,15089,822,2320,289,10,40
74820,31630,1965,29665,18344,819,5767,359,10,88
74824,1221,54,1167,936,6,93,0,0,4
74825,2061,66,1995,1340,10,378,5,0,5
74826,1196,51,1145,891,2,146,10,1,2
74827,376,13,363,266,0,58,3,0,0
74829,1441,77,1364,784,382,115,11,0,13
74830,186,9,177,109,1,39,0,1,1
74831,816,51,765,594,11,77,3,2,2
74832,885,31,854,737,9,38,3,0,0
74833,543,15,528,339,48,95,2,0,0
74834,7011,199,6812,5435,231,415,25,5,15
74836,211,9,202,96,1,85,0,0,0
74837,144,3,141,97,3,21,1,0,0
74839,745,29,716,373,8,244,2,4,3
74840,2046,107,1939,1216,44,416,3,3,11
74842,192,8,184,134,0,42,1,0,1
74843,260,11,249,186,0,38,0,0,0
74844,255,7,248,178,0,48,1,0,0
74845,422,12,410,172,29,152,0,0,0
74848,8143,539,7604,4848,651,1360,23,2,20
74849,2898,114,2784,1714,32,701,6,2,9
74850,259,17,242,159,2,45,0,0,0
74851,10759,611,10148,7451,310,1289,71,3,17
74852,1533,84,1449,1175,10,98,2,0,10
74854,1783,58,1725,1272,20,248,1,1,10
74855,4495,135,4360,3526,46,370,16,7,5
74856,710,30,680,457,2,127,2,0,3
74857,9981,607,9374,7513,128,712,60,4,22
74859,6074,160,5914,3434,119,1655,18,0,15
74860,1545,46,1499,1158,42,169,1,0,2
74864,5334,194,5140,4150,113,405,15,1,14
74865,1760,74,1686,1293,7,214,5,1,0
74866,49,0,49,29,0,7,0,0,1
74867,738,44,694,452,11,119,1,0,3
74868,12211,683,11528,7712,285,1994,45,4,58
74869,644,21,623,497,3,48,2,0,3
74871,2290,92,2198,1478,27,417,5,2,3
74872,3379,124,3255,2439,13,430,19,0,10
74873,11496,505,10991,8066,220,1314,38,6,21
74875,1051,14,1037,842,4,96,1,0,4
74878,1392,60,1332,1094,4,124,1,2,0
74880,1832,42,1790,987,105,534,0,0,3
74881,4556,208,4348,3663,55,206,14,1,13
74883,2189,73,2116,1180,59,628,0,5,6
74884,5509,241,5268,2872,573,1111,15,0,13
74901,1832,65,1767,1372,15,140,3,1,4
74902,4239,172,4067,3031,106,462,32,1,0
74930,1875,46,1829,1353,6,326,8,0,1
74931,1251,43,1208,408,2,653,2,1,0
74932,2302,76,2226,1708,9,260,15,0,1
74935,138,1,137,94,1,27,3,0,0
74936,1084,31,1053,648,19,226,8,2,5
74937,5188,1170,4018,2853,9,668,27,5,6
74939,1428,71,1357,896,187,197,3,2,0
74940,2283,132,2151,1621,9,340,8,0,2
74941,2331,65,2266,1603,9,430,8,2,7
74942,150,4,146,89,0,46,0,0,0
74943,78,3,75,59,1,13,0,0,0
74944,1002,37,965,647,2,207,1,2,4
74945,186,8,178,60,1,104,0,0,0
74946,37,1,36,28,5,0,1,0,0
74947,132,3,129,116,0,11,0,0,0
74948,11803,533,11270,7175,108,2343,96,2,31
74949,238,2,236,170,0,51,0,0,0
74951,1332,66,1266,892,13,177,10,0,5
74953,12113,1273,10840,7912,105,1516,93,17,15
74954,4686,211,4475,2802,207,745,30,3,12
74955,14340,750,13590,7936,137,3488,108,2,43
74956,1876,71,1805,1396,8,220,9,2,0
74957,1049,20,1029,675,1,274,0,0,1
74959,6226,198,6028,4144,342,888,48,0,5
74960,11937,926,11011,3680,25,5883,55,7,0
74962,4641,150,4491,2419,91,1364,28,3,10
74963,521,6,515,341,0,127,0,0,0
74964,2372,129,2243,1302,5,625,26,1,9
74965,4525,169,4356,2254,3,1376,77,4,4
74966,3607,158,3449,2459,10,610,16,3,8
75001,16528,3971,12557,7692,2700,54,1321,5,101
75002,69939,10255,59684,39652,7066,277,8982,30,274
75006,47811,23175,24636,14890,4119,133,3982,12,174
75007,53960,14838,39122,22606,5127,165,8829,56,225
75009,21276,3451,17825,15022,961,89,591,13,78
75010,33186,4579,28607,12742,4612,110,9664,24,135
75013,48360,4459,43901,23017,3567,118,14813,24,223
75019,44897,6215,38682,21723,2584,107,12265,25,186
75020,23782,2794,20988,16766,1739,463,217,8,66
75021,8288,901,7387,6186,359,175,29,2,21
75022,26781,2633,24148,17574,646,77,4561,11,118
75023,46777,7677,39100,25399,4549,178,6503,29,246
75024,45469,3678,41791,17690,3314,151,18656,14,220
75025,53161,4600,48561,22252,4484,147,19330,17,261
75028,46830,5427,41403,31323,1765,203,5689,20,191
75032,34590,6959,27631,22161,2685,153,1066,17,123
75033,45347,6164,39183,25921,4049,119,6481,25,209
75034,47734,7159,40575,24555,4935,182,8294,26,289
75035,82596,8006,74590,32613,7352,244,30403,56,444
75036,35148,4352,30796,17423,2813,120,8835,6,174
75038,32928,6775,26153,5813,9026,87,10088,66,196
75039,24569,3361,21208,7403,3415,61,9411,19,131
75040,64035,28846,35189,16322,8995,152,7878,20,238
75041,32219,21170,11049,6817,2628,85,780,10,80
75042,39148,21739,17409,6872,4080,69,5509,13,110
75043,63973,22736,41237,19268,13977,217,5454,27,282
75044,46094,10335,35759,17678,6560,98,9555,8,227
75048,27818,4377,23441,13893,3218,107,4825,34,115
75050,43531,23549,19982,9434,8083,209,994,49,137
75051,40243,26282,13961,5953,6031,96,1069,22,121
75052,96225,36284,59941,19405,26360,334,10506,94,454
75054,15646,2459,13187,4125,6010,27,2229,7,78
75056,67570,13885,53685,32173,6658,239,11242,37,310
75057,16001,7144,8857,5237,2440,61,498,4,43
75058,3799,603,3196,2877,34,47,23,1,7
75060,47955,31616,16339,10017,2318,134,2818,30,139
75061,55828,37122,18706,9848,5100,166,2243,49,269
75062,50466,23767,26699,12293,6946,156,5651,68,269
75063,46598,4076,42522,8925,4932,132,27119,18,225
75065,12770,3099,9671,7866,688,87,372,10,38
75067,68734,22614,46120,23068,11317,183,8294,48,356
75068,66248,15255,50993,28523,11834,266,6573,43,349
75069,39084,12647,26437,19001,4264,151,1345,25,187
75070,57712,7488,50224,27618,8588,216,10655,49,218
75071,64449,9608,54841,36220,8283,252,6715,43,287
75072,55538,6234,49304,35170,4805,193,6200,52,252
75074,53003,18776,34227,17247,6222,146,8500,22,267
75075,36600,6254,30346,21407,2711,101,4436,29,120
75076,8057,389,7668,6965,40,162,33,4,20
75077,38073,5346,32727,25656,2677,135,2442,18,147
75078,38980,4265,34715,25580,3545,190,3238,24,153
75080,53633,11137,42496,30341,3394,160,6304,30,229
75081,37766,6801,30965,16495,6162,104,6469,21,186
75082,28063,2588,25475,13450,3059,54,7634,4,120
75087,40460,5692,34768,28835,2382,177,1360,26,123
75088,26899,5871,21028,14334,3897,136,1408,15,90
75089,34608,7216,27392,15300,6876,112,3522,17,140
75090,25002,8008,16994,12499,2628,250,401,11,74
75092,27186,3478,23708,18637,1975,345,1049,18,89
75093,48081,4700,43381,27789,3443,116,9808,22,216
75094,23864,1848,22016,10565,2373,55,7972,17,83
75098,67212,13244,53968,35585,8298,320,6339,47,296
75101,633,335,298,201,76,1,0,0,1
75102,1501,438,1063,948,50,7,8,4,4
75103,15162,1470,13692,12617,337,96,104,9,31
75104,49749,11989,37760,8814,26059,157,1087,22,198
75105,307,60,247,200,28,2,3,0,2
75109,4766,737,4029,3567,124,24,32,14,11
75110,30336,10626,19710,12733,4946,67,274,685,94
75114,6347,1897,4450,3891,302,25,41,1,15
75115,56164,9303,46861,5647,38992,121,487,13,229
75116,20656,10781,9875,4340,4700,58,246,11,55
75117,4170,386,3784,3416,138,34,19,1,10
75119,28973,11487,17486,13318,3002,60,136,87,68
75124,5093,434,4659,4426,40,15,8,5,2
75125,7545,4212,3333,2376,733,21,21,2,11
75126,64573,13939,50634,31296,14452,250,1604,49,227
75127,1644,176,1468,1380,10,9,3,1,1
75132,135,45,90,31,17,1,8,1,0
75134,20194,5116,15078,1050,13467,44,85,6,97
75135,8065,1642,6423,5834,139,54,31,0,17
75137,20023,7386,12637,4388,7363,49,305,5,69
75140,7538,1165,6373,5986,48,32,28,2,17
75141,5173,2480,2693,598,1975,10,12,1,8
75142,21952,7643,14309,12276,1053,72,104,6,39
75143,15349,2246,13103,11986,229,95,71,5,45
75144,3462,516,2946,2054,651,15,33,9,10
75146,23837,5451,18386,2486,15123,41,78,5,92
75147,7781,824,6957,6311,146,47,105,0,38
75148,5796,785,5011,4122,556,40,27,3,13
75149,60317,28245,32072,15468,13351,190,1257,24,136
75150,64654,30078,34576,16858,13869,195,1884,31,238
75152,5820,2064,3756,3339,145,23,19,1,10
75153,536,241,295,260,12,0,1,0,1
75154,45894,12411,33483,16678,14563,133,335,17,207
75155,3485,1971,1514,1303,113,7,1,7,4
75156,15708,1503,14205,13119,195,100,76,3,37
75157,258,38,220,157,31,8,0,0,0
75158,5214,822,4392,3962,115,37,15,7,13
75159,22127,9632,12495,8248,3426,114,110,17,45
75160,26632,7756,18876,12564,4968,96,257,4,62
75161,7552,1987,5565,4798,384,52,22,2,27
75163,2317,202,2115,1846,135,11,11,2,6
75164,335,58,277,220,11,5,2,1,6
75165,49805,13239,36566,27588,6097,189,398,57,336
75166,5457,976,4481,3367,592,43,203,2,29
75167,12455,2497,9958,8340,993,45,108,4,44
75169,17017,2263,14754,13182,650,101,70,15,40
75172,5519,2936,2583,815,1606,19,11,7,9
75173,7733,2130,5603,4897,229,36,76,8,22
75180,26860,16143,10717,4076,5878,60,226,6,41
75181,27027,9160,17867,5711,10098,74,1136,11,84
75182,7806,836,6970,3879,764,25,2001,9,49
75189,37777,9673,28104,22918,2610,222,691,31,88
75201,17740,2256,15484,11004,2616,61,1048,5,50
75202,2529,408,2121,1319,454,20,194,3,10
75203,14710,8220,6490,1216,4825,30,125,5,65
75204,34012,6565,27447,18688,4919,93,2310,20,162
75205,26299,1806,24493,20677,499,57,2076,2,130
75206,40386,6846,33540,25980,2675,96,2962,18,175
75207,7116,1415,5701,2793,2546,9,205,0,13
75208,29446,17576,11870,8691,1913,79,450,9,73
75209,14740,2831,11909,9059,1810,24,449,2,41
75210,8736,3893,4843,150,4501,20,14,1,33
75211,70695,57502,13193,5946,5537,209,636,35,197
75212,27329,17897,9432,1555,6867,59,503,4,105
75214,35664,6320,29344,24793,1708,114,984,13,215
75215,18806,4321,14485,1459,12402,52,82,5,64
75216,55759,26872,28887,1367,26346,91,153,8,140
75217,85330,62619,22711,4145,17295,145,203,17,170
75218,23136,6065,17071,14362,1264,70,415,13,97
75219,27885,5951,21934,16030,2669,77,1979,12,135
75220,39627,29897,9730,7107,1436,56,507,9,149
75223,13898,9532,4366,2201,1631,33,186,3,47
75224,33766,20303,13463,2888,9300,77,342,5,260
75225,22635,1182,21453,19587,159,54,877,6,66
75226,4535,1311,3224,2043,711,28,206,2,45
75227,59103,37985,21118,4385,15353,113,375,18,195
75228,68219,37619,30600,14495,12685,209,1534,25,224
75229,33168,13635,19533,15789,1100,59,1567,2,78
75230,27810,4464,23346,18496,2171,64,1554,8,106
75231,40754,14265,26489,11713,9401,77,4019,23,105
75232,30061,11595,18466,1262,16558,38,73,7,65
75233,15104,8836,6268,1403,4426,17,95,0,38
75234,33216,16701,16515,11324,2012,90,2115,6,163
75235,19153,9422,9731,4342,2945,56,1825,10,71
75236,18385,8263,10122,1866,7247,47,548,14,69
75237,19057,3715,15342,563,14228,17,78,9,60
75238,32801,7959,24842,16938,5267,73,1449,14,117
75240,25839,14873,10966,6110,3115,46,981,3,124
75241,32944,7596,25348,1538,23007,53,123,0,117
75243,62273,13575,48698,14663,27032,125,4528,24,282
75244,12576,2526,10050,7202,1241,32,1035,5,55
75246,2458,998,1460,846,456,12,61,2,7
75247,830,147,683,233,386,0,19,1,6
75248,38210,6380,31830,24423,3494,78,2087,17,184
75249,15291,6037,9254,1643,6542,31,524,1,74
75251,3840,700,3140,1624,1022,9,369,2,12
75252,27458,3849,23609,14057,3048,55,5242,3,160
75253,25867,18200,7667,3874,3158,71,60,12,62
75254,24664,8279,16385,8029,5784,48,1593,24,155
75261,1,1,0,0,0,0,0,0,0
75270,0,0,0,0,0,0,0,0,0
75287,53181,13205,39976,17919,15516,148,3739,38,364
75390,0,0,0,0,0,0,0,0,0
75401,19550,7167,12383,8482,2917,104,80,39,43
75402,18983,2510,16473,13715,1217,112,331,10,90
75407,25738,8846,16892,12231,2628,150,668,13,117
75409,21292,4851,16441,12440,2238,123,400,21,112
75410,5073,422,4651,4383,16,31,12,0,11
75411,1279,50,1229,1116,22,34,0,1,1
75412,604,28,576,524,23,8,7,0,0
75413,179,11,168,147,0,2,0,0,0
75414,3507,265,3242,2904,35,48,17,6,17
75415,212,13,199,182,1,3,1,0,2
75416,2848,155,2693,2463,52,43,5,0,6
75417,2361,117,2244,2081,27,34,6,0,0
75418,14775,2160,12615,10309,1538,110,95,11,25
75420,1206,166,1040,951,15,6,4,0,1
75421,988,94,894,753,80,10,4,0,2
75422,2902,388,2514,2307,33,31,22,0,7
75423,3089,457,2632,2371,63,25,1,0,5
75424,4517,890,3627,3263,66,33,34,0,13
75426,4717,387,4330,2645,1457,31,25,0,4
75428,11192,1291,9901,6176,2526,106,257,71,49
75429,9,1,8,2,0,0,0,1,0
75431,2101,578,1523,1349,66,6,9,0,2
75432,3361,259,3102,2604,282,20,33,4,19
75433,2815,244,2571,2394,24,17,3,0,18
75434,81,1,80,67,2,1,2,0,0
75435,994,67,927,820,29,21,0,0,7
75436,2130,99,2031,1813,96,25,5,0,4
75437,1199,90,1109,1029,7,32,3,0,0
75438,963,53,910,840,10,3,3,0,10
75439,923,80,843,764,15,6,5,5,7
75440,6894,660,6234,5682,177,40,28,1,19
75441,113,4,109,104,0,2,0,0,0
75442,11241,2851,8390,7342,345,58,79,4,37
75446,3355,418,2937,2477,228,32,5,0,15
75447,1161,54,1107,1052,2,5,3,0,0
75448,679,72,607,543,15,5,3,0,6
75449,1116,70,1046,739,210,18,3,2,0
75450,293,9,284,275,0,2,0,0,0
75451,1256,153,1103,889,104,0,19,2,7
75452,4802,596,4206,3719,93,58,14,1,33
75453,3737,326,3411,3109,64,23,16,2,26
75454,16252,2411,13841,10231,1906,135,642,13,76
75455,27305,12529,14776,11051,2679,80,242,3,67
75457,5991,859,5132,4474,340,23,39,1,39
75459,5556,1023,4533,3978,164,51,29,3,16
75460,22925,2813,20112,12825,5408,339,245,19,51
75462,12016,772,11244,9690,570,155,204,1,29
75468,928,33,895,837,6,11,2,0,6
75469,394,31,363,327,10,0,0,2,1
75470,229,23,206,184,3,4,0,0,0
75471,1243,279,964,890,28,2,8,0,3
75472,3849,315,3534,3256,70,30,27,0,11
75473,3660,139,3521,3096,100,67,4,0,7
75474,16010,2724,13286,12040,159,161,85,10,42
75475,150,17,133,120,0,0,1,0,1
75476,1214,85,1129,1037,15,12,2,0,9
75477,854,69,785,635,91,11,1,0,1
75478,1006,170,836,733,12,4,24,0,4
75479,1861,95,1766,1621,13,15,6,0,2
75480,1582,207,1375,1256,7,5,12,1,7
75481,389,43,346,318,8,2,1,0,0
75482,25743,4737,21006,17473,2216,123,205,4,54
75486,2698,143,2555,2358,24,40,5,4,9
75487,1511,279,1232,1033,103,10,3,1,1
75488,1144,73,1071,1008,14,14,1,0,4
75489,1028,76,952,853,13,22,5,0,1
75490,2809,415,2394,2163,29,29,1,4,8
75491,5148,564,4584,4034,193,56,21,1,3
75492,562,18,544,494,11,4,3,0,0
75493,497,353,144,129,2,2,1,0,1
75494,11827,1592,10235,9236,321,66,102,3,59
75495,9061,1154,7907,7117,210,69,62,1,14
75496,3438,410,3028,2677,160,30,16,3,11
75497,3679,399,3280,3104,17,12,9,0,12
75501,36423,3291,33132,17763,13147,216,166,31,165
75503,25547,1578,23969,16899,4887,133,756,14,99
75550,602,77,525,423,80,1,4,0,1
75551,10372,442,9930,7444,1991,38,45,3,39
75554,1530,79,1451,1302,72,15,5,1,4
75555,1719,70,1649,1387,143,14,7,1,0
75556,1131,52,1079,983,42,5,3,0,0
75558,1518,357,1161,1048,22,10,4,0,1
75559,5472,334,5138,4138,684,68,31,1,8
75560,920,28,892,583,250,0,5,0,2
75561,4875,330,4545,3535,691,21,22,1,9
75562,116,11,105,83,18,0,0,0,1
75563,3794,214,3580,2770,561,26,17,0,25
75564,9,0,9,7,0,0,0,0,0
75565,106,6,100,91,0,0,0,0,0
75566,676,27,649,422,189,1,4,0,2
75567,3770,105,3665,3336,163,18,7,3,7
75568,2939,208,2731,2012,499,29,15,3,8
75569,3338,542,2796,1517,1051,17,34,4,19
75570,11315,1346,9969,6756,2416,62,66,12,22
75571,2607,237,2370,1813,397,22,7,2,11
75572,3387,110,3277,2507,577,35,22,2,4
75573,275,9,266,236,13,0,0,0,0
75574,1695,54,1641,1552,3,15,0,2,1
75601,15813,3400,12413,8175,3356,59,182,7,41
75602,22041,6999,15042,6596,7497,79,144,14,52
75603,5784,1041,4743,2766,1720,31,28,2,8
75604,30752,5960,24792,17094,5773,98,375,7,93
75605,32909,3065,29844,23417,4056,102,818,9,89
75630,2650,129,2521,2058,261,22,11,1,21
75631,2461,211,2250,1899,259,3,4,0,1
75633,13558,1606,11952,9340,2085,44,77,4,13
75638,5434,586,4848,3369,1247,21,8,2,8
75639,2716,105,2611,1864,631,11,4,0,1
75640,5438,404,5034,4352,305,34,34,0,27
75641,139,32,107,22,80,0,0,1,0
75642,194,23,171,127,14,5,2,0,1
75643,2046,139,1907,1701,97,18,5,1,5
75644,11720,1229,10491,8696,1042,48,55,4,30
75645,10724,1038,9686,8468,609,70,26,0,58
75647,13485,1279,12206,9819,1540,60,78,6,30
75650,10139,740,9399,8003,757,44,89,7,40
75651,2075,96,1979,1740,147,6,5,1,8
75652,15956,2996,12960,8584,3816,40,68,6,50
75654,12045,2964,9081,7444,1135,39,73,3,32
75656,4558,312,4246,3528,503,19,8,1,9
75657,7923,331,7592,5418,1688,48,35,3,25
75658,210,40,170,134,25,4,0,0,0
75659,59,7,52,34,15,0,0,0,0
75661,2381,277,2104,1377,606,17,11,1,2
75662,25002,5218,19784,15500,2927,86,161,8,62
75667,1227,156,1071,813,210,5,2,1,1
75668,1672,194,1478,1006,371,9,13,2,3
75669,589,33,556,419,93,10,0,2,0
75670,16935,3919,13016,5711,6671,65,56,8,98
75671,0,0,0,0,0,0,0,0,0
75672,17285,2442,14843,10458,3588,57,180,4,59
75680,14,1,13,10,3,0,0,0,0
75681,2674,198,2476,1967,422,8,6,1,4
75682,563,50,513,452,31,1,3,1,0
75683,3773,501,3272,2759,242,44,15,0,12
75684,6744,1049,5695,4309,1011,41,23,2,28
75686,13293,3438,9855,7196,2007,34,110,6,30
75687,7,5,2,0,1,0,0,0,0
75689,212,59,153,131,13,4,0,0,2
75691,4025,878,3147,2383,582,13,6,1,6
75692,5098,675,4423,3439,733,34,19,0,14
75693,6512,579,5933,5323,197,42,33,4,13
75694,0,0,0,0,0,0,0,0,0
75701,34502,7323,27179,17779,7504,93,495,12,117
75702,26777,12506,14271,3247,10276,44,113,1,68
75703,44428,4270,40158,29963,6051,130,2024,27,176
75704,10075,3425,6650,4150,2080,31,71,3,27
75705,2141,626,1515,555,875,8,6,1,5
75706,10313,4601,5712,3786,1565,30,56,2,18
75707,16620,2314,14306,11552,1484,48,505,2,61
75708,8294,3812,4482,2815,1335,33,50,5,9
75709,6037,1133,4904,3107,1438,18,116,2,15
75711,135,12,123,83,35,0,5,0,0
75750,3777,445,3332,2930,214,31,11,7,5
75751,17100,4313,12787,9800,2117,55,155,13,51
75752,7439,1064,6375,5733,281,32,38,0,29
75754,6632,919,5713,5123,247,40,16,2,7
75755,5250,393,4857,4184,310,32,10,4,17
75756,4458,580,3878,3601,105,30,10,0,7
75757,13330,892,12438,11244,470,54,85,2,34
75758,9890,701,9189,8079,567,38,72,0,23
75759,122,23,99,24,69,0,0,0,1
75760,2583,260,2323,1963,208,10,13,3,3
75762,13923,1198,12725,10646,1259,59,136,1,44
75763,5663,424,5239,4453,448,30,25,1,12
75764,178,46,132,119,6,2,0,0,3
75765,7728,347,7381,6336,570,37,31,0,32
75766,25382,8484,16898,12468,3432,58,155,10,65
75770,2893,165,2728,2202,396,9,2,0,15
75771,21870,2079,19791,17444,1100,90,193,4,77
75773,13559,2100,11459,10159,581,76,75,1,28
75778,3467,441,3026,2787,69,11,12,0,6
75779,80,16,64,53,5,0,0,0,0
75780,481,408,73,70,2,0,0,0,0
75782,85,7,78,64,1,3,0,0,0
75783,7763,698,7065,6399,225,34,38,0,20
75784,542,86,456,361,78,2,1,0,0
75785,10687,1355,9332,7154,1697,24,58,5,33
75788,99,15,84,68,4,2,0,0,1
75789,8045,878,7167,6050,750,37,38,2,12
75790,4359,629,3730,3406,72,25,29,0,14
75791,14255,1364,12891,11063,962,48,229,5,32
75792,3595,582,3013,2277,568,16,15,2,2
75801,16859,3752,13107,9078,3204,78,149,7,45
75803,22290,4523,17767,12399,4547,55,166,3,42
75831,4865,1212,3653,3205,274,12,31,3,1
75833,3259,258,3001,2614,263,8,20,0,11
75835,11342,1818,9524,5885,3198,51,72,3,28
75838,525,51,474,415,25,5,6,0,5
75839,5282,371,4911,4401,254,36,15,2,12
75840,7029,1213,5816,4537,959,34,40,0,19
75844,5144,241,4903,3986,646,24,43,4,23
75845,2784,213,2571,2246,212,2,0,1,3
75846,2327,493,1834,1656,61,7,21,2,12
75847,1547,70,1477,1236,179,2,1,0,4
75848,88,10,78,73,0,1,0,0,1
75849,95,8,87,82,1,0,0,0,2
75850,596,65,531,463,49,0,4,0,0
75851,4869,975,3894,2617,1141,17,22,1,2
75852,3621,982,2639,1367,1208,6,18,0,0
75853,970,82,888,748,88,3,6,1,1
75855,2242,129,2113,1460,562,12,8,1,9
75856,195,2,193,162,16,1,0,1,0
75858,100,15,85,68,12,0,0,0,1
75859,2212,196,2016,1822,114,10,7,3,2
75860,6623,1426,5197,3965,1049,10,10,9,9
75861,1410,109,1301,1031,187,5,14,0,6
75862,9364,1050,8314,7053,773,24,30,0,30
75865,22,6,16,9,5,0,0,2,0
75884,4156,1296,2860,1259,1582,2,14,0,0
75886,2959,706,2253,921,1324,0,7,0,0
75901,28373,7968,20405,14602,4514,52,437,16,63
75903,133,21,112,71,37,0,0,0,0
75904,34680,7208,27472,18927,6797,92,402,4,94
75925,3635,587,3048,2219,694,4,9,0,0
75926,1066,48,1018,899,78,3,0,0,0
75928,1181,14,1167,643,469,5,2,0,3
75929,1415,47,1368,1292,20,5,4,0,0
75930,1954,67,1887,1759,55,13,2,0,0
75931,2446,50,2396,2186,116,14,7,3,3
75932,1331,36,1295,1102,120,9,4,0,4
75933,1290,26,1264,1063,157,4,0,0,2
75934,71,3,68,24,37,1,0,0,1
75935,13060,3141,9919,6855,2393,19,334,14,34
75936,848,68,780,689,64,5,1,0,4
75937,1081,131,950,802,74,5,5,0,8
75938,2432,120,2312,2124,68,21,3,0,8
75939,3716,1008,2708,1849,728,7,27,0,3
75941,8622,3319,5303,3937,1139,17,28,8,11
75942,125,1,124,65,51,0,0,0,0
75943,1300,121,1179,1038,75,6,10,2,5
75944,1138,16,1122,1067,0,2,0,0,2
75946,3452,321,3131,2345,558,13,25,0,11
75948,5582,236,5346,4725,335,32,42,0,29
75949,8052,429,7623,7046,237,26,17,2,16
75951,14370,1499,12871,7826,4467,36,78,10,40
75954,3233,336,2897,2597,153,15,17,0,6
75956,7435,359,7076,5907,781,45,9,1,12
75959,821,28,793,724,37,1,7,0,5
75960,816,164,652,474,147,3,1,0,2
75961,15656,2657,12999,8022,4185,42,139,0,68
75962,2712,621,2091,1704,309,8,9,0,0
75964,19986,7574,12412,8445,3275,61,116,2,52
75965,17652,1925,15727,12222,2264,47,456,3,47
75966,4209,127,4082,2905,976,19,8,0,11
75968,1819,77,1742,1427,252,5,2,0,1
75969,4301,712,3589,3368,132,1,6,0,12
75972,5899,580,5319,3328,1815,8,25,0,0
75973,2290,107,2183,1776,340,5,4,0,0
75974,2860,797,2063,1498,431,15,13,0,7
75975,3373,334,3039,2382,494,10,9,0,8
75976,1047,82,965,797,114,0,3,1,0
75977,570,14,556,297,221,3,1,0,5
75979,10354,1159,9195,6996,1742,43,61,3,22
75980,2453,87,2366,2206,25,13,1,0,2
76001,34102,7574,26528,14434,8111,102,2285,37,145
76002,35021,8487,26534,7584,12273,83,5004,34,172
76005,4412,513,3899,1997,602,8,1068,8,30
76006,25320,5230,20090,7979,9420,104,1403,30,144
76008,21844,2223,19621,18045,268,74,247,14,52
76009,23376,8312,15064,13163,543,108,223,14,83
76010,55894,32891,23003,8689,9840,179,2895,43,198
76011,23158,8741,14417,5718,7003,76,733,20,76
76012,27080,7280,19800,13790,3807,70,1005,27,102
76013,36535,6899,29636,19535,5215,128,3013,22,201
76014,35954,15674,20280,5968,9520,86,3638,52,141
76015,17185,4871,12314,7185,3476,73,861,18,79
76016,31091,4644,26447,19854,2914,107,2044,30,94
76017,45745,9290,36455,22355,9126,171,2650,54,214
76018,27784,9359,18425,6212,7395,42,3679,56,112
76020,33469,4438,29031,26586,391,171,218,20,75
76021,35265,5407,29858,22113,3556,116,2095,216,133
76022,14692,3053,11639,7897,2137,68,531,201,58
76023,6825,801,6024,5514,37,58,22,1,22
76028,74023,12042,61981,53847,3201,341,924,63,289
76031,18398,5552,12846,11052,577,72,95,254,54
76033,27243,6363,20880,18364,797,118,154,261,64
76034,25988,1847,24141,19629,618,75,2587,20,98
76035,2649,398,2251,1914,172,21,9,6,9
76036,31589,8045,23544,14648,6527,110,742,32,126
76039,39997,7519,32478,17754,5809,103,6294,471,220
76040,31899,6693,25206,10703,7574,107,4464,813,273
76041,395,123,272,240,9,3,3,0,5
76043,7060,1361,5699,5307,32,37,45,0,27
76044,5715,803,4912,4532,86,33,19,1,3
76048,25764,4148,21616,20041,182,155,195,5,74
76049,30784,3530,27254,25408,163,150,255,40,77
76050,7315,944,6371,5821,123,35,35,6,33
76051,49969,10028,39941,32196,2213,166,3029,59,194
76052,26675,4718,21957,17433,2209,98,694,22,134
76053,31935,9089,22846,15390,4217,137,1378,259,103
76054,12120,1365,10755,9158,383,55,508,19,16
76055,3076,940,2136,1740,215,17,19,1,8
76058,20940,5257,15683,14199,297,144,80,30,50
76059,4928,1619,3309,2410,229,14,86,315,51
76060,8653,1676,6977,4896,1157,50,389,5,20
76061,192,46,146,115,9,3,1,0,1
76063,76914,14739,62175,38469,15547,283,3919,54,338
76064,1929,326,1603,1391,63,25,24,1,3
76065,42827,7019,35808,29787,3486,211,438,28,138
76066,3816,388,3428,3205,11,20,10,1,8
76067,20473,4775,15698,14086,544,94,178,11,46
76070,601,56,545,506,0,1,0,0,4
76071,4220,998,3222,2840,94,45,27,2,20
76073,6579,663,5916,5555,18,45,9,3,26
76077,555,50,505,479,0,8,6,0,0
76078,9979,2164,7815,6992,183,64,68,0,35
76082,21514,3032,18482,16902,132,153,97,16,67
76084,11979,4178,7801,5790,1220,50,256,9,49
76085,12249,1915,10334,9469,105,80,54,11,39
76086,21429,3702,17727,15877,474,126,204,19,75
76087,33346,4194,29152,26943,301,209,229,13,99
76088,13794,1566,12228,11300,103,110,46,8,61
76092,31924,2463,29461,21947,765,57,4923,13,152
76093,2271,304,1967,1848,17,5,4,0,3
76102,13236,2590,10646,6772,3189,72,243,10,37
76103,15394,7913,7481,3735,2911,67,323,8,57
76104,21571,9027,12544,3967,7434,69,558,6,49
76105,23445,14679,8766,1071,7100,26,143,13,70
76106,36521,29879,6642,2960,2824,69,303,20,69
76107,31591,7076,24515,18034,4332,96,868,17,111
76108,46170,12265,33905,26612,3500,204,1094,89,190
76109,25373,2955,22418,18374,1601,107,1227,16,132
76110,29858,18736,11122,8883,1038,60,501,9,56
76111,22512,15505,7007,4597,956,63,903,7,53
76112,43132,12113,31019,9523,18617,126,1110,47,136
76114,26676,14281,12395,10488,742,120,241,28,61
76115,20956,15578,5378,1937,2183,18,961,10,36
76116,51639,14289,37350,24818,9019,198,1094,49,203
76117,33398,16187,17211,11696,1915,103,2461,48,77
76118,16537,3938,12599,8727,1582,50,1280,111,55
76119,50850,23579,27271,4970,19468,101,1795,23,92
76120,19240,4334,14906,4641,8284,45,1125,10,118
76123,37981,10059,27922,9521,14051,91,2640,33,167
76126,25444,3562,21882,19193,874,111,575,14,56
76127,2214,660,1554,1079,330,66,36,1,4
76129,2579,285,2294,944,735,1,583,0,11
76131,48515,13609,34906,21044,6020,189,5178,101,251
76132,26249,4500,21749,13441,5801,87,1342,16,105
76133,51811,19187,32624,17414,11746,136,1394,40,159
76134,27362,11510,15852,4830,9148,89,965,12,71
76135,22009,6274,15735,12574,1642,92,412,30,108
76137,60555,15599,44956,28191,7379,243,6094,102,286
76140,32623,13963,18660,7100,10006,78,509,8,118
76148,23587,6380,17207,13697,959,110,1120,115,118
76155,5647,1066,4581,1354,2169,10,737,18,73
76164,15602,14047,1555,1002,327,22,38,5,39
76177,23001,4478,18523,11551,3162,72,2600,11,88
76179,68333,18768,49565,36577,6160,279,3252,83,264
76180,37087,8009,29078,21733,3429,156,1761,134,163
76182,31117,4518,26599,22636,1211,107,1102,38,109
76201,27610,6145,21465,14599,3379,138,2078,51,107
76203,224,57,167,83,59,1,23,1,0
76205,18969,4765,14204,9684,2787,75,750,22,50
76207,16097,3675,12422,9976,1335,103,322,13,60
76208,27084,7637,19447,14201,2571,113,1110,31,127
76209,28088,8462,19626,14339,3104,133,552,16,71
76210,46211,9255,36956,28553,3597,191,2104,34,168
76225,3789,400,3389,3146,20,35,17,0,4
76226,37214,4313,32901,28190,1160,176,1601,19,146
76227,47118,8249,38869,26897,7621,212,1093,51,285
76228,1001,46,955,913,4,5,1,0,1
76230,9992,1211,8781,8155,43,79,46,2,16
76233,3719,451,3268,3042,19,25,8,0,9
76234,18755,3928,14827,13718,139,106,136,6,38
76238,447,47,400,373,2,2,2,0,6
76239,1022,98,924,862,0,8,0,0,5
76240,28349,6817,21532,18653,1109,235,260,12,72
76241,5,0,5,4,0,1,0,0,0
76244,77154,14586,62568,43362,7290,280,7076,131,349
76245,1954,105,1849,1705,6,42,4,0,1
76247,17178,3113,14065,11871,856,118,237,17,40
76248,40894,4317,36577,30022,1317,156,3052,26,168
76249,9411,1927,7484,6643,205,63,68,7,28
76250,945,21,924,881,5,11,10,0,2
76251,719,43,676,648,0,4,1,0,1
76252,2851,152,2699,2529,7,35,6,0,10
76253,191,11,180,163,2,1,0,0,0
76255,5448,825,4623,4291,19,42,33,1,7
76258,7409,2024,5385,4690,163,62,28,7,18
76259,6321,1278,5043,4547,115,44,51,2,21
76261,242,24,218,181,0,5,0,0,0
76262,42592,5485,37107,29979,1873,183,2788,33,145
76263,48,0,48,45,2,0,0,0,0
76264,1497,75,1422,1313,5,25,3,0,0
76265,1585,114,1471,1362,3,6,1,1,1
76266,16779,3250,13529,12007,400,86,125,6,77
76267,147,12,135,124,0,0,0,0,0
76268,220,30,190,167,4,4,8,0,1
76270,2217,181,2036,1917,11,18,6,0,10
76271,1879,282,1597,1455,12,20,8,0,3
76272,5494,1186,4308,3939,39,38,22,1,21
76273,9857,972,8885,8144,48,107,51,2,14
76301,15320,5145,10175,6199,3072,113,105,3,52
76302,12400,2598,9802,7467,1353,94,166,16,55
76305,5151,636,4515,3971,175,42,85,3,16
76306,14664,3688,10976,7074,2541,171,315,18,55
76308,20305,3275,17030,13645,1705,111,502,14,136
76309,13053,3653,9400,7578,752,125,331,8,28
76310,20204,2718,17486,14411,1066,129,824,25,73
76311,6349,979,5370,3916,810,25,179,40,19
76351,1817,127,1690,1565,14,20,2,0,5
76354,11496,1255,10241,9003,345,100,93,6,30
76357,685,63,622,558,2,15,3,0,2
76360,2886,350,2536,2230,117,12,12,1,6
76363,231,68,163,140,9,0,1,0,2
76364,181,21,160,145,1,2,6,0,1
76365,4775,257,4518,4237,23,27,32,0,17
76366,2023,104,1919,1803,1,16,4,0,3
76367,13457,1904,11553,9415,1459,122,56,6,21
76370,238,25,213,188,0,4,1,0,0
76371,1513,587,926,795,72,3,12,0,3
76372,869,100,769,713,3,5,1,0,1
76373,161,33,128,118,3,1,2,0,0
76374,3883,825,3058,2782,87,12,29,0,9
76377,592,39,553,481,1,4,2,0,2
76379,519,101,418,390,4,4,0,0,5
76380,3522,447,3075,2843,53,12,9,0,8
76384,12374,3660,8714,6608,1008,93,557,0,29
76388,200,49,151,146,0,1,0,0,0
76389,1213,221,992,968,2,2,3,0,0
76401,30144,5861,24283,21832,932,153,311,9,63
76402,980,230,750,488,217,4,0,0,0
76424,8417,2135,6282,5681,236,31,57,1,26
76426,11727,3734,7993,7286,198,61,62,1,11
76427,643,49,594,577,0,4,2,0,0
76429,207,28,179,170,1,0,2,0,0
76430,2317,289,2028,1930,17,5,11,0,2
76431,3517,564,2953,2798,14,28,8,0,7
76432,1261,195,1066,1011,5,10,5,0,4
76433,1998,163,1835,1693,6,16,9,0,5
76435,691,113,578,546,5,4,2,1,0
76436,272,52,220,206,1,4,0,0,1
76437,5770,691,5079,4637,144,40,22,2,12
76439,28,5,23,20,0,1,0,0,0
76442,7573,2347,5226,4907,21,25,31,1,7
76443,1685,111,1574,1514,0,11,1,0,2
76444,3676,936,2740,2593,15,11,3,2,11
76445,323,57,266,255,3,2,0,0,1
76446,8534,2965,5569,5207,39,28,27,3,36
76448,5417,951,4466,4165,72,16,41,2,4
76449,2542,252,2290,2178,2,12,4,0,4
76450,13026,2545,10481,9866,83,66,57,0,29
76452,111,53,58,56,0,0,0,0,0
76453,1177,80,1097,1037,0,3,5,0,5
76454,1492,426,1066,1000,4,6,3,4,0
76455,804,270,534,515,3,0,0,0,2
76457,3770,520,3250,3052,10,30,17,2,6
76458,6042,1319,4723,4210,293,20,36,5,7
76459,184,17,167,157,0,4,1,0,0
76460,394,21,373,356,2,1,0,0,2
76462,3820,343,3477,3271,9,23,13,4,19
76463,499,42,457,427,1,2,0,0,1
76464,505,52,453,428,1,2,1,0,1
76466,156,33,123,119,0,0,1,0,2
76469,88,6,82,78,0,1,0,0,0
76470,3072,561,2511,2280,103,29,24,1,4
76471,1712,188,1524,1430,4,8,4,6,3
76472,1432,152,1280,1200,2,7,6,1,7
76474,237,13,224,218,0,0,2,0,0
76475,877,222,655,613,5,6,3,0,2
76476,3056,192,2864,2718,10,14,7,1,11
76481,196,36,160,143,0,1,2,0,1
76483,963,101,862,829,1,2,1,0,0
76484,1020,85,935,858,6,18,11,1,3
76486,1273,132,1141,1065,3,14,1,0,12
76487,3238,382,2856,2640,24,22,3,0,12
76490,99,21,78,71,1,0,0,0,0
76491,387,36,351,342,0,1,1,0,0
76501,16987,5586,11401,7522,2993,69,74,15,62
76502,47297,9395,37902,28727,4838,161,1641,88,215
76504,24682,7674,17008,11011,4371,79,352,53,100
76511,2451,1045,1406,1134,169,4,10,2,11
76513,43698,11033,32665,26727,2708,164,721,60,169
76518,1220,388,832,784,11,0,1,1,6
76519,560,119,441,404,15,2,3,0,4
76520,8068,2391,5677,4306,1112,18,27,6,16
76522,41123,8096,33027,20716,6800,212,1078,844,272
76523,181,25,156,139,2,1,0,0,0
76524,2700,512,2188,2029,44,7,5,0,8
76525,1021,166,855,791,4,7,5,0,0
76527,4688,1499,3189,2856,49,30,31,4,13
76528,18773,2788,15985,14271,648,85,113,20,41
76530,2654,690,1964,1786,85,3,3,2,14
76531,4695,567,4128,3952,18,13,20,1,12
76534,2659,446,2213,2021,63,8,5,1,10
76537,10943,4047,6896,5535,647,33,140,14,46
76538,952,106,846,781,7,8,5,0,3
76539,8960,1268,7692,6277,519,56,165,51,56
76541,19641,6591,13050,5289,5700,72,519,239,127
76542,53312,13167,40145,14729,17718,193,2315,806,415
76543,30545,7935,22610,7665,11135,116,943,472,200
76544,28404,6877,21527,13542,4551,179,1029,355,116
76548,32714,7271,25443,13500,7179,132,1511,412,186
76549,56199,15096,41103,13018,20406,231,2120,1077,416
76550,12840,2554,10286,9365,151,61,90,24,57
76554,2139,456,1683,1544,12,14,16,2,4
76556,1503,164,1339,1216,59,6,10,0,1
76557,5318,1049,4269,3838,128,19,21,3,14
76559,6354,1567,4787,3108,1056,39,116,49,24
76561,1062,196,866,798,15,4,2,0,2
76565,73,2,71,71,0,0,0,0,0
76566,355,34,321,274,2,8,4,1,2
76567,9163,2489,6674,5494,732,22,49,4,51
76569,2661,725,1936,1764,52,9,7,0,10
76570,2376,571,1805,1437,269,10,15,0,9
76571,8937,1291,7646,7065,114,35,55,6,35
76573,26,5,21,21,0,0,0,0,0
76574,19366,7542,11824,9426,1538,67,121,9,53
76577,3262,554,2708,2495,71,12,10,0,8
76578,1817,442,1375,1208,66,5,7,0,13
76579,5120,1032,4088,3712,109,27,8,1,9
76596,1159,328,831,470,354,0,7,0,0
76597,3233,940,2293,1118,1159,1,15,0,0
76598,440,125,315,219,94,0,1,0,0
76599,1367,301,1066,677,377,4,7,0,1
76621,996,99,897,850,13,0,3,0,1
76622,1148,92,1056,958,26,7,3,0,7
76623,208,90,118,96,9,0,3,0,1
76624,2487,264,2223,2012,47,10,3,1,5
76626,1662,145,1517,1380,36,11,8,5,6
76627,1687,205,1482,1383,8,7,5,3,2
76628,87,28,59,54,0,0,0,0,0
76629,1980,143,1837,1474,257,8,19,2,12
76630,1878,339,1539,1367,32,10,25,1,12
76631,394,53,341,304,12,4,0,0,1
76632,1544,694,850,641,157,1,3,2,8
76633,5665,643,5022,4666,55,22,26,8,17
76634,7313,1349,5964,5385,110,22,43,2,11
76635,1138,416,722,441,234,12,5,0,0
76636,1502,156,1346,1256,19,7,7,0,3
76637,485,57,428,406,5,0,1,0,0
76638,3130,256,2874,2701,25,14,14,0,3
76639,1621,196,1425,1196,142,0,6,3,0
76640,3063,589,2474,2065,201,24,20,3,16
76641,1761,438,1323,1187,59,7,3,2,4
76642,6641,1236,5405,4211,859,16,98,1,23
76643,16044,2780,13264,10425,1592,57,526,16,39
76645,11274,4092,7182,5502,1149,29,84,6,36
76648,2520,278,2242,1794,308,15,8,1,2
76649,762,122,640,616,0,3,0,0,3
76650,46,8,38,28,3,0,0,0,0
76651,3373,773,2600,2100,385,11,9,5,0
76652,1078,47,1031,976,0,10,0,0,1
76653,1145,91,1054,951,52,8,1,0,6
76654,132,22,110,103,5,0,0,0,0
76655,10227,1377,8850,7796,418,47,185,5,27
76656,2229,265,1964,1725,148,7,1,0,10
76657,11444,2878,8566,7358,582,45,106,10,30
76660,484,116,368,318,26,6,0,0,2
76661,7982,2043,5939,2752,2945,23,32,3,7
76664,3269,445,2824,2024,602,20,5,2,10
76665,2390,480,1910,1693,77,15,28,0,0
76666,305,90,215,184,13,0,0,0,0
76667,10801,3049,7752,4921,2409,27,44,13,28
76670,1512,466,1046,781,184,10,8,2,1
76671,1988,368,1620,1495,7,15,3,1,1
76673,1176,209,967,860,44,8,1,0,0
76676,315,93,222,189,12,1,2,0,2
76678,111,21,90,78,4,0,0,0,0
76679,1442,175,1267,1127,45,11,4,2,0
76680,284,50,234,195,31,1,0,0,0
76681,520,191,329,255,27,4,16,0,0
76682,2798,355,2443,2188,105,14,5,0,21
76685,91,35,56,29,23,0,0,0,0
76686,242,21,221,198,23,0,0,0,0
76687,1500,104,1396,1291,34,2,12,3,6
76689,3991,629,3362,3063,71,9,7,1,21
76690,1473,430,1043,970,8,14,1,0,2
76691,6588,761,5827,5418,116,25,3,2,13
76692,10562,1218,9344,8557,242,39,53,3,23
76693,1866,290,1576,1278,216,5,4,1,3
76701,1674,414,1260,817,311,5,52,0,19
76704,7220,1323,5897,716,4845,35,48,0,39
76705,31736,9300,22436,14779,6229,120,153,19,82
76706,39303,11491,27812,19418,5033,143,1474,27,318
76707,16227,8130,8097,3178,4337,42,73,4,49
76708,28499,9326,19173,13709,4039,54,266,11,131
76710,24874,6634,18240,12634,4380,73,280,11,89
76711,9806,5913,3893,2513,996,20,124,6,42
76712,27800,4128,23672,19202,2013,103,1139,17,88
76798,2473,369,2104,1520,110,7,328,5,4
76801,25401,6434,18967,16594,1212,64,169,27,75
76802,5503,789,4714,4316,54,31,77,0,8
76820,104,2,102,100,0,0,0,0,0
76821,4618,1555,3063,2801,84,18,15,5,13
76823,2784,531,2253,2026,69,20,10,0,0
76824,6,0,6,6,0,0,0,0,0
76825,6592,2218,4374,4067,91,7,39,0,11
76827,390,25,365,344,3,2,3,0,0
76828,175,17,158,137,1,2,2,0,1
76831,31,3,28,27,0,0,0,0,0
76832,551,79,472,444,2,0,0,0,6
76834,4991,849,4142,3831,96,25,22,0,23
76836,54,7,47,46,0,0,0,0,0
76837,2313,869,1444,1320,67,8,14,1,4
76841,73,12,61,57,0,1,0,0,0
76842,218,39,179,172,0,0,1,0,2
76844,3334,640,2694,2524,17,8,4,0,5
76845,183,11,172,164,2,0,1,0,0
76848,68,6,62,62,0,0,0,0,0
76849,3482,904,2578,2442,6,12,34,1,11
76852,215,39,176,167,0,0,0,0,1
76853,1543,446,1097,998,17,10,10,0,11
76854,377,35,342,327,2,0,0,2,0
76856,3574,831,2743,2635,4,0,1,0,14
76857,1829,164,1665,1573,9,4,2,0,4
76858,213,78,135,127,1,0,0,0,0
76859,1905,658,1247,1172,12,8,5,2,8
76861,2116,734,1382,1306,4,6,3,2,4
76862,230,6,224,212,0,0,0,0,2
76864,707,49,658,614,5,2,0,0,0
76865,123,23,100,92,0,4,0,0,0
76866,627,140,487,458,1,1,5,0,10
76869,52,6,46,41,0,0,0,0,0
76870,59,0,59,58,0,0,0,0,0
76871,648,70,578,536,0,6,0,0,0
76872,602,45,557,522,2,0,0,0,0
76873,65,10,55,53,0,0,0,0,0
76874,55,19,36,34,0,0,0,0,0
76875,604,90,514,494,1,2,0,0,0
76877,4374,1580,2794,2578,103,23,16,1,4
76878,1492,240,1252,1140,42,4,3,0,4
76880,16,3,13,12,1,0,0,0,0
76882,309,27,282,265,1,2,2,0,0
76884,117,27,90,85,0,2,1,0,1
76885,133,12,121,116,0,0,0,0,4
76887,118,10,108,104,0,0,0,0,0
76888,117,6,111,111,0,0,0,0,0
76890,878,82,796,745,2,7,3,0,5
76901,31084,11964,19120,16737,839,103,324,15,110
76902,5,1,4,2,2,0,0,0,0
76903,32215,18552,13663,11125,1255,103,220,33,76
76904,36736,9368,27368,23645,1227,99,861,68,111
76905,13635,5839,7796,6606,419,38,207,16,60
76908,1515,284,1231,885,172,5,64,6,2
76909,195,78,117,76,22,0,5,1,0
76930,115,21,94,90,0,0,0,0,1
76932,3379,2291,1088,953,33,12,19,1,6
76933,1319,280,1039,1006,0,1,2,1,2
76934,1336,268,1068,928,57,4,14,0,3
76935,1714,271,1443,1368,9,2,5,1,2
76936,2357,1265,1092,1025,15,4,6,2,8
76937,122,19,103,90,0,0,0,1,0
76939,28,4,24,23,0,0,0,0,0
76940,128,65,63,54,0,0,2,0,3
76941,1273,315,958,918,6,7,0,1,1
76943,3027,1894,1133,1043,17,9,10,0,7
76945,1745,389,1356,1266,7,11,0,4,4
76950,3379,2096,1283,1201,6,5,7,0,14
76951,1372,449,923,867,3,4,1,2,2
76953,51,5,46,44,0,0,0,0,0
76955,137,23,114,111,0,0,0,0,0
76957,68,6,62,56,0,0,0,0,0
76958,301,47,254,221,6,8,0,0,0
77002,19844,4572,15272,7559,6040,40,989,88,63
77003,11874,4644,7230,3350,2694,34,722,3,62
77004,37005,5692,31313,9938,15333,78,4652,15,160
77005,28241,3192,25049,18453,743,30,4392,12,245
77006,24129,4280,19849,15201,1284,41,2146,51,139
77007,42908,8705,34203,25198,2332,50,4561,15,190
77008,36631,7898,28733,23448,1377,69,2051,9,161
77009,36425,20974,15451,11076,2535,59,714,11,129
77010,883,105,778,669,42,0,44,0,1
77011,16841,15227,1614,935,384,42,111,3,30
77012,18397,16906,1491,547,575,12,206,2,48
77013,16815,12232,4583,1342,2907,11,116,3,52
77014,35161,14324,20837,1964,14783,46,3184,53,198
77015,57106,40119,16987,5865,9528,92,702,14,122
77016,29966,11985,17981,544,16810,28,92,1,93
77017,31659,26412,5247,2183,1449,57,1281,1,79
77018,27870,8185,19685,15171,2175,41,1041,9,131
77019,24136,3694,20442,14950,2225,33,2151,12,144
77020,24846,16941,7905,1210,6052,62,183,4,43
77021,28055,5036,23019,2401,19029,52,739,10,86
77022,28748,20919,7829,1837,5392,42,162,4,87
77023,26780,21287,5493,3399,1158,69,434,7,79
77024,39565,4781,34784,25510,1184,60,6344,7,222
77025,28510,5276,23234,12689,3996,40,5320,19,127
77026,23405,11284,12121,583,10983,31,60,4,59
77027,18987,3061,15926,11550,1369,15,2108,7,98
77028,18701,6964,11737,366,10982,14,44,4,47
77029,17044,12226,4818,990,3561,19,39,1,27
77030,13221,1650,11571,6296,917,14,3675,7,88
77031,15678,8586,7092,2105,3715,18,930,0,85
77032,13497,6517,6980,795,5846,3,103,2,62
77033,28369,9868,18501,372,17532,27,102,3,91
77034,38186,26391,11795,4036,4890,61,2121,8,130
77035,37417,16662,20755,7635,10425,64,1524,10,191
77036,75870,47772,28098,5124,10863,95,10522,20,616
77037,19569,17451,2118,1444,248,31,246,4,33
77038,30483,21277,9206,1290,5341,40,2173,4,84
77039,28740,23764,4976,1909,2472,36,251,18,68
77040,49524,24911,24613,11685,7614,89,3918,6,205
77041,35958,17596,18362,8628,3046,63,5581,6,158
77042,41177,12670,28507,11470,12358,66,3041,14,308
77043,26281,12029,14252,9312,1653,84,2381,4,107
77044,55665,25981,29684,10542,15975,67,1525,52,224
77045,32411,17564,14847,965,12792,31,561,8,93
77046,1742,265,1477,1015,165,3,226,0,5
77047,32088,9708,22380,1686,18622,33,1238,9,138
77048,20536,5656,14880,522,13637,33,333,8,66
77049,38788,25182,13606,3353,8352,43,1141,9,175
77050,5004,3179,1825,153,1566,2,40,1,12
77051,18323,2995,15328,406,14204,43,242,6,64
77053,30350,17305,13045,833,11462,34,271,4,97
77054,24419,3020,21399,4723,9820,31,5921,7,141
77055,42766,22416,20350,14454,1967,75,2699,8,159
77056,24115,4164,19951,13307,2203,45,3284,9,188
77057,43669,14708,28961,18548,4547,90,4099,11,318
77058,19442,4596,14846,10232,2018,49,1637,9,99
77059,18568,2663,15905,11086,517,25,3391,4,75
77060,42707,30941,11766,2093,8592,47,366,34,158
77061,23398,15273,8125,1867,4589,48,1307,3,86
77062,25095,6124,18971,13826,1208,58,2584,23,164
77063,38298,12838,25460,12362,7566,93,3927,12,193
77064,48243,20329,27914,11452,7403,93,7485,25,246
77065,37144,11632,25512,12045,7853,60,4095,30,177
77066,34443,16647,17796,4522,7693,61,4426,14,227
77067,31729,17558,14171,1138,10859,35,1571,29,164
77068,11764,3892,7872,2982,3453,26,1009,1,83
77069,19299,3782,15517,9092,4265,43,1348,12,129
77070,52943,15023,37920,21252,9265,98,5149,24,295
77071,26949,8943,18006,3896,11527,25,1864,6,206
77072,56271,29431,26840,2987,10328,42,12058,22,775
77073,46071,25641,20430,3364,14851,68,1069,83,186
77074,40199,24709,15490,5500,5118,44,3767,4,345
77075,38873,25858,13015,2434,6419,45,3504,12,131
77076,32349,27587,4762,1895,2381,42,143,3,95
77077,61302,13616,47686,21762,15126,123,7991,21,370
77078,14855,6738,8117,327,7537,10,18,3,31
77079,36404,6499,29905,20970,3797,53,3451,5,214
77080,45428,30243,15185,9895,2133,99,2077,12,171
77081,48293,30978,17315,4648,7579,77,3867,14,270
77082,57493,16536,40957,10017,21224,79,7627,26,514
77083,73763,27794,45969,5522,20384,84,18461,16,283
77084,109808,51651,58157,24620,18419,227,11292,71,589
77085,17785,11230,6555,596,5293,12,415,3,67
77086,29366,18761,10605,1669,6122,43,2422,19,84
77087,34654,27360,7294,1694,4969,22,180,4,127
77088,54320,27117,27203,3309,21334,84,1527,18,184
77089,56994,27564,29430,10488,8885,90,8623,15,236
77090,42285,12256,30029,5064,22487,90,983,63,265
77091,28020,13040,14980,2262,11798,49,248,15,125
77092,34903,21564,13339,8223,3702,42,596,4,178
77093,47736,39978,7758,2261,4818,45,138,5,161
77094,11150,1706,9444,5770,615,21,2520,8,60
77095,71206,20651,50555,27932,11455,119,8145,25,347
77096,34510,8447,26063,14150,7328,46,3075,8,260
77098,15717,2632,13085,9606,756,15,1861,1,90
77099,49849,24666,25183,2999,13222,62,7673,25,519
77204,4280,828,3452,1449,451,1,1476,0,7
77301,35923,18692,17231,10868,4471,88,735,33,136
77302,19384,6373,13011,11557,418,78,222,20,89
77303,20974,6836,14138,12000,1070,58,203,20,83
77304,35969,6925,29044,23343,2763,148,1133,27,131
77306,15127,8130,6997,6289,174,24,104,8,28
77316,30598,4328,26270,23642,729,126,323,19,97
77318,17518,2713,14805,13154,587,87,145,9,64
77320,37325,8975,28350,18505,8577,128,357,6,89
77326,137,10,127,111,4,0,1,0,0
77327,32269,15420,16849,13928,1894,80,128,4,86
77328,17071,5465,11606,10577,299,41,76,10,60
77331,6953,429,6524,5402,795,35,15,2,29
77334,139,26,113,83,21,0,0,0,3
77335,1937,309,1628,1348,163,10,5,0,11
77336,14881,2619,12262,10963,450,65,141,1,56
77338,45031,18144,26887,7151,16379,103,1372,536,203
77339,43076,9325,33751,26937,3029,92,1753,54,205
77340,35020,7111,27909,18561,7222,115,758,33,218
77341,0,0,0,0,0,0,0,0,0
77342,23,6,17,10,7,0,0,0,0
77345,27258,3702,23556,20195,818,89,1049,19,105
77346,71119,19641,51478,31592,13800,195,2592,131,376
77350,264,25,239,193,33,0,0,0,3
77351,37353,5428,31925,25919,3583,851,268,0,96
77354,40625,9809,30816,26762,1434,149,728,20,137
77355,29300,6642,22658,20679,440,124,188,10,105
77356,32136,2980,29156,26412,919,117,370,31,122
77357,30339,13679,16660,14266,882,97,240,35,94
77358,4817,528,4289,3522,571,11,14,5,7
77359,679,70,609,449,109,3,4,0,8
77360,5603,366,5237,4762,115,38,38,0,17
77362,7007,1822,5185,4575,224,20,94,1,10
77363,3820,863,2957,2585,144,18,23,0,14
77364,2312,106,2206,1744,327,11,7,0,0
77365,42086,16906,25180,20530,1758,127,1161,57,164
77367,287,35,252,198,33,2,0,0,6
77368,30,6,24,23,0,0,0,0,0
77369,736,80,656,606,13,4,1,0,5
77371,7870,1783,6087,5179,497,34,21,2,8
77372,13306,3996,9310,8522,107,56,56,1,27
77373,63413,23931,39482,18635,15805,136,2015,230,374
77374,407,9,398,390,1,0,2,0,0
77375,65365,19236,46129,32861,6105,166,4166,55,315
77376,468,17,451,428,6,0,0,0,2
77377,39711,8793,30918,23469,2110,80,3505,14,183
77378,17417,6113,11304,9001,1390,81,65,20,66
77379,84704,18939,65765,43700,8845,149,9211,44,421
77380,27651,6489,21162,15441,2037,86,2070,56,153
77381,35191,5246,29945,25191,1019,67,1964,17,194
77382,37755,6778,30977,24271,1053,43,3728,15,172
77384,23952,4151,19801,15252,1482,50,1783,32,134
77385,27801,6713,21088,15464,2546,73,1586,27,158
77386,66058,15015,51043,36443,7219,178,3718,142,313
77388,51483,14406,37077,23105,7123,110,4444,39,215
77389,41534,10341,31193,23404,2596,117,3033,17,225
77396,61058,26631,34427,10443,19832,127,2048,265,288
77401,17219,1832,15387,10195,284,28,4075,9,90
77406,58703,11877,46826,29056,9146,86,5952,26,296
77407,74657,13642,61015,11943,21124,74,25419,29,409
77412,57,10,47,20,19,0,0,0,1
77414,23416,9954,13462,9372,3218,84,205,5,68
77415,82,7,75,56,16,0,0,0,1
77417,2154,1303,851,620,182,2,19,1,5
77418,10037,1965,8072,6857,861,25,55,1,29
77419,1332,613,719,684,13,1,1,0,6
77420,2296,937,1359,1133,159,9,9,0,5
77422,13731,2834,10897,8564,1769,46,62,2,30
77423,16152,6785,9367,6088,2376,55,369,3,56
77426,2053,348,1705,1361,266,6,12,0,5
77428,84,16,68,57,1,0,9,0,0
77429,94176,21545,72631,50410,9023,199,8719,66,545
77430,2224,524,1700,1547,29,13,9,2,5
77431,84,2,82,50,27,1,0,0,0
77432,138,67,71,65,3,0,0,0,2
77433,106663,28756,77907,42407,16565,250,14161,59,505
77434,4411,2254,2157,1057,1016,4,9,0,10
77435,4795,1383,3412,3071,241,11,12,0,3
77436,131,26,105,25,78,0,0,0,0
77437,17832,8624,9208,7474,1380,29,73,0,38
77440,60,17,43,40,0,0,0,0,1
77441,23111,4131,18980,13500,1532,35,2871,1,100
77442,1151,292,859,728,103,0,2,0,0
77443,151,43,108,75,30,0,1,0,1
77444,1057,416,641,577,24,3,5,0,2
77445,14160,5022,9138,5250,3397,43,77,7,46
77446,6236,484,5752,67,5519,30,8,0,105
77447,20805,7958,12847,10045,1708,45,319,4,76
77448,459,140,319,179,128,1,1,0,2
77449,128180,62521,65659,25034,27897,264,8214,61,735
77450,72977,17212,55765,37099,5230,122,9888,30,371
77451,495,154,341,22,299,0,6,0,8
77453,243,183,60,48,11,0,0,0,0
77454,192,74,118,89,22,2,1,0,0
77455,1751,593,1158,1021,78,6,3,0,10
77456,1191,415,776,647,66,4,1,0,6
77457,426,34,392,374,6,0,0,0,0
77458,397,229,168,159,2,0,2,0,0
77459,79731,10726,69005,25192,20579,134,19750,28,364
77460,52,8,44,43,0,0,0,0,0
77461,11890,4359,7531,6509,527,18,77,0,45
77464,501,174,327,293,23,2,3,0,1
77465,7137,3460,3677,2865,159,10,486,2,15
77466,627,439,188,125,47,3,4,0,0
77467,25,7,18,11,6,0,0,0,0
77468,20,7,13,13,0,0,0,0,0
77469,57925,19790,38135,16798,12216,125,7028,40,286
77470,276,64,212,180,15,0,0,0,2
77471,42284,23730,18554,10171,6140,93,1155,3,168
77473,39,12,27,4,20,0,1,0,0
77474,14164,4911,9253,7514,1099,33,135,7,36
77475,718,162,556,515,10,1,3,0,1
77476,601,144,457,347,69,1,5,1,11
77477,35520,11382,24138,5886,9438,53,7686,22,165
77478,24536,2977,21559,10023,2040,23,8525,5,137
77479,93180,9211,83969,29611,6625,125,43988,19,453
77480,7911,1458,6453,5284,775,23,45,0,20
77481,132,22,110,52,36,0,11,1,0
77482,2241,723,1518,1197,235,5,2,0,8
77483,226,44,182,175,3,0,2,0,0
77484,13449,5000,8449,6770,1052,51,145,0,75
77485,3657,1088,2569,2043,363,9,26,0,27
77486,7488,1494,5994,4990,685,41,40,2,19
77488,13861,5084,8777,5181,3187,14,64,0,45
77489,37257,8518,28739,1520,25124,41,1227,12,158
77493,51774,18335,33439,20848,6616,120,3610,32,276
77494,130872,29769,101103,54371,10704,247,29728,41,752
77498,51472,12106,39366,12183,8235,101,17147,23,276
77502,37495,30596,6899,5226,962,58,169,13,102
77503,24956,17344,7612,6002,810,52,163,7,75
77504,25728,16309,9419,6408,1636,71,804,15,74
77505,23584,10213,13371,10943,646,44,1086,13,97
77506,34431,29840,4591,3295,785,25,132,10,109
77507,770,239,531,385,72,0,32,1,3
77510,14357,2320,12037,11268,89,51,55,12,51
77511,51093,19845,31248,27337,1412,134,513,12,155
77514,4926,1245,3681,2751,579,17,113,0,24
77515,32710,11523,21187,16349,3300,120,278,10,89
77517,6058,1174,4884,4501,25,20,33,4,17
77518,9689,3963,5726,4613,486,40,223,0,17
77519,882,29,853,806,1,6,5,0,0
77520,38587,21718,16869,9709,5530,98,276,21,237
77521,65058,29159,35899,19620,12027,173,1935,28,402
77523,27638,6323,21315,18334,1423,105,403,2,123
77530,35319,25355,9964,5454,3507,50,395,14,130
77531,15666,7612,8054,5901,1380,74,199,4,67
77532,34679,10494,24185,18312,4217,96,223,8,133
77533,980,69,911,811,36,5,1,0,7
77534,2998,596,2402,2202,34,13,5,0,10
77535,36494,10030,26464,22151,2701,127,229,6,110
77536,33693,12199,21494,19054,674,96,445,21,157
77538,809,172,637,555,23,5,3,0,10
77539,48183,16417,31766,23033,5121,141,1542,25,179
77541,16441,8290,8151,6267,1251,54,82,1,54
77545,26563,9386,17177,1134,14817,33,491,10,91
77546,54670,10159,44511,34824,2778,133,4422,51,210
77547,9627,8171,1456,728,616,12,9,2,30
77550,24247,7050,17197,10234,5012,122,871,32,85
77551,22677,7699,14978,10110,3488,40,627,4,86
77554,8961,1188,7773,6946,293,34,216,3,30
77555,9,0,9,7,0,1,0,0,1
77560,960,136,824,485,276,2,11,0,14
77561,92,4,88,73,9,0,0,0,0
77562,11861,4655,7206,5856,862,43,70,1,32
77563,9778,2277,7501,5178,1842,29,85,6,32
77564,2047,136,1911,1798,22,13,1,0,11
77565,6966,1110,5856,5088,208,26,208,7,33
77566,30538,8593,21945,18049,1554,103,954,9,155
77568,20254,5892,14362,7244,5982,44,388,31,68
77571,37018,13471,23547,19543,2030,144,383,15,182
77573,95256,19471,75785,59165,6277,237,5560,47,524
77575,15768,3226,12542,9454,2311,45,123,2,85
77577,1250,348,902,809,26,9,1,0,4
77578,25228,5902,19326,8923,6229,58,3136,6,93
77580,99,36,63,30,13,4,2,0,2
77581,49198,14760,34438,23757,4689,125,3934,25,190
77582,262,27,235,182,39,0,0,0,6
77583,43113,16309,26804,9855,13392,70,2241,12,153
77584,93062,21022,72040,28831,22140,159,16936,50,424
77585,892,40,852,827,2,1,0,0,0
77586,23503,3946,19557,16389,977,84,875,7,129
77587,16179,14472,1707,1131,330,18,100,2,32
77590,30758,10972,19786,12698,5584,104,277,28,112
77591,17347,3992,13355,4344,8034,49,276,4,96
77597,734,73,661,548,75,1,2,0,0
77598,25620,8350,17270,9889,4340,82,1831,18,149
77611,9993,1053,8940,8198,91,36,273,0,23
77612,9311,288,9023,8369,296,33,15,2,15
77613,1293,124,1169,756,349,4,14,0,1
77614,468,13,455,438,7,2,1,0,0
77615,314,10,304,291,1,1,2,0,0
77616,656,22,634,606,4,4,1,0,2
77617,125,13,112,97,3,1,3,0,0
77619,17349,5154,12195,10041,1047,41,593,3,39
77622,1384,208,1176,1102,20,2,7,1,2
77623,340,21,319,289,0,2,14,0,1
77624,535,25,510,369,91,1,9,0,1
77625,8599,476,8123,7156,577,42,40,5,32
77627,23296,4066,19230,16464,979,80,931,11,61
77629,868,114,754,612,104,6,1,0,4
77630,29317,3247,26070,17843,6541,102,423,6,86
77632,22487,1520,20967,18402,1298,98,253,5,57
77640,16618,3476,13142,3231,9035,36,466,2,41
77642,39017,17640,21377,5733,11992,68,2783,12,148
77650,2304,286,2018,1903,13,16,10,4,7
77651,13705,1981,11724,10494,283,42,462,0,24
77655,291,21,270,223,12,0,20,0,2
77656,17199,882,16317,13319,2181,51,93,4,45
77657,22161,1574,20587,19264,126,77,217,19,57
77659,4964,350,4614,4139,147,17,41,5,9
77660,1206,53,1153,1093,2,10,6,0,1
77661,429,169,260,141,84,2,2,0,9
77662,25462,1553,23909,22688,85,126,170,2,32
77663,1291,59,1232,1182,2,6,1,1,5
77664,2934,83,2851,2614,68,21,16,0,10
77665,7080,1890,5190,4508,391,10,34,0,22
77701,13232,4580,8652,1301,6712,16,288,3,54
77702,2682,585,2097,919,1060,4,29,2,18
77703,13357,3039,10318,1018,8892,12,52,1,51
77705,37950,8075,29875,11551,16792,144,607,15,76
77706,29910,3089,26821,16142,7701,50,1805,7,144
77707,17509,3126,14383,5885,7162,37,723,1,91
77708,12478,1576,10902,2575,7752,30,186,4,47
77713,14408,1812,12596,7122,3945,49,971,4,63
77801,15097,6196,8901,4982,2329,13,1056,20,55
77802,25502,5376,20126,15824,2501,49,600,36,122
77803,30533,18026,12507,5362,6291,33,114,5,134
77807,13140,4565,8575,6262,1629,23,177,18,61
77808,15217,3466,11751,10172,796,56,108,6,71
77830,2836,310,2526,2259,179,7,2,0,5
77831,3517,550,2967,2469,251,19,33,2,19
77833,29431,5657,23774,17708,4510,58,501,14,115
77835,2463,226,2237,1905,201,5,23,0,11
77836,11721,2589,9132,7551,1113,36,48,0,15
77837,1362,172,1190,574,541,4,19,3,4
77840,55180,12353,42827,28089,5974,135,6343,55,205
77843,8701,2681,6020,4711,319,10,955,5,15
77845,70108,10396,59712,47376,3727,176,5258,63,321
77852,40,1,39,39,0,0,0,0,0
77853,1116,228,888,580,265,7,2,0,5
77855,159,8,151,148,0,0,0,0,0
77856,5170,490,4680,4130,347,6,48,7,10
77857,985,108,877,734,78,3,12,0,1
77859,7131,2329,4802,2728,1858,14,15,9,19
77861,2850,331,2519,2300,48,9,18,0,16
77863,64,7,57,28,21,0,1,0,0
77864,7243,2188,5055,3444,1342,35,45,0,4
77865,1571,148,1423,1326,22,5,13,0,11
77866,36,17,19,11,1,1,0,0,1
77867,109,48,61,28,31,0,0,0,0
77868,16647,5520,11127,7290,3259,37,55,8,47
77871,3677,284,3393,3090,106,13,26,1,11
77872,1992,220,1772,1639,31,8,27,0,4
77873,1450,161,1289,1130,96,5,5,0,3
77875,63,14,49,42,1,0,0,0,0
77876,46,5,41,40,0,0,0,0,0
77878,602,117,485,359,102,3,1,0,4
77879,4994,964,4030,3099,623,27,19,0,15
77880,1922,189,1733,1098,564,7,12,0,9
77882,45,15,30,28,1,0,0,0,0
77901,40062,25018,15044,10273,3373,97,542,20,67
77904,29646,9975,19671,16604,1355,64,800,7,101
77905,15282,4881,10401,9545,358,45,27,4,42
77950,159,66,93,90,2,0,0,0,0
77951,2246,1701,545,416,93,2,3,0,6
77954,11458,4141,7317,5714,1287,19,44,2,25
77957,8730,2716,6014,4712,843,15,125,4,74
77960,78,52,26,17,8,0,0,0,0
77961,161,26,135,132,0,0,0,0,0
77962,3425,1373,2052,1897,57,8,9,0,10
77963,5184,1851,3333,2976,182,12,20,0,10
77964,8233,886,7347,6505,586,8,42,1,11
77968,3398,684,2714,2535,43,4,11,1,13
77969,206,50,156,140,2,0,4,1,2
77970,283,90,193,179,4,2,1,0,2
77971,829,230,599,563,4,2,5,0,6
77973,47,15,32,23,1,0,0,0,0
77974,455,46,409,388,9,1,0,1,1
77975,1753,430,1323,1251,17,1,5,2,0
77976,68,20,48,39,3,0,0,0,0
77977,667,486,181,142,16,5,5,2,0
77978,621,248,373,313,11,4,15,0,4
77979,16782,9083,7699,6031,348,19,1015,0,49
77982,968,138,830,800,1,3,2,0,2
77983,1732,405,1327,1199,8,8,75,0,4
77984,4490,493,3997,3656,191,11,9,0,8
77986,27,9,18,10,4,0,0,0,0
77987,161,15,146,143,1,1,0,0,0
77988,353,184,169,141,8,1,1,0,6
77990,661,357,304,275,11,0,4,0,0
77991,428,174,254,207,14,1,5,0,1
77993,166,26,140,135,0,0,1,0,1
77994,309,65,244,230,0,0,0,0,2
77995,9821,3618,6203,5302,573,14,44,1,18
78001,4,3,1,1,0,0,0,0,0
78002,8876,7159,1717,1502,54,21,28,5,26
78003,9595,2043,7552,6909,52,49,42,4,45
78004,518,70,448,402,2,1,7,1,6
78005,823,325,498,452,7,3,1,0,9
78006,40979,9245,31734,29324,369,99,465,40,158
78007,95,16,79,77,1,0,0,0,0
78008,224,108,116,102,3,2,1,0,0
78009,8715,3650,5065,4434,246,39,44,11,31
78010,3357,1071,2286,2121,16,9,10,0,14
78011,1943,1473,470,414,16,0,3,0,13
78012,373,265,108,85,2,0,1,0,10
78013,5868,2190,3678,3385,17,42,21,2,29
78014,5078,3991,1087,855,177,1,4,0,5
78015,20764,5336,15428,13360,429,46,646,12,114
78016,10530,5485,5045,4655,63,30,24,4,51
78017,5912,4421,1491,866,511,7,33,0,39
78019,1483,884,599,549,44,1,0,0,0
78021,160,67,93,88,0,1,0,0,0
78022,4343,1944,2399,2279,16,13,13,1,2
78023,30295,12791,17504,13374,918,67,1896,32,127
78024,1083,160,923,867,4,2,6,3,5
78025,5146,1256,3890,3648,23,24,30,0,8
78026,6181,3162,3019,2792,45,13,15,2,28
78027,478,47,431,397,3,0,5,0,11
78028,40789,10343,30446,27805,639,113,505,34,144
78029,7,5,2,2,0,0,0,0,0
78039,1795,920,875,796,11,16,5,4,5
78040,36688,35581,1107,866,61,32,25,1,56
78041,48491,45511,2980,1999,287,20,424,9,111
78043,43473,41849,1624,1184,74,20,196,2,60
78044,200,185,15,13,0,2,0,0,0
78045,65354,61099,4255,3100,249,35,564,8,146
78046,71956,69261,2695,2259,114,26,88,5,85
78050,583,430,153,142,0,1,1,0,0
78052,7443,5109,2334,2068,74,24,31,1,37
78055,1574,207,1367,1294,8,1,5,0,1
78056,2116,718,1398,1274,31,7,11,3,8
78057,1220,581,639,580,19,2,3,1,2
78058,1304,185,1119,1041,8,8,14,0,10
78059,5724,3715,2009,1800,54,15,9,7,12
78061,10569,8804,1765,1305,172,40,163,8,36
78062,3,0,3,3,0,0,0,0,0
78063,9302,1773,7529,6995,45,54,47,5,33
78064,15710,8284,7426,6781,98,50,73,6,40
78065,12048,8931,3117,2772,82,25,29,5,34
78066,650,175,475,429,10,2,8,2,0
78067,613,567,46,46,0,0,0,0,0
78069,5803,4598,1205,1027,25,14,19,2,26
78070,20618,4703,15915,14499,214,104,158,11,142
78071,4124,2189,1935,1621,176,23,6,2,24
78072,420,191,229,209,0,1,3,5,0
78073,9550,7697,1853,1584,75,30,35,0,28
78074,101,16,85,78,0,0,1,0,0
78075,103,26,77,71,0,2,1,0,1
78076,13033,12204,829,739,9,7,15,0,16
78101,9104,3087,6017,5335,260,39,38,6,44
78102,27289,17384,9905,7007,2300,29,203,2,48
78104,47,28,19,18,0,0,0,0,0
78107,309,168,141,134,0,1,2,0,0
78108,44079,13812,30267,19422,6347,152,1380,176,241
78109,52093,23415,28678,13095,11078,156,1423,245,216
78111,10,1,9,9,0,0,0,0,0
78112,9591,7140,2451,2091,106,30,34,2,24
78113,2253,480,1773,1695,11,0,3,0,3
78114,22178,11055,11123,10072,306,48,128,12,72
78116,218,34,184,178,1,0,0,0,0
78117,649,119,530,511,5,0,0,0,0
78118,4899,2723,2176,1647,318,17,67,0,49
78119,7048,4028,3020,2036,779,11,84,1,13
78121,15206,3648,11558,10596,277,51,59,7,50
78122,354,94,260,219,29,0,0,0,0
78123,2291,731,1560,1402,43,10,12,0,15
78124,6860,2254,4606,4004,182,14,65,10,35
78125,57,22,35,35,0,0,0,0,0
78130,88349,32139,56210,49376,2125,228,1123,136,353
78132,37475,8624,28851,25771,976,111,481,26,157
78133,20787,3552,17235,15870,144,77,123,13,114
78140,3607,2303,1304,1135,65,12,11,1,7
78141,726,202,524,491,9,2,1,0,1
78142,119,58,61,50,0,0,0,0,0
78143,77,22,55,50,0,2,0,0,0
78144,36,11,25,25,0,0,0,0,0
78145,83,62,21,21,0,0,0,0,0
78146,624,306,318,294,4,4,0,0,1
78147,1825,1031,794,752,7,2,4,0,9
78148,21569,8302,13267,8970,2178,90,732,116,116
78150,9,6,3,1,0,0,0,0,0
78151,1299,845,454,413,9,0,0,0,0
78152,3022,851,2171,1951,121,3,10,1,3
78154,41533,13728,27805,19386,4676,108,1329,89,152
78155,51772,23197,28575,24367,2198,128,375,40,177
78159,793,431,362,344,4,1,1,2,0
78160,4528,1486,3042,2831,34,10,13,0,23
78161,699,251,448,408,2,2,1,2,7
78162,301,102,199,186,0,0,0,0,0
78163,13960,3380,10580,9628,197,45,105,7,45
78164,3464,1107,2357,2224,66,4,2,0,3
78201,42005,34782,7223,5167,1114,81,265,12,124
78202,11422,7713,3709,1141,2180,22,79,6,54
78203,5872,4355,1517,431,910,7,39,0,25
78204,11298,9139,2159,1668,160,17,128,8,36
78205,2339,1072,1267,888,163,28,88,2,21
78207,51705,45526,6179,3572,1836,92,276,17,115
78208,3874,2677,1197,414,624,14,42,5,30
78209,42456,13057,29399,24796,1772,71,1065,34,218
78210,33010,26834,6176,3852,1609,95,163,15,102
78211,29976,28464,1512,1036,174,48,77,10,58
78212,26738,15515,11223,9316,663,54,421,6,100
78213,40589,28874,11715,8384,1684,74,625,32,155
78214,22664,20636,2028,1558,193,28,73,10,38
78215,3644,1277,2367,1906,156,14,151,5,28
78216,40172,22364,17808,13204,2395,96,841,31,160
78217,33562,16831,16731,10906,3926,88,633,42,146
78218,36137,19694,16443,8057,5454,78,1593,68,148
78219,16509,8733,7776,2598,4260,45,353,28,39
78220,17749,9498,8251,1342,6401,41,58,18,36
78221,39779,35205,4574,3531,454,59,154,6,120
78222,25028,16329,8699,3785,4054,54,188,30,76
78223,55705,43485,12220,8285,2550,102,334,24,195
78224,21759,19611,2148,1326,464,40,110,10,79
78225,12576,11917,659,482,48,28,12,0,46
78226,7140,6478,662,400,154,11,19,8,14
78227,46594,37626,8968,5134,2295,143,501,73,197
78228,56369,49214,7155,4708,1307,127,324,28,153
78229,33135,16546,16589,8071,3428,95,3677,46,197
78230,42145,20747,21398,15929,2085,110,1757,53,209
78231,8993,3152,5841,4841,266,17,402,5,27
78232,35397,12485,22912,19087,1447,79,809,55,203
78233,49442,24707,24735,16074,4994,155,1428,129,195
78234,7464,1576,5888,3734,1159,43,439,51,48
78235,2307,1558,749,457,137,6,95,5,9
78236,9869,1628,8241,5547,1817,14,378,21,136
78237,36019,33585,2434,1083,802,40,275,9,61
78238,26014,17597,8417,4946,1741,51,1022,31,113
78239,31554,15517,16037,9243,4611,89,922,82,143
78240,56112,27257,28855,16309,4290,127,5925,64,259
78242,33294,29093,4201,2510,989,50,186,35,94
78243,235,58,177,112,43,0,15,0,0
78244,35801,18070,17731,6143,8951,87,1004,77,168
78245,93031,59924,33107,18410,8412,238,2459,208,429
78247,50876,22752,28124,21525,2938,138,1335,54,258
78248,13825,4268,9557,8299,280,26,482,5,36
78249,56996,28181,28815,18567,3617,93,4290,74,220
78250,54933,34447,20486,14441,2696,124,1327,67,230
78251,58836,36542,22294,12381,5465,122,2113,122,303
78252,17156,11975,5181,2925,1434,40,301,26,82
78253,66589,32262,34327,21348,6568,158,2814,121,383
78254,72791,39579,33212,22302,5026,145,2677,133,289
78255,17775,6678,11097,8282,533,34,1527,11,79
78256,13643,5438,8205,5310,985,36,1226,14,58
78257,12173,5141,7032,4950,674,21,944,17,33
78258,51073,18489,32584,23046,2677,92,4603,51,216
78259,29842,10507,19335,13574,1435,67,2803,47,157
78260,37037,12918,24119,18677,1597,91,2043,51,176
78261,26971,9557,17414,12447,1986,65,1636,61,123
78263,4995,1978,3017,2520,237,20,45,4,15
78264,14705,11368,3337,2804,161,48,109,5,43
78266,7534,1917,5617,4218,648,24,323,17,46
78330,780,614,166,154,3,0,0,0,1
78332,27152,23159,3993,3362,140,23,119,9,62
78336,12009,4550,7459,6622,251,52,115,10,34
78338,50,27,23,22,0,0,0,0,0
78339,625,587,38,30,3,0,1,0,0
78340,341,121,220,203,1,5,1,0,2
78341,1420,1337,83,58,0,1,3,0,0
78342,318,301,17,16,0,1,0,0,0
78343,4405,3111,1294,1135,37,18,28,0,18
78344,278,259,19,18,1,0,0,0,0
78347,19,3,16,14,0,0,0,0,0
78349,325,309,16,13,0,1,1,0,0
78351,578,525,53,45,1,0,1,0,2
78352,254,203,51,40,1,0,0,0,0
78353,377,336,41,26,0,2,1,0,2
78355,6982,6132,850,745,8,7,29,0,15
78357,2858,2304,554,393,4,6,26,0,3
78358,1137,173,964,820,8,5,70,0,10
78359,1920,1672,248,204,14,5,5,1,4
78360,22,14,8,8,0,0,0,0,0
78361,4842,4290,552,409,5,15,26,5,8
78362,10238,4665,5573,4931,138,37,117,7,45
78363,29391,21079,8312,5983,982,78,773,1,90
78368,8726,5997,2729,2464,70,15,25,1,37
78369,249,238,11,7,0,0,2,0,0
78370,4746,3240,1506,1381,25,5,8,0,5
78371,281,264,17,14,1,0,1,0,0
78372,5550,3076,2474,2292,22,24,5,4,14
78373,3134,236,2898,2693,4,12,39,2,25
78374,20281,8481,11800,10004,351,87,569,39,79
78375,3109,2743,366,325,4,0,10,2,4
78376,307,264,43,39,0,1,1,0,0
78377,3547,1846,1701,1283,329,11,11,0,4
78379,1624,823,801,739,13,5,11,0,7
78380,23386,17546,5840,5293,165,21,64,8,62
78382,19432,4879,14553,13076,188,111,382,15,56
78383,3757,1305,2452,2277,23,13,10,0,10
78384,5653,4248,1405,518,145,7,14,0,12
78385,259,202,57,47,0,5,0,1,2
78387,9936,7059,2877,2534,139,16,36,8,38
78389,1535,855,680,604,11,16,2,0,12
78390,5447,3943,1504,1343,51,12,8,0,13
78391,261,196,65,62,0,1,0,0,1
78393,2137,935,1202,1095,57,2,12,0,6
78401,4701,2285,2416,1941,290,38,48,0,10
78402,625,218,407,324,13,8,28,0,11
78404,15339,10202,5137,4220,418,42,136,3,55
78405,14151,12665,1486,799,526,19,22,10,43
78406,1185,883,302,243,44,0,7,0,1
78407,1649,1117,532,269,210,9,6,2,6
78408,11023,8912,2111,1255,625,36,44,8,44
78409,2570,1856,714,587,65,2,17,0,4
78410,29545,16991,12554,11121,454,60,227,19,79
78411,26150,16873,9277,7577,779,52,287,10,106
78412,38783,21041,17742,13174,2172,96,1038,39,180
78413,37531,21465,16066,12042,1704,172,1128,47,148
78414,46972,23668,23304,16710,1913,94,3136,43,184
78415,38722,31025,7697,5302,1337,62,450,30,97
78416,14103,12300,1803,646,982,16,45,8,37
78417,4482,3806,676,385,174,18,23,2,18
78418,31787,8876,22911,19611,703,132,923,38,130
78419,441,77,364,300,27,0,14,12,0
78501,60817,54027,6790,5012,295,69,948,6,134
78503,23604,21931,1673,1189,45,28,280,0,50
78504,56830,46408,10422,6818,536,44,2306,15,220
78516,34506,31394,3112,2813,44,18,44,4,77
78520,64949,60878,4071,3248,140,38,317,11,140
78521,88708,84655,4053,3275,106,31,243,7,154
78526,55164,50986,4178,3185,186,29,514,6,84
78535,679,597,82,65,0,0,3,0,6
78536,322,314,8,8,0,0,0,0,0
78537,51962,49049,2913,2574,35,41,31,5,130
78538,12278,11846,432,334,15,10,22,2,21
78539,37686,32042,5644,3226,334,51,1660,3,114
78540,11,8,3,3,0,0,0,0,0
78541,48513,44443,4070,2685,424,32,655,2,91
78542,84678,79815,4863,3209,735,84,450,2,230
78543,7535,7235,300,218,8,10,9,0,14
78545,762,743,19,18,0,0,0,0,0
78547,413,409,4,1,0,0,0,0,1
78548,1296,1259,37,31,2,0,0,0,0
78549,872,838,34,31,0,1,0,0,2
78550,56038,46346,9692,7954,462,84,634,15,104
78552,38474,31100,7374,6326,224,47,379,27,104
78557,13986,13666,320,265,13,5,4,1,18
78558,388,380,8,5,0,0,1,0,0
78559,12533,10966,1567,1422,14,20,31,1,25
78560,4815,4684,131,89,2,5,6,0,21
78561,768,725,43,40,0,1,0,0,1
78562,3081,2353,728,712,6,0,3,0,2
78563,201,171,30,29,0,0,0,0,0
78564,103,91,12,8,0,0,1,0,0
78565,319,308,11,7,0,0,0,0,1
78566,23704,21352,2352,1971,63,22,134,3,51
78567,544,512,32,29,0,0,0,0,3
78569,3821,3455,366,318,22,8,5,0,4
78570,32950,31113,1837,1594,47,17,42,9,60
78572,78280,68097,10183,8379,278,51,996,11,160
78573,42229,40106,2123,1689,113,14,154,1,78
78574,63627,60500,3127,2526,85,24,223,5,100
78575,5270,4299,971,790,36,6,89,0,8
78576,13901,13659,242,190,8,3,10,0,17
78577,79937,75409,4528,3739,135,24,294,3,173
78578,10076,6702,3374,3101,31,25,59,5,34
78579,2637,2600,37,23,4,4,0,0,1
78580,13208,11396,1812,1148,421,24,156,0,26
78582,43253,42167,1086,806,26,4,95,0,77
78583,5869,4877,992,930,12,5,20,0,4
78584,19373,19047,326,269,1,4,4,0,20
78585,4,4,0,0,0,0,0,0,0
78586,50135,46673,3462,2925,103,46,94,4,110
78588,168,143,25,21,1,0,0,0,0
78589,38987,37574,1413,1090,50,33,69,3,79
78590,468,449,19,18,0,0,0,0,0
78591,341,327,14,11,1,0,1,0,0
78592,765,739,26,15,0,0,0,0,5
78593,5541,5183,358,298,6,5,13,1,9
78594,1796,1682,114,85,1,15,0,2,2
78595,6304,6204,100,70,3,14,0,0,12
78596,37329,32872,4457,3847,69,43,316,2,58
78597,2479,737,1742,1563,22,7,65,0,5
78598,319,77,242,233,1,0,0,0,1
78599,32500,31277,1223,951,80,9,81,4,52
78602,33759,11738,22021,17917,2221,116,388,47,171
78605,6246,1348,4898,4505,46,25,33,4,29
78606,5875,1215,4660,4348,47,18,22,1,37
78607,180,10,170,157,0,2,0,0,4
78608,519,65,454,416,6,2,1,0,1
78609,1827,125,1702,1605,6,7,12,0,1
78610,45134,20209,24925,20867,1427,73,869,22,154
78611,14839,2733,12106,11096,262,48,118,4,64
78612,16265,8573,7692,6210,675,95,150,2,80
78613,89279,16710,72569,52525,3650,208,11297,75,454
78614,459,139,320,310,1,0,0,4,0
78615,1694,737,957,876,22,3,15,1,5
78616,11605,8164,3441,2910,264,23,18,1,26
78617,28832,21819,7013,3966,2138,50,390,13,52
78618,256,33,223,211,1,3,1,0,0
78619,5819,819,5000,4535,67,14,108,6,40
78620,20493,3132,17361,15826,138,55,262,5,99
78621,27275,13082,14193,10481,2540,59,159,6,111
78622,340,182,158,134,2,0,0,0,2
78623,1670,225,1445,1334,7,8,13,1,15
78624,23080,5199,17881,16956,71,50,123,0,86
78626,39935,13413,26522,20898,2348,97,1294,46,184
78628,40378,6772,33606,28498,1333,114,1822,24,181
78629,12046,5790,6256,5108,806,33,43,0,29
78631,2698,354,2344,2246,8,9,2,2,10
78632,990,260,730,677,24,0,2,0,2
78633,27736,2229,25507,23912,319,63,319,5,77
78634,37951,13361,24590,17192,4378,100,823,59,207
78635,110,8,102,96,1,3,0,0,1
78636,3894,596,3298,3095,14,8,15,0,26
78638,2381,610,1771,1606,35,5,3,0,25
78639,8365,1467,6898,6415,65,39,30,4,14
78640,64539,36273,28266,22527,2585,164,799,41,266
78641,83426,18160,65266,49864,3591,294,6896,81,467
78642,20385,3679,16706,14847,394,79,290,21,82
78643,6453,632,5821,5435,10,33,52,0,26
78644,20813,10934,9879,8069,1057,63,119,2,87
78645,14051,2101,11950,10762,165,45,187,15,54
78648,8167,3881,4286,3442,486,21,49,1,50
78650,1918,647,1271,1170,13,5,16,0,5
78652,5831,1728,4103,3521,126,15,133,3,37
78653,31167,16106,15061,7180,5765,78,904,18,151
78654,19698,5699,13999,12740,209,71,231,2,38
78655,2910,1680,1230,1107,31,14,6,0,8
78656,2596,1687,909,728,74,15,31,1,7
78657,6531,998,5533,5198,49,40,45,1,11
78658,69,4,65,60,4,0,0,0,0
78659,3911,1143,2768,2485,79,23,12,7,16
78660,110955,36170,74785,41585,16106,256,11129,132,706
78661,304,121,183,140,25,0,1,0,0
78662,2890,835,2055,1838,55,7,6,0,19
78663,815,131,684,618,10,7,11,0,5
78664,60287,21595,38692,24651,6898,179,3980,114,363
78665,61577,15400,46177,29557,6761,134,6184,109,361
78666,86584,36770,49814,36805,5030,220,2034,58,330
78669,12415,1389,11026,10111,74,55,222,1,53
78670,106,47,59,54,0,0,3,0,0
78671,624,179,445,428,5,2,1,0,2
78672,984,56,928,858,2,8,3,0,5
78674,287,207,80,70,3,0,0,0,1
78675,178,67,111,98,0,1,1,0,2
78676,14713,1916,12797,11930,57,56,80,4,74
78677,55,25,30,30,0,0,0,0,0
78681,57503,11798,45705,32352,2916,123,7243,28,339
78701,11625,1610,10015,7763,760,31,965,4,76
78702,25910,9084,16826,11761,2903,53,931,24,138
78703,22194,2091,20103,17458,260,25,1357,8,98
78704,49197,11260,37937,31580,1557,142,2180,38,233
78705,36535,6664,29871,18863,1462,65,8052,24,159
78712,351,130,221,113,56,3,43,2,0
78717,36987,5378,31609,16023,1666,87,11918,17,188
78719,2004,1712,292,237,21,8,2,0,10
78721,11316,4569,6747,3246,2890,9,210,1,40
78722,6618,1135,5483,4299,552,16,256,12,25
78723,34522,11490,23032,14649,5145,60,1548,16,216
78724,29680,19519,10161,3749,5466,47,374,9,97
78725,10301,5577,4724,2255,1847,21,220,1,48
78726,15618,3057,12561,7951,1099,25,2630,7,83
78727,29928,5873,24055,14275,1984,70,6242,15,151
78728,25555,7426,18129,9838,4317,51,2651,20,126
78729,31829,6435,25394,17395,2348,74,3679,12,204
78730,9403,1158,8245,6568,213,13,965,4,48
78731,27240,3241,23999,19853,428,27,2418,8,103
78732,19128,2347,16781,12721,431,43,2420,6,120
78733,9347,1028,8319,6401,36,9,1368,1,35
78734,22963,4028,18935,16708,283,92,756,18,121
78735,20983,4416,16567,13696,472,39,1451,4,84
78736,10165,1850,8315,6985,186,25,521,3,65
78737,20996,2842,18154,15785,268,40,975,13,99
78738,29529,3147,26382,20789,592,54,3359,13,151
78739,21854,3419,18435,14111,281,26,2863,7,101
78741,49344,23358,25986,16338,5084,178,2354,31,325
78742,964,732,232,174,28,4,3,0,7
78744,51048,34763,16285,10180,3556,119,1034,31,231
78745,59843,22267,37576,30296,2592,165,1826,35,312
78746,29106,2858,26248,21925,240,34,2539,2,107
78747,21891,12404,9487,6546,1393,63,663,16,109
78748,55226,20072,35154,26949,2899,122,2636,33,275
78749,35239,7216,28023,21696,1045,67,3291,16,199
78750,28348,4555,23793,16609,953,57,4643,18,141
78751,17071,2883,14188,11493,404,34,1371,11,93
78752,19289,9713,9576,6035,1896,62,841,8,112
78753,58761,33621,25140,12146,6890,72,4332,24,199
78754,27020,10765,16255,7038,4212,27,3993,16,134
78756,8426,1185,7241,6165,210,10,351,3,37
78757,23847,4911,18936,16038,628,41,1043,11,149
78758,49831,23253,26578,17004,3676,125,3697,31,269
78759,42333,6763,35570,26025,1429,75,5882,24,224
78801,21051,15613,5438,4907,95,19,151,5,59
78802,0,0,0,0,0,0,0,0,0
78827,863,824,39,32,1,0,0,2,0
78828,158,19,139,132,0,0,1,0,0
78829,858,739,119,108,0,0,4,0,0
78830,509,464,45,38,5,0,0,1,0
78832,3127,1468,1659,1489,36,21,10,2,15
78833,817,252,565,524,3,3,4,1,0
78834,7061,6057,1004,791,66,8,68,7,12
78836,85,76,9,9,0,0,0,0,0
78837,216,79,137,120,3,4,2,3,4
78838,264,53,211,205,0,1,2,0,0
78839,7364,6958,406,281,57,19,13,1,3
78840,47147,38079,9068,7589,505,53,337,32,81
78841,1,0,1,1,0,0,0,0,0
78842,0,0,0,0,0,0,0,0,0
78843,168,25,143,99,30,0,12,0,0
78850,1075,408,667,630,2,0,2,0,6
78851,33,3,30,26,0,0,0,0,0
78852,56712,53927,2785,1436,127,829,180,4,107
78860,237,219,18,10,0,5,0,0,0
78861,13298,6738,6560,5607,636,16,62,3,36
78870,868,443,425,382,8,3,5,0,2
78871,23,12,11,11,0,0,0,0,0
78872,1491,1290,201,183,10,2,2,0,0
78873,1559,319,1240,1172,17,5,5,0,2
78877,936,788,148,128,2,1,2,0,3
78879,307,95,212,197,1,0,4,2,0
78880,1254,699,555,512,2,5,8,1,2
78881,1853,1123,730,695,3,2,0,1,3
78883,257,25,232,219,0,0,1,0,0
78884,949,116,833,809,2,3,0,0,2
78885,129,15,114,109,0,0,0,0,0
78886,463,270,193,180,0,1,0,0,2
78931,231,6,225,202,4,0,0,0,5
78932,897,98,799,744,30,0,0,0,4
78933,1531,185,1346,1260,19,7,2,0,4
78934,6770,1568,5202,4287,713,5,51,0,16
78935,922,198,724,640,69,0,0,0,0
78938,289,77,212,200,3,0,0,0,1
78940,1974,190,1784,1701,25,0,5,0,5
78941,3006,1080,1926,1741,107,11,7,0,2
78942,8973,3268,5705,4478,882,19,43,0,22
78943,439,259,180,108,57,0,0,0,0
78944,532,60,472,382,55,1,0,0,18
78945,10483,2213,8270,7160,739,22,35,6,29
78946,1093,220,873,686,156,0,0,0,2
78947,4828,535,4293,3811,226,14,6,1,9
78948,912,93,819,682,110,3,1,0,1
78949,529,84,445,420,6,3,0,0,0
78950,2151,208,1943,1802,44,3,5,0,10
78951,78,19,59,53,3,0,0,0,0
78953,1350,218,1132,1037,13,2,4,4,3
78954,1144,97,1047,972,19,3,0,0,11
78956,5161,1066,4095,3533,434,7,20,1,15
78957,10214,1949,8265,7152,630,24,65,1,44
78959,1723,938,785,582,148,4,10,0,6
78962,4617,1078,3539,3049,376,4,9,0,7
78963,988,252,736,649,44,1,0,0,1
79001,218,18,200,197,0,0,1,0,0
79002,26,0,26,26,0,0,0,0,0
79003,166,16,150,146,0,2,0,0,0
79005,1693,922,771,719,3,9,1,0,0
79007,13819,4287,9532,8202,386,184,87,2,41
79008,0,0,0,0,0,0,0,0,0
79009,1931,1582,349,320,17,0,0,0,5
79010,506,89,417,343,41,2,2,0,1
79011,253,51,202,190,0,1,0,0,0
79012,22,5,17,16,0,0,0,0,0
79013,2995,2155,840,125,359,3,322,0,15
79014,3281,1098,2183,2032,3,17,10,0,4
79015,21710,3632,18078,16428,444,151,215,10,87
79016,668,189,479,318,119,5,9,1,5
79018,508,113,395,368,2,8,0,0,0
79019,1713,149,1564,1457,6,17,10,0,2
79021,80,41,39,36,1,0,0,0,0
79022,10835,4787,6048,5472,261,55,31,6,11
79024,388,90,298,281,0,4,0,0,3
79025,73,24,49,48,0,0,0,0,0
79027,4899,3411,1488,1281,87,32,22,3,9
79029,16230,9569,6661,5259,289,75,653,1,68
79031,1188,743,445,421,11,0,0,1,1
79032,125,59,66,61,0,0,0,1,1
79033,97,27,70,61,0,0,0,0,0
79034,521,98,423,384,0,5,1,0,1
79035,5266,3808,1458,1341,26,12,11,0,27
79036,4643,408,4235,3871,20,60,13,0,7
79039,772,59,713,673,0,4,3,0,0
79040,1685,685,1000,971,2,4,0,1,7
79041,2880,1623,1257,1136,35,11,6,1,5
79042,1190,163,1027,971,9,13,6,0,0
79043,1278,989,289,261,6,3,1,1,0
79044,517,195,322,305,1,4,3,2,0
79045,18621,14127,4494,4077,107,45,43,0,40
79046,451,54,397,358,1,9,0,0,0
79051,22,0,22,21,0,0,0,0,0
79052,1102,543,559,484,29,5,2,0,0
79053,92,12,80,75,1,0,0,0,3
79054,505,31,474,431,1,12,2,0,0
79056,93,2,91,84,1,2,0,0,0
79057,966,114,852,811,7,1,1,0,0
79058,51,18,33,21,0,9,0,0,0
79059,764,51,713,656,3,2,0,0,1
79061,275,21,254,245,1,2,0,0,0
79062,227,97,130,117,0,4,0,0,2
79063,667,66,601,592,0,1,0,0,0
79064,2456,1664,792,757,13,1,0,2,0
79065,19750,6207,13543,11777,825,126,124,0,37
79066,5,0,5,5,0,0,0,0,0
79068,3054,331,2723,2518,13,25,14,1,6
79070,9671,5370,4301,4019,14,31,28,2,21
79072,25590,15840,9750,7706,1290,82,135,28,58
79073,4,3,1,0,0,0,0,0,0
79078,333,38,295,264,0,9,3,0,3
79079,2461,451,2010,1778,74,23,23,2,11
79080,528,42,486,452,1,6,0,0,0
79081,3742,1925,1817,1724,10,11,9,2,9
79082,342,123,219,208,3,0,0,0,1
79083,2321,291,2030,1859,15,30,4,0,2
79084,2236,1151,1085,996,10,4,2,0,6
79085,34,11,23,18,1,1,0,0,0
79086,2122,939,1183,1104,5,10,5,0,0
79087,720,266,454,428,1,3,0,0,0
79088,5331,2535,2796,2279,371,10,8,0,8
79091,117,16,101,87,0,1,0,0,5
79092,1121,230,891,845,0,4,8,0,0
79093,70,22,48,46,0,0,0,0,0
79094,25,0,25,25,0,0,0,0,0
79095,2293,744,1549,1361,105,22,7,0,0
79096,2033,726,1307,1258,6,9,1,0,1
79097,1093,97,996,918,1,2,2,0,0
79098,526,71,455,404,3,3,1,0,1
79101,2307,664,1643,1350,168,16,13,0,15
79102,9252,3336,5916,4074,593,62,710,0,156
79103,10532,6371,4161,3291,384,36,128,3,29
79104,7166,5334,1832,1379,184,36,70,1,29
79106,27692,7484,20208,16046,2169,180,478,10,114
79107,37480,18504,18976,6507,7611,119,3849,2,96
79108,12117,2987,9130,7904,335,108,219,4,30
79109,42509,8506,34003,29304,1820,248,642,16,214
79110,18285,5264,13021,11148,741,96,240,7,62
79111,1612,455,1157,933,88,16,30,0,3
79118,27608,8080,19528,16474,975,142,834,8,84
79119,21147,3534,17613,15640,480,96,582,9,51
79121,6601,925,5676,5059,139,38,229,1,6
79124,11585,1357,10228,9020,304,57,385,2,37
79201,6702,1955,4747,3871,571,21,51,2,16
79220,115,27,88,86,0,0,0,0,1
79223,17,0,17,17,0,0,0,0,0
79225,774,256,518,469,16,4,0,0,1
79226,2858,292,2566,2235,163,22,9,1,7
79227,1143,207,936,880,19,0,5,1,2
79229,361,77,284,270,0,0,0,0,3
79230,149,53,96,91,3,0,0,0,0
79231,40,16,24,22,0,0,0,0,0
79233,146,46,100,82,12,0,0,0,0
79234,96,19,77,75,0,0,0,0,0
79235,3296,1940,1356,1196,84,6,6,0,7
79236,202,18,184,181,0,0,0,1,0
79237,405,54,351,315,4,4,1,0,0
79239,103,33,70,68,0,0,0,0,0
79240,62,12,50,48,0,1,0,0,0
79241,2014,1099,915,824,41,1,5,1,6
79243,81,24,57,54,0,0,0,0,1
79244,649,113,536,500,7,0,0,0,1
79245,2192,782,1410,1171,173,5,9,0,1
79247,54,2,52,50,0,0,1,0,0
79248,1367,326,1041,891,95,2,0,4,0
79250,1281,766,515,478,5,3,5,1,2
79251,59,5,54,53,0,0,0,0,0
79252,2847,579,2268,2022,116,10,18,1,6
79255,477,124,353,332,5,1,1,0,0
79256,287,22,265,252,0,0,0,0,1
79257,948,243,705,665,12,3,0,0,2
79258,20,9,11,11,0,0,0,0,0
79259,48,2,46,43,0,0,0,0,0
79261,384,95,289,268,4,1,0,0,2
79311,3479,1527,1952,1788,68,4,2,0,8
79312,934,539,395,334,39,2,0,0,3
79313,1394,590,804,727,25,12,2,0,2
79314,61,35,26,26,0,0,0,0,0
79316,10619,5965,4654,4014,388,28,37,0,24
79322,1720,931,789,707,53,2,3,0,1
79323,6541,4455,2086,1875,54,16,45,1,13
79324,50,16,34,34,0,0,0,0,0
79325,2283,1001,1282,1253,9,2,3,0,3
79326,22,0,22,19,0,2,0,0,0
79329,3214,1183,2031,1922,20,8,7,1,2
79330,169,24,145,142,0,2,0,0,0
79331,11825,6494,5331,4242,847,22,55,1,19
79336,15953,8395,7558,6639,490,44,46,4,47
79339,6744,3755,2989,2560,304,7,5,2,11
79342,322,120,202,194,1,2,0,0,0
79343,1325,726,599,537,39,1,0,1,0
79344,2,0,2,2,0,0,0,0,0
79345,857,498,359,339,1,0,0,0,0
79346,2095,1309,786,697,53,2,0,0,0
79347,7169,4596,2573,2396,50,24,8,0,27
79350,341,152,189,178,4,0,0,0,0
79351,1061,527,534,514,6,1,1,0,0
79353,38,9,29,26,3,0,0,0,0
79355,1867,1039,828,788,1,8,0,0,0
79356,5695,3262,2433,2042,231,27,26,0,10
79357,1972,1179,793,715,23,5,8,0,1
79358,1335,405,930,876,11,8,1,0,2
79359,2800,1777,1023,882,112,3,3,0,6
79360,17803,5978,11825,11347,127,35,70,2,40
79363,6259,1601,4658,4346,29,41,10,0,44
79364,7985,3789,4196,3597,326,19,13,4,27
79366,1189,155,1034,956,18,1,6,0,1
79367,594,234,360,331,11,7,0,0,1
79369,83,33,50,47,0,0,0,0,0
79370,1417,400,1017,952,18,0,1,2,6
79371,1331,630,701,650,24,2,0,0,7
79372,1247,640,607,567,16,4,0,0,4
79373,3068,1314,1754,1552,89,14,9,4,6
79376,64,27,37,36,0,0,0,0,0
79377,276,117,159,154,0,0,0,0,0
79378,241,88,153,151,0,1,0,0,0
79379,448,216,232,210,9,4,0,0,0
79380,119,59,60,55,0,0,0,0,1
79381,1297,455,842,791,8,1,1,0,5
79382,8449,2308,6141,5560,156,42,71,1,24
79383,75,44,31,28,1,0,0,0,0
79401,8775,2996,5779,3884,984,54,531,8,54
79402,0,0,0,0,0,0,0,0,0
79403,15604,7114,8490,3860,4160,59,50,4,26
79404,9956,5525,4431,1880,2334,26,28,2,24
79406,6848,167,6681,703,3763,308,1884,4,0
79407,23208,7973,15235,12491,1106,102,695,10,56
79410,8615,2403,6212,5228,400,38,182,2,15
79411,7297,4222,3075,2146,644,48,40,1,27
79412,14834,8965,5869,3535,1810,42,80,18,52
79413,20962,6927,14035,11586,1260,85,322,11,97
79414,17537,7371,10166,7496,1585,82,403,13,66
79415,17499,10128,7371,4898,1175,57,852,18,71
79416,36251,12085,24166,18851,2393,134,1415,39,145
79423,42311,13010,29301,25137,1943,141,721,26,84
79424,53479,10989,42490,36823,1543,155,2179,16,153
79501,3594,1233,2361,2113,71,11,37,2,5
79502,1087,209,878,825,17,3,5,0,2
79503,224,18,206,194,1,1,3,0,0
79504,2980,304,2676,2519,2,16,10,0,7
79505,223,37,186,174,6,0,1,0,0
79506,653,49,604,544,3,11,0,1,0
79508,1256,124,1132,1046,16,5,9,0,4
79510,7985,751,7234,6669,108,35,34,7,37
79511,1182,364,818,766,4,3,11,0,2
79512,7974,3080,4894,3752,896,32,54,0,11
79517,212,41,171,162,0,1,0,0,1
79518,107,17,90,89,0,0,0,0,0
79519,70,4,66,58,1,2,2,0,0
79520,2169,649,1520,1327,111,9,16,0,6
79521,3672,956,2716,2422,159,11,22,3,15
79525,2902,248,2654,2538,4,12,6,0,12
79526,1071,258,813,770,8,1,5,0,0
79527,360,54,306,290,0,0,0,0,0
79528,595,70,525,512,2,3,0,0,3
79529,1272,419,853,735,58,7,8,3,0
79530,587,64,523,484,0,4,0,0,0
79532,796,333,463,401,29,3,0,1,0
79533,417,54,363,332,2,1,1,0,2
79534,208,23,185,174,0,0,1,0,4
79535,165,16,149,142,0,0,0,0,0
79536,5133,853,4280,3999,47,18,13,1,6
79537,69,3,66,65,1,0,0,0,0
79538,243,15,228,216,2,0,3,0,0
79539,151,48,103,97,0,1,0,0,0
79540,101,8,93,85,1,0,0,0,0
79541,943,97,846,768,13,12,0,0,4
79543,1005,235,770,736,13,1,0,0,3
79544,434,117,317,284,10,6,0,1,4
79545,1772,688,1084,998,20,13,7,0,9
79546,1798,614,1184,1045,76,9,11,2,3
79547,666,156,510,456,10,5,0,1,5
79548,165,27,138,123,1,1,0,0,0
79549,15456,6774,8682,7596,591,56,77,5,27
79553,3202,1158,2044,1686,236,14,5,1,6
79556,12644,4658,7986,6867,600,35,95,2,22
79560,143,22,121,113,1,0,0,0,1
79561,674,111,563,506,4,5,1,0,3
79562,5264,497,4767,4508,24,30,27,2,16
79563,1152,239,913,809,34,5,4,0,5
79565,252,53,199,194,0,0,0,0,0
79566,245,28,217,204,0,1,1,0,2
79567,3113,1191,1922,1778,42,10,3,1,2
79601,26515,6583,19932,14821,3614,109,423,18,82
79602,25389,5491,19898,16562,1620,99,452,31,98
79603,23746,10221,13525,9619,2681,94,151,14,51
79605,30239,7642,22597,18139,2452,139,453,32,93
79606,27818,4514,23304,18826,1653,81,1251,44,107
79607,2983,642,2341,1636,366,12,79,20,8
79699,169,40,129,93,23,0,6,0,3
79701,29748,18375,11373,7271,3097,110,246,15,130
79703,21205,10732,10473,7759,1240,128,675,37,71
79705,44138,16436,27702,21941,3528,196,644,32,148
79706,31805,16249,15556,13456,776,72,378,20,110
79707,37632,9754,27878,23109,1651,143,1618,44,135
79713,592,191,401,391,2,0,0,3,0
79714,18588,10391,8197,7396,191,96,102,0,49
79718,668,478,190,171,1,0,3,1,2
79719,300,247,53,42,0,3,1,0,1
79720,31948,14183,17765,14847,1491,204,358,13,66
79721,1660,1584,76,36,23,0,17,0,0
79730,218,175,43,39,0,1,1,0,0
79731,4496,3086,1410,1236,70,14,22,0,1
79733,225,51,174,162,1,2,0,0,0
79734,1811,526,1285,1206,0,5,12,0,11
79735,13088,9612,3476,2691,488,23,121,0,34
79738,295,55,240,235,1,0,0,0,0
79739,885,330,555,545,5,0,0,1,0
79741,298,73,225,209,5,3,0,0,1
79742,457,236,221,198,11,0,1,0,0
79743,324,181,143,129,2,2,2,0,0
79744,1164,685,479,439,2,6,10,0,1
79745,6857,4385,2472,2140,132,36,77,0,8
79748,103,28,75,72,0,2,0,0,0
79749,379,85,294,279,3,0,0,0,0
79752,2226,1412,814,699,48,4,2,0,2
79754,57,1,56,50,0,1,0,0,1
79755,160,82,78,65,0,2,0,0,0
79756,10318,5614,4704,3964,396,35,65,2,19
79758,2898,898,2000,1842,37,9,8,0,10
79759,81,49,32,28,0,1,0,0,0
79761,30187,18300,11887,8228,2517,110,313,57,90
79762,40253,18566,21687,17118,2249,184,885,93,156
79763,39767,30163,9604,7681,1128,93,134,44,77
79764,26271,17221,9050,7652,517,92,205,82,70
79765,21163,9141,12022,9270,993,86,1025,54,83
79766,9688,7434,2254,1918,159,29,16,2,31
79769,13,2,11,9,0,0,0,0,0
79770,38,24,14,14,0,0,0,0,0
79772,13867,11892,1975,1453,223,27,162,2,37
79776,3,3,0,0,0,0,0,0,0
79777,105,40,65,62,0,0,0,0,1
79778,892,279,613,550,11,4,2,0,1
79780,101,94,7,7,0,0,0,0,0
79781,222,65,157,133,13,0,3,0,0
79782,4641,2144,2497,2310,79,21,10,1,20
79783,142,31,111,110,0,0,0,0,0
79785,68,33,35,34,0,0,0,0,0
79788,438,166,272,237,8,3,2,0,1
79789,927,347,580,555,7,2,0,0,1
79821,6416,5546,870,628,87,71,30,2,22
79830,7621,3219,4402,3914,81,24,84,6,45
79832,471,253,218,128,79,0,5,3,1
79834,150,34,116,114,0,0,0,0,0
79835,12456,11339,1117,798,129,34,59,4,35
79836,7217,6760,457,385,21,12,3,2,17
79837,389,214,175,158,1,5,0,0,0
79838,7895,7652,243,203,7,0,1,2,12
79839,1113,1050,63,56,2,0,0,0,1
79842,445,194,251,239,0,3,3,0,2
79843,2275,1361,914,838,16,10,16,0,2
79845,3717,3523,194,97,8,5,69,0,4
79846,49,43,6,4,1,0,0,0,1
79847,151,55,96,85,3,0,2,0,1
79848,696,365,331,298,8,0,5,0,2
79849,14310,13969,341,241,27,21,1,0,19
79851,1339,577,762,733,2,2,10,0,0
79852,712,219,493,458,2,1,1,2,6
79853,3638,3554,84,69,0,5,2,0,0
79854,163,82,81,64,0,0,2,0,4
79855,2071,1584,487,398,16,11,25,0,3
79901,10027,9022,1005,718,173,7,27,8,23
79902,20071,15439,4632,3181,598,48,444,9,83
79903,16425,15000,1425,1033,163,24,75,5,41
79904,31491,23313,8178,4978,1675,92,379,211,134
79905,22483,21602,881,599,79,20,40,15,57
79906,5336,1346,3990,2623,675,36,188,65,46
79907,50971,48622,2349,1530,262,228,67,15,64
79908,3583,924,2659,1669,472,22,142,71,42
79911,8023,5323,2700,1897,280,23,293,3,25
79912,78652,54825,23827,17471,1897,141,2659,47,262
79915,35234,33415,1819,1135,328,51,85,17,78
79916,3800,997,2803,1349,448,125,582,93,7
79918,362,94,268,138,35,13,42,2,1
79920,51,10,41,20,8,0,12,0,1
79922,8133,5327,2806,2494,59,17,77,2,20
79924,58721,43016,15705,9445,3536,140,974,172,217
79925,38422,30990,7432,5202,1209,104,361,59,116
79927,40290,38896,1394,882,86,234,37,7,54
79928,78971,71583,7388,4606,1409,134,412,111,192
79930,24553,21290,3263,2226,509,59,132,22,40
79932,29996,23982,6014,4800,421,61,274,22,77
79934,29386,17831,11555,6308,2872,158,812,166,132
79935,17534,14438,3096,2198,497,49,150,7,45
79936,105150,91942,13208,8592,2315,169,988,87,245
79938,96353,77483,18870,10901,4138,267,1344,301,319
80002,20267,4964,15303,13665,223,132,327,26,98
80003,36258,9112,27146,23271,602,205,1278,19,144
80004,36076,4830,31246,28464,315,156,580,18,138
80005,28742,3183,25559,23358,160,72,643,16,125
80007,17997,1715,16282,14596,80,36,742,2,46
80010,42303,22048,20255,9211,6248,205,2746,171,271
80011,54254,27766,26488,12400,8990,273,2397,416,262
80012,49897,16579,33318,16290,11301,202,2648,339,215
80013,75099,17427,57672,36701,10091,331,5292,166,513
80014,41711,7409,34302,22122,6218,182,3273,107,270
80015,71466,11026,60440,43011,6288,206,6142,131,385
80016,65406,7552,57854,42169,4231,199,7035,61,320
80017,37637,11936,25701,13437,7520,180,1950,275,243
80018,16106,4466,11640,7666,2004,80,912,21,85
80019,3865,1209,2656,999,1138,9,252,18,39
80020,52141,7364,44777,37995,580,173,3055,45,258
80021,36176,4787,31389,26931,571,132,1756,29,190
80022,57432,30476,26956,20976,2157,292,1337,74,250
80023,25964,2628,23336,19236,283,37,2468,24,80
80024,170,115,55,51,1,0,1,0,0
80025,212,14,198,189,0,1,0,0,2
80026,32318,5773,26545,23164,334,90,1295,17,167
80027,34413,2807,31606,26552,276,67,2716,19,178
80030,15885,6920,8965,7199,287,105,748,6,70
80031,37254,9411,27843,23011,531,191,2267,38,141
80033,26618,5800,20818,18346,361,178,581,27,155
80045,1278,144,1134,747,139,9,194,8,2
80101,415,61,354,328,5,3,0,0,2
80102,6520,1344,5176,4609,102,32,44,18,32
80103,2704,318,2386,2218,22,17,18,2,1
80104,34727,4072,30655,27445,402,125,612,39,199
80105,1771,349,1422,1302,5,14,9,1,7
80106,4547,309,4238,3850,47,19,35,5,38
80107,13766,1078,12688,11733,61,64,101,8,71
80108,32188,2822,29366,26322,373,79,911,39,109
80109,27148,3027,24121,21485,386,66,653,21,106
80110,23279,6732,16547,13797,688,179,732,11,107
80111,32672,2662,30010,23102,678,71,4392,25,199
80112,35713,3593,32120,24976,1603,102,3443,19,173
80113,22821,2793,20028,17534,518,122,580,31,114
80116,4716,271,4445,4109,26,18,49,0,27
80117,2751,202,2549,2403,7,12,10,1,9
80118,6057,406,5651,5220,30,18,87,5,37
80120,29445,4072,25373,22739,436,156,575,27,126
80121,18176,1634,16542,15095,163,53,374,34,79
80122,32336,2799,29537,26528,379,75,914,9,156
80123,47302,6776,40526,35301,620,259,2100,18,190
80124,22541,2147,20394,16511,405,74,2199,21,100
80125,12482,1217,11265,10111,65,48,328,10,44
80126,44221,3750,40471,34748,456,111,2683,19,208
80127,44776,4432,40344,36260,285,134,1347,29,208
80128,36699,4331,32368,29087,315,123,885,23,197
80129,29703,2701,27002,23557,308,71,1585,21,114
80130,27250,2461,24789,19997,351,61,2882,15,110
80131,243,21,222,209,1,1,0,0,0
80132,27533,2069,25464,22700,351,89,570,12,237
80133,2520,221,2299,2131,13,6,24,0,13
80134,76369,7315,69054,57510,1211,190,6085,57,313
80135,4100,243,3857,3576,11,9,44,3,32
80136,6028,981,5047,4617,55,28,50,6,27
80137,1250,287,963,829,24,4,10,6,2
80138,34337,3267,31070,27653,498,90,855,45,141
80202,19606,2031,17575,14882,627,85,936,16,174
80203,22883,2971,19912,16831,1005,144,706,14,133
80204,35269,14149,21120,15886,2532,365,858,34,161
80205,34967,8157,26810,18621,5315,208,731,42,174
80206,26108,2304,23804,20834,806,84,739,13,129
80207,21170,3705,17465,10443,5320,97,320,8,146
80209,27061,1897,25164,22777,366,52,708,16,136
80210,39394,3267,36127,31653,618,111,1608,20,166
80211,37940,8580,29360,25587,945,189,862,21,164
80212,20397,4177,16220,14483,271,101,440,16,104
80214,26493,8818,17675,14717,844,283,490,67,130
80215,19908,3516,16392,14255,367,155,544,53,135
80216,15915,7953,7962,5720,1356,148,219,10,102
80218,19484,2054,17430,15001,922,85,422,17,102
80219,61585,41448,20137,13837,1422,518,2623,53,316
80220,37233,5527,31706,24413,3363,174,1617,19,183
80221,42224,23766,18458,15078,606,283,1086,62,200
80222,22381,3389,18992,15379,1391,83,877,22,133
80223,19862,9327,10535,8181,776,173,622,16,115
80224,19199,2835,16364,12324,2229,62,649,13,143
80226,33142,10148,22994,19778,535,249,1003,17,193
80227,35567,9258,26309,22327,502,240,1681,37,176
80228,34836,4295,30541,26961,405,154,1257,18,141
80229,54153,30024,24129,18451,1191,406,2139,35,278
80230,9898,1302,8596,6438,1121,35,378,8,81
80231,36014,7383,28631,19086,5645,199,1670,59,202
80232,22240,6273,15967,13349,222,150,1264,28,90
80233,48050,16728,31322,25867,836,309,1920,81,225
80234,29660,8119,21541,17768,561,175,1647,18,149
80235,8639,2331,6308,5248,261,57,347,17,60
80236,16565,7408,9157,7055,407,107,974,12,64
80237,23108,2774,20334,15921,1924,86,1077,17,159
80238,28937,3285,25652,20177,1664,61,1709,12,148
80239,46177,27769,18408,5800,9100,250,1299,588,139
80241,33097,7877,25220,21037,544,170,1649,31,135
80246,13265,2545,10720,8629,791,67,435,5,90
80247,29181,5830,23351,13033,7167,124,1504,21,170
80249,36794,14268,22526,6813,10027,118,3445,277,204
80260,36691,21875,14816,11625,648,250,1208,33,129
80264,0,0,0,0,0,0,0,0,0
80266,8,0,8,2,0,0,3,0,0
80290,446,60,386,324,13,0,33,0,3
80293,0,0,0,0,0,0,0,0,0
80294,0,0,0,0,0,0,0,0,0
80301,25944,3343,22601,19723,255,55,1177,8,142
80302,27322,1792,25530,22201,274,89,1582,17,160
80303,25328,2055,23273,19437,254,103,2019,20,183
80304,27532,3724,23808,21152,240,39,903,14,143
80305,17283,1107,16176,14068,120,35,964,8,114
80310,8281,1109,7172,5754,306,121,921,64,0
80401,41913,4091,37822,33603,535,206,1421,34,212
80403,21335,1319,20016,18327,61,31,505,2,99
80419,0,0,0,0,0,0,0,0,0
80420,927,78,849,787,1,4,5,1,5
80421,8179,578,7601,6984,37,42,35,5,43
80422,4037,226,3811,3529,15,29,28,4,32
80423,137,19,118,108,2,0,0,0,0
80424,10474,1001,9473,8783,55,13,144,4,54
80425,273,17,256,239,0,1,0,1,3
80426,75,11,64,62,0,0,0,0,0
80427,1051,109,942,799,17,7,47,0,3
80428,706,25,681,656,4,1,0,3,0
80430,91,4,87,79,0,1,0,0,0
80432,631,50,581,541,9,3,9,0,0
80433,8209,434,7775,7257,16,23,53,9,47
80434,56,2,54,47,0,3,0,1,1
80435,8344,2225,6119,5616,67,16,102,9,49
80436,541,61,480,442,3,7,2,0,3
80438,534,43,491,453,2,5,0,0,1
80439,24711,1104,23607,22101,66,91,230,3,122
80440,2564,204,2360,2190,19,8,20,2,9
80442,2537,191,2346,2241,11,1,14,2,11
80443,4170,315,3855,3608,13,14,58,5,21
80444,1171,128,1043,961,7,3,11,6,6
80446,3998,534,3464,3279,19,21,16,0,17
80447,2020,107,1913,1813,1,10,8,2,12
80448,204,40,164,137,3,9,0,0,6
80449,1134,84,1050,969,3,7,6,1,15
80451,755,58,697,643,2,0,9,0,4
80452,3313,210,3103,2893,25,9,33,0,11
80453,259,11,248,235,3,0,1,0,0
80454,1437,71,1366,1283,1,4,16,0,11
80455,517,21,496,463,1,6,2,0,2
80456,651,40,611,566,1,9,5,0,0
80457,728,34,694,654,2,2,2,0,3
80459,2454,440,2014,1904,10,11,3,6,9
80461,7196,2638,4558,4092,28,43,61,8,45
80463,133,8,125,123,0,0,0,0,0
80465,16196,1593,14603,13317,103,52,291,8,100
80466,3332,128,3204,2979,3,12,34,0,22
80467,2302,155,2147,2002,6,4,4,1,13
80468,341,33,308,280,0,0,0,4,5
80469,318,19,299,280,0,0,0,0,0
80470,3684,203,3481,3225,10,22,35,3,21
80471,37,1,36,30,0,1,2,0,0
80473,60,5,55,52,0,0,0,0,0
80474,203,13,190,171,0,0,2,0,1
80475,230,28,202,189,2,2,2,0,0
80476,239,15,224,202,4,0,4,1,1
80478,1498,74,1424,1365,2,6,10,0,12
80479,48,8,40,35,0,0,0,0,2
80480,1172,127,1045,983,0,8,2,1,4
80481,544,8,536,480,1,1,8,1,8
80482,1755,79,1676,1581,14,7,23,3,1
80483,576,23,553,540,1,0,0,0,0
80487,18209,1742,16467,15457,134,56,155,22,67
80498,8405,1805,6600,6095,97,24,103,2,28
80501,42822,13528,29294,25896,413,196,845,21,234
80503,35863,3768,32095,27931,305,147,1879,33,220
80504,60183,13353,46830,41594,449,208,1730,38,299
80510,439,19,420,389,0,5,3,0,0
80512,2056,126,1930,1749,9,10,18,0,8
80513,15824,1482,14342,13280,42,65,163,11,100
80514,6350,2198,4152,3642,58,34,180,8,13
80515,845,46,799,772,0,0,6,0,5
80516,34376,3615,30761,26672,261,64,1940,26,151
80517,9720,1124,8596,8063,48,42,155,4,25
80520,1933,606,1327,1212,9,8,14,1,7
80521,37451,4663,32788,28376,705,169,1487,40,178
80524,39030,7320,31710,28569,340,206,641,31,231
80525,55901,6002,49899,44413,650,235,1704,33,293
80526,45624,5629,39995,35760,521,150,1116,41,186
80528,23660,2897,20763,17706,241,71,1463,11,106
80530,5428,1187,4241,3852,28,14,69,7,20
80532,214,8,206,193,0,1,0,0,1
80534,18785,3027,15758,14497,123,64,274,9,75
80535,2543,248,2295,2103,5,22,21,4,18
80536,2023,97,1926,1807,19,7,5,2,14
80537,43603,5125,38478,35297,291,212,449,25,268
80538,49084,6320,42764,39208,341,222,538,47,235
80540,4710,224,4486,4226,8,12,34,3,20
80542,4841,591,4250,3974,10,18,50,0,16
80543,8696,2358,6338,5828,30,38,36,3,33
80544,138,12,126,97,0,0,6,0,8
80545,1051,59,992,935,6,3,3,1,12
80546,306,46,260,246,2,0,2,0,2
80547,6536,549,5987,5298,39,12,304,1,39
80549,13530,1893,11637,10550,92,45,76,11,76
80550,38909,4223,34686,32187,208,112,506,18,119
80601,40460,17138,23322,20092,551,194,737,74,226
80602,43375,8871,34504,27934,600,139,3629,31,195
80603,16078,6060,10018,8745,238,80,286,21,82
80610,3570,775,2795,2558,3,12,10,0,10
80611,868,103,765,690,0,4,4,1,3
80612,669,57,612,554,2,5,2,1,4
80615,9486,1641,7845,7329,38,22,70,16,39
80620,20975,10040,10935,9236,342,88,477,53,82
80621,13343,6530,6813,6149,75,53,77,3,71
80622,121,5,116,112,0,1,0,0,0
80623,999,521,478,446,1,1,4,0,5
80624,968,244,724,689,0,3,0,1,3
80631,52336,26628,25708,20762,1933,273,1090,58,197
80634,65980,20435,45545,40772,842,293,1051,54,244
80640,13106,6005,7101,5800,248,58,482,12,33
80642,4139,1061,3078,2876,25,12,22,2,14
80643,3599,485,3114,2904,38,16,19,1,16
80644,3006,774,2232,2101,3,16,5,0,11
80645,4245,1352,2893,2660,22,27,12,1,9
80646,6,4,2,1,0,0,0,0,0
80648,1261,113,1148,1058,3,5,3,2,2
80649,397,63,334,315,0,1,2,0,1
80650,1884,350,1534,1411,1,7,8,1,12
80651,4987,1755,3232,2923,12,27,27,3,8
80652,563,100,463,439,1,1,0,0,8
80653,757,82,675,652,1,3,0,0,1
80654,3230,622,2608,2434,19,12,16,0,11
80701,16101,6766,9335,7936,827,68,89,8,41
80705,985,559,426,365,22,8,0,0,1
80720,2623,343,2280,2151,20,3,7,4,7
80721,155,27,128,125,0,1,0,0,0
80722,370,30,340,328,0,1,4,0,1
80723,7092,2395,4697,4380,65,16,45,2,21
80726,406,39,367,356,0,1,1,0,0
80727,439,103,336,326,0,0,0,1,0
80728,892,54,838,807,0,11,0,0,4
80729,533,62,471,441,1,1,2,0,2
80731,1526,104,1422,1356,7,6,4,1,3
80732,25,2,23,20,0,0,0,0,0
80733,564,81,483,468,1,3,2,0,2
80734,3087,1058,2029,1953,6,6,18,0,5
80735,467,114,353,342,0,1,1,0,1
80736,619,89,530,515,0,0,1,0,2
80737,1615,243,1372,1294,3,9,9,0,3
80740,101,6,95,88,0,0,0,0,0
80741,903,81,822,790,2,0,3,5,5
80742,329,24,305,286,0,3,0,4,0
80743,1119,85,1034,974,4,1,1,3,9
80744,433,72,361,350,0,1,0,0,0
80745,117,20,97,94,1,0,0,0,0
80746,47,4,43,42,0,0,1,0,0
80747,488,26,462,441,2,5,2,0,2
80749,344,45,299,284,0,0,3,0,3
80750,391,58,333,316,0,1,4,1,0
80751,17702,3174,14528,12974,745,142,109,15,38
80754,157,11,146,136,0,1,0,0,0
80755,176,21,155,151,0,0,0,0,1
80757,185,3,182,173,0,0,0,0,1
80758,3784,810,2974,2853,17,11,15,1,11
80759,4590,1665,2925,2817,4,4,8,0,14
80801,151,22,129,119,0,0,0,1,1
80802,234,15,219,208,0,1,0,0,0
80804,357,7,350,323,0,7,0,0,2
80805,416,90,326,304,0,4,3,0,3
80807,4232,1071,3161,2921,10,13,21,5,23
80808,6990,1003,5987,5384,55,39,33,3,50
80809,1525,95,1430,1338,5,4,14,1,5
80810,1038,116,922,884,0,1,3,0,2
80812,191,26,165,154,0,1,5,0,1
80813,1961,142,1819,1630,16,20,15,0,10
80814,3890,297,3593,3245,13,22,34,2,38
80815,890,63,827,777,6,3,1,0,4
80816,5794,380,5414,4983,20,42,28,2,39
80817,31621,7450,24171,17585,2690,195,703,343,213
80818,386,19,367,353,1,2,0,1,1
80819,800,39,761,705,7,3,11,0,1
80820,780,40,740,690,4,9,1,0,7
80821,1115,48,1067,1002,4,1,2,0,7
80822,247,28,219,213,0,1,0,0,0
80823,199,9,190,174,0,2,0,0,0
80824,185,16,169,164,0,0,1,0,0
80825,399,71,328,306,1,3,0,0,1
80826,904,333,571,280,246,35,10,0,0
80827,826,43,783,713,5,12,7,0,4
80828,2603,365,2238,2051,24,13,25,21,9
80829,5343,366,4977,4537,50,28,60,3,36
80830,238,16,222,209,0,0,0,0,1
80831,32823,4338,28485,24152,1050,164,595,64,201
80832,877,57,820,740,4,9,3,1,6
80833,784,155,629,558,4,4,3,3,4
80834,330,29,301,287,0,3,0,0,0
80835,870,64,806,752,5,6,0,1,1
80836,1116,140,976,928,4,1,5,0,2
80840,6609,936,5673,4365,495,38,394,45,27
80860,547,19,528,426,1,2,1,2,4
80861,258,26,232,223,1,2,0,0,0
80862,47,2,45,44,0,0,0,0,0
80863,12738,880,11858,10925,89,39,123,6,58
80864,1495,212,1283,1143,13,5,11,0,5
80902,10926,2600,8326,5755,1144,97,288,167,81
80903,15944,2332,13612,10971,1028,106,416,24,70
80904,20986,2512,18474,16443,386,106,278,35,110
80905,17592,3590,14002,11431,842,111,370,60,116
80906,39019,6495,32524,26270,2140,204,1392,143,204
80907,28806,4629,24177,20855,908,183,493,33,176
80908,22811,2417,20394,17599,562,72,640,36,188
80909,37302,8547,28755,22960,2340,281,542,72,232
80910,30991,10473,20518,13344,3864,241,880,147,182
80911,34577,7378,27199,20012,2880,211,905,299,234
80913,7384,1411,5973,3897,1279,3,258,41,83
80914,696,119,577,388,75,1,51,17,2
80915,22548,5598,16950,12954,1410,156,566,87,159
80916,39990,14980,25010,15573,4745,245,1268,286,260
80917,30513,5115,25398,20690,1649,133,699,110,147
80918,47453,7272,40181,33570,1922,233,1107,55,273
80919,28909,2695,26214,22996,561,95,817,16,195
80920,39540,4542,34998,29125,1100,161,1891,78,248
80921,25158,2205,22953,19158,621,68,1518,37,143
80922,29392,5244,24148,18410,1856,136,1265,112,208
80923,31849,4933,26916,21320,1560,161,1464,117,182
80924,15058,1781,13277,10477,604,57,985,29,60
80925,15061,3126,11935,8263,1658,86,467,217,127
80926,1517,230,1287,1131,13,8,15,6,8
80927,7373,1170,6203,4803,391,33,379,7,55
80928,1129,155,974,842,35,3,9,0,7
80929,503,88,415,302,8,8,6,6,5
80930,1527,242,1285,1105,52,16,14,10,5
80938,421,83,338,261,32,0,10,2,0
80939,0,0,0,0,0,0,0,0,0
80951,4588,997,3591,2633,312,9,192,23,26
81001,31107,16817,14290,11959,590,305,322,31,174
81003,15169,7275,7894,6423,531,160,114,15,104
81004,26005,12702,13303,11248,570,228,125,21,170
81005,31327,14226,17101,15185,533,162,216,21,168
81006,11653,4207,7446,6775,70,89,43,2,52
81007,33263,8443,24820,22149,377,185,409,22,173
81008,11868,4684,7184,6036,285,66,295,23,72
81019,2022,281,1741,1637,10,20,6,0,8
81020,890,285,605,562,0,3,4,2,10
81021,27,2,25,24,0,0,0,0,0
81022,1463,590,873,789,9,12,3,0,7
81023,1339,155,1184,1124,8,1,1,2,5
81024,277,68,209,200,0,0,0,0,2
81025,950,276,674,621,3,7,18,0,3
81027,110,14,96,91,0,0,0,0,5
81029,329,20,309,285,2,4,0,0,1
81030,173,49,124,106,0,0,0,0,0
81033,182,57,125,120,0,4,0,0,0
81036,991,76,915,845,3,0,9,1,1
81039,1971,351,1620,1530,4,14,0,1,8
81040,448,139,309,278,0,6,0,0,2
81041,603,369,234,215,0,9,0,0,3
81043,39,11,28,23,0,2,0,0,0
81044,273,57,216,190,2,1,0,0,0
81045,141,6,135,127,0,0,0,0,0
81046,13,5,8,7,0,0,0,0,0
81047,1577,588,989,900,2,18,8,0,5
81049,202,37,165,154,0,1,0,0,1
81050,9924,4283,5641,5076,95,58,59,19,66
81052,9142,3578,5564,5058,80,89,22,6,41
81054,4823,1603,3220,2697,247,88,39,0,8
81055,1489,154,1335,1257,9,8,3,0,4
81057,355,68,287,269,5,0,0,0,0
81058,844,257,587,543,1,10,0,4,10
81059,125,18,107,94,0,3,1,0,0
81062,2536,691,1845,1387,301,79,36,0,0
81063,2724,776,1948,1579,200,61,31,2,0
81064,251,16,235,228,1,0,0,0,1
81067,5521,2667,2854,2595,31,31,34,5,20
81069,1944,210,1734,1588,7,11,13,0,12
81071,303,17,286,269,0,0,0,0,0
81073,1817,188,1629,1503,13,21,7,0,19
81076,416,74,342,298,9,7,3,0,5
81077,619,160,459,435,4,1,5,0,0
81081,85,16,69,63,0,3,0,0,0
81082,12026,4994,7032,6206,181,128,101,10,58
81084,116,12,104,98,0,2,1,0,0
81087,135,19,116,108,0,1,0,0,1
81089,4656,1821,2835,2501,44,62,18,0,40
81090,875,93,782,708,3,10,0,0,15
81091,786,190,596,557,2,7,2,0,9
81092,866,174,692,670,2,1,1,0,1
81101,15657,7546,8111,7014,209,204,142,17,92
81120,2063,1453,610,550,9,5,1,0,8
81121,284,57,227,201,0,16,1,0,2
81122,9808,1040,8768,7898,22,305,42,8,57
81123,727,324,403,326,10,9,24,0,1
81124,174,147,27,26,0,0,0,0,0
81125,2989,2038,951,822,2,51,6,1,12
81126,239,195,44,30,2,2,3,0,2
81128,110,13,97,88,0,1,0,0,0
81129,78,42,36,33,0,2,0,0,0
81130,800,39,761,728,0,3,2,0,1
81131,1510,84,1426,1287,11,10,40,1,11
81132,2977,1010,1967,1810,10,27,8,3,24
81133,1009,416,593,492,13,15,9,0,6
81136,190,45,145,131,0,3,1,0,1
81137,5094,1142,3952,2567,7,1096,22,1,18
81138,62,15,47,43,0,0,2,0,0
81140,2154,951,1203,1119,2,28,13,2,7
81141,1226,557,669,648,5,4,3,0,2
81143,818,93,725,651,1,9,5,0,13
81144,7347,3357,3990,3565,32,102,22,1,29
81146,547,122,425,358,2,7,0,1,9
81147,12615,2026,10589,9636,40,139,94,4,71
81148,302,219,83,68,1,5,1,0,5
81149,829,218,611,559,5,8,9,1,3
81151,1527,511,1016,965,2,2,4,0,5
81152,1294,943,351,284,6,6,16,0,1
81154,1302,182,1120,1032,9,9,9,0,5
81155,189,22,167,156,0,1,0,0,2
81201,9128,840,8288,7745,31,29,50,4,57
81210,315,27,288,263,3,1,4,0,3
81211,8224,845,7379,6627,263,86,59,4,31
81212,31643,4035,27608,24642,982,365,200,19,123
81220,225,14,211,185,0,6,1,0,4
81221,334,19,315,290,2,0,1,0,2
81222,333,19,314,292,0,5,2,0,2
81223,2190,90,2100,1946,6,32,4,0,17
81224,3941,137,3804,3591,3,5,41,2,15
81225,1074,54,1020,955,1,10,5,1,6
81226,8585,1368,7217,5590,800,245,88,3,52
81227,27,1,26,24,0,1,0,0,0
81228,0,0,0,0,0,0,0,0,0
81230,10598,1361,9237,8542,69,51,70,4,75
81232,11,0,11,11,0,0,0,0,0
81233,881,59,822,771,0,4,3,3,4
81235,728,25,703,647,8,6,2,1,5
81236,1161,60,1101,1027,0,9,10,3,8
81237,86,3,83,83,0,0,0,0,0
81239,53,3,50,48,0,0,0,0,0
81240,4366,399,3967,3672,17,37,33,5,29
81241,132,2,130,112,0,0,1,0,4
81242,1032,95,937,868,1,7,14,0,4
81243,110,4,106,101,1,0,0,0,2
81244,468,55,413,381,2,3,1,0,2
81248,56,3,53,52,0,0,0,0,1
81251,240,24,216,201,3,3,2,0,0
81252,4252,146,4106,3831,8,39,21,0,37
81253,339,22,317,284,2,2,0,0,8
81301,30760,3441,27319,24196,128,1083,256,17,244
81303,8027,1215,6812,6119,22,284,58,4,33
81320,380,19,361,325,0,7,0,0,0
81321,14402,2181,12221,9829,45,1503,101,14,51
81323,4554,369,4185,3756,11,161,9,1,28
81324,1602,115,1487,1348,18,23,2,4,6
81325,170,8,162,151,0,2,0,0,0
81326,2545,292,2253,2023,3,71,12,4,29
81327,588,57,531,483,0,9,3,0,3
81328,4387,446,3941,3545,16,101,17,6,23
81330,28,5,23,17,0,1,0,0,0
81331,512,25,487,455,1,6,0,0,0
81332,296,33,263,248,0,2,3,0,0
81334,1461,34,1427,10,2,1385,0,4,3
81335,86,13,73,62,0,5,0,0,0
81401,23266,5062,18204,16815,114,151,231,15,89
81403,11987,2120,9867,9151,22,75,85,11,65
81410,1780,188,1592,1497,4,1,7,1,16
81411,38,1,37,34,1,0,0,0,0
81413,5271,347,4924,4639,9,21,18,3,28
81415,1674,124,1550,1467,1,2,3,0,11
81416,14304,3034,11270,10284,91,72,178,3,65
81418,1645,155,1490,1394,2,7,10,0,15
81419,3681,342,3339,3105,6,9,12,1,27
81422,539,33,506,449,1,2,2,0,2
81423,1409,139,1270,1179,5,30,0,0,13
81424,1014,59,955,908,1,5,0,0,0
81425,5120,1654,3466,3226,19,26,12,2,17
81426,238,18,220,198,2,1,0,0,3
81427,1099,81,1018,948,7,5,9,0,4
81428,3635,260,3375,3138,8,13,13,1,38
81429,108,6,102,94,0,1,0,0,0
81430,836,52,784,721,2,0,1,0,7
81431,377,9,368,346,1,0,0,0,0
81432,3061,167,2894,2726,9,5,17,0,17
81433,652,86,566,527,1,6,1,0,1
81434,158,11,147,128,0,1,0,0,3
81435,5499,660,4839,4585,11,14,54,0,24
81501,23935,4711,19224,17076,339,222,329,67,196
81503,16121,2418,13703,12471,73,106,173,7,120
81504,31150,6195,24955,22505,226,193,299,49,166
81505,11791,1596,10195,9260,45,40,260,13,52
81506,11412,1058,10354,9626,56,29,118,10,71
81507,16053,1061,14992,13855,53,49,182,5,68
81520,14042,3207,10835,9854,103,122,68,7,62
81521,16446,1829,14617,13535,77,72,96,26,65
81522,107,6,101,94,0,0,1,0,2
81523,892,39,853,803,4,1,4,0,8
81524,2357,176,2181,1990,9,27,16,1,12
81525,1058,72,986,917,1,6,2,0,0
81526,5216,583,4633,4294,13,34,39,3,36
81527,2034,134,1900,1761,7,14,13,0,9
81601,16484,5533,10951,10081,57,42,146,8,94
81610,350,31,319,300,2,2,0,0,1
81611,9637,943,8694,8094,56,18,186,6,58
81612,79,6,73,67,0,0,1,0,1
81615,3083,252,2831,2662,18,4,39,1,2
81620,10038,2923,7115,6470,115,15,231,8,43
81621,6034,1383,4651,4337,24,18,79,3,29
81623,16110,4470,11640,10864,35,38,143,13,76
81624,1196,69,1127,1071,2,4,3,0,6
81625,12560,2067,10493,9688,75,89,52,2,59
81630,1019,99,920,833,8,9,8,0,3
81631,9017,1670,7347,7013,34,10,50,0,12
81632,11343,3794,7549,7057,61,17,150,5,29
81633,17,0,17,17,0,0,0,0,0
81635,7185,1758,5427,4866,55,61,31,9,40
81637,9845,4895,4950,4544,23,34,83,3,33
81638,166,11,155,145,0,4,0,0,0
81639,2498,219,2279,2117,8,6,10,8,10
81640,204,13,191,178,0,2,0,0,0
81641,3772,334,3438,3206,13,23,7,2,16
81642,87,22,65,46,4,0,8,0,0
81643,751,28,723,685,2,3,2,0,9
81645,1033,222,811,783,1,7,4,0,0
81646,189,6,183,173,1,3,0,0,4
81647,7445,2205,5240,4801,27,29,54,1,32
81648,2677,279,2398,2238,16,25,15,0,11
81649,314,71,243,220,2,5,0,0,0
81650,14336,5698,8638,7846,97,111,61,10,60
81652,5801,1684,4117,3812,17,33,11,0,26
81653,85,4,81,70,0,1,0,1,0
81654,1249,217,1032,975,6,7,10,0,7
81655,290,11,279,269,0,1,2,0,0
81656,422,31,391,347,0,0,10,0,5
81657,5114,520,4594,4279,34,8,90,1,34
82001,37528,6104,31424,27414,1023,264,464,58,195
82005,539,120,419,256,96,4,26,4,0
82007,21249,5271,15978,13793,598,174,225,22,88
82009,35700,3504,32196,29278,465,131,485,51,201
82050,366,95,271,235,0,1,0,0,6
82051,33,2,31,29,0,0,0,0,0
82052,64,3,61,52,0,0,3,0,1
82053,1513,104,1409,1318,4,10,1,0,7
82054,1132,121,1011,945,1,2,12,0,8
82055,284,9,275,266,0,0,1,0,1
82058,42,1,41,39,0,0,0,0,1
82059,212,22,190,168,0,4,2,0,0
82060,420,23,397,369,2,2,1,0,2
82061,51,7,44,39,0,0,0,0,1
82063,122,1,121,114,1,0,2,0,1
82070,20308,2195,18113,16347,198,158,395,18,86
82072,15719,1672,14047,12305,180,122,624,12,95
82073,55,4,51,47,2,0,0,0,0
82081,74,6,68,60,0,1,2,0,3
82082,1764,235,1529,1429,11,3,10,1,7
82083,334,15,319,297,1,2,2,1,1
82084,89,5,84,83,0,0,0,0,1
82190,392,14,378,353,0,0,4,0,0
82201,6395,507,5888,5533,14,45,40,3,29
82210,329,14,315,308,1,0,0,0,1
82212,441,18,423,412,2,0,0,0,0
82213,591,17,574,550,2,7,0,0,0
82214,1270,154,1116,1059,3,15,4,1,3
82215,159,8,151,147,0,0,0,0,0
82217,90,5,85,83,0,0,0,0,0
82218,18,1,17,14,0,0,0,0,0
82219,76,3,73,70,1,0,0,0,0
82221,532,17,515,492,3,6,0,0,4
82222,127,2,125,118,0,0,1,0,0
82223,896,39,857,822,0,3,3,0,1
82224,30,3,27,26,0,0,0,0,1
82225,2077,67,2010,1885,6,26,11,5,0
82227,154,4,150,149,0,0,0,0,0
82229,63,4,59,50,0,0,1,0,0
82240,9689,1107,8582,8094,69,74,43,0,37
82242,87,1,86,83,0,1,0,0,0
82243,187,4,183,171,0,0,0,0,0
82244,495,17,478,465,1,0,0,0,0
82301,8539,2098,6441,5831,109,125,78,9,32
82310,35,1,34,28,0,2,1,0,0
82321,676,127,549,507,2,4,1,1,0
82322,68,10,58,53,2,0,0,0,0
82323,146,16,130,124,0,0,1,0,0
82324,231,12,219,213,0,0,0,0,0
82325,871,32,839,800,3,0,1,0,4
82327,738,61,677,630,3,4,1,3,4
82329,318,15,303,280,2,0,0,1,3
82331,2316,155,2161,2046,4,13,6,0,14
82332,73,15,58,52,0,1,0,0,0
82334,441,53,388,357,7,9,1,0,1
82335,7,0,7,6,0,0,0,0,1
82336,243,38,205,182,0,2,0,0,0
82401,7001,1051,5950,5631,11,41,32,1,40
82410,1815,112,1703,1604,6,27,9,1,9
82411,695,82,613,589,0,3,1,0,4
82412,589,73,516,484,0,4,1,0,1
82414,16087,646,15441,14592,26,63,115,7,57
82420,912,46,866,827,0,14,4,0,0
82421,447,30,417,398,0,4,1,0,0
82422,88,19,69,68,0,1,0,0,0
82423,201,19,182,163,0,7,0,1,5
82426,2425,290,2135,2033,5,8,11,2,8
82428,141,4,137,125,0,3,0,0,0
82430,90,4,86,76,0,3,2,0,0
82431,3595,343,3252,3061,8,21,16,2,15
82432,264,26,238,228,0,0,0,0,0
82433,738,21,717,663,5,3,2,0,1
82434,147,6,141,140,0,0,0,0,0
82435,12093,996,11097,10417,28,54,93,10,88
82440,145,12,133,124,2,0,0,0,1
82441,223,23,200,182,1,4,1,0,2
82442,742,22,720,687,1,5,1,0,3
82443,4501,173,4328,4038,9,39,16,3,16
82450,170,8,162,154,0,0,0,0,0
82501,18523,1474,17049,13073,104,2821,77,7,61
82510,1236,29,1207,75,3,1094,2,0,1
82512,223,8,215,139,0,64,0,0,0
82513,1816,32,1784,1679,3,13,15,0,10
82514,1539,63,1476,76,2,1354,0,0,1
82515,550,34,516,449,2,25,1,0,1
82516,393,20,373,206,0,142,0,0,0
82520,12887,637,12250,9211,49,2196,103,0,37
82523,895,31,864,741,0,29,4,0,11
82601,27180,2684,24496,22233,289,272,219,27,101
82604,26539,2103,24436,22654,191,193,145,25,108
82609,18845,1698,17147,15588,200,210,225,13,66
82620,177,11,166,157,0,1,4,0,0
82630,21,0,21,21,0,0,0,0,0
82633,9764,858,8906,8402,31,49,44,0,35
82635,154,26,128,124,0,0,0,0,2
82636,4763,426,4337,3932,28,59,32,11,27
82637,3835,197,3638,3459,8,23,10,0,5
82638,22,0,22,22,0,0,0,0,0
82639,792,34,758,715,0,4,0,0,9
82640,29,3,26,25,0,0,0,0,0
82642,75,18,57,48,0,2,1,0,1
82643,297,22,275,262,0,0,1,2,0
82644,1861,193,1668,1541,21,29,5,0,0
82646,47,1,46,42,0,0,1,0,0
82648,35,3,32,32,0,0,0,0,0
82649,1062,76,986,861,3,55,2,0,13
82701,5309,273,5036,4675,24,80,21,9,32
82710,285,0,285,278,0,1,0,0,0
82711,122,1,121,119,0,0,0,1,0
82712,332,7,325,311,0,2,0,1,0
82714,66,3,63,62,0,0,0,0,0
82716,17094,1963,15131,13913,89,225,104,17,67
82718,25764,2061,23703,21998,127,252,212,6,111
82720,916,10,906,877,0,4,2,0,3
82721,3108,54,3054,2892,0,31,4,3,7
82723,219,5,214,205,0,5,0,0,1
82725,136,1,135,130,0,0,0,0,0
82727,1838,58,1780,1682,1,13,3,0,6
82729,2221,35,2186,2099,0,5,3,2,6
82730,1450,24,1426,1354,4,8,5,0,6
82731,173,18,155,146,0,1,0,1,0
82732,1932,182,1750,1649,1,18,1,0,3
82801,25685,1231,24454,22746,95,262,168,17,103
82831,224,5,219,211,1,0,0,1,3
82832,794,13,781,756,0,3,0,0,2
82833,520,19,501,466,1,4,2,0,5
82834,7471,307,7164,6750,26,64,15,7,19
82835,286,12,274,264,0,2,0,0,2
82836,1085,24,1061,986,2,32,6,0,8
82837,21,0,21,16,0,0,0,0,0
82838,297,10,287,275,1,1,0,0,1
82839,1454,78,1376,1293,10,22,4,0,5
82842,683,23,660,623,1,0,0,0,0
82844,54,3,51,47,0,0,0,0,0
82845,84,1,83,80,0,0,0,0,0
82901,28005,5076,22929,20944,290,173,213,41,118
82922,304,6,298,286,1,1,2,0,0
82923,545,47,498,443,1,5,7,1,6
82925,299,18,281,259,0,0,8,1,3
82929,54,8,46,38,2,3,1,0,0
82930,13894,1754,12140,11355,46,94,84,19,60
82932,717,40,677,650,0,5,0,0,0
82933,829,28,801,767,0,10,0,0,2
82934,115,19,96,75,0,2,2,0,2
82935,12324,1661,10663,9828,52,67,65,20,22
82936,57,1,56,52,0,0,0,0,0
82937,3645,130,3515,3392,3,11,17,2,6
82938,144,10,134,129,0,0,0,0,0
82939,1777,57,1720,1664,0,6,7,4,8
82941,5066,389,4677,4446,10,26,27,3,29
82942,53,2,51,50,1,0,0,0,0
82943,303,52,251,226,1,3,1,0,5
82944,241,15,226,212,0,1,0,2,0
82945,190,32,158,150,1,1,0,0,0
83001,17690,3074,14616,13649,40,56,235,2,66
83011,262,2,260,250,1,0,1,1,1
83012,236,9,227,216,0,1,1,0,3
83013,378,14,364,341,0,1,1,0,5
83014,3542,138,3404,3223,5,5,54,0,15
83025,588,26,562,525,3,2,4,0,1
83101,2808,154,2654,2521,2,22,16,1,6
83110,4744,173,4571,4349,17,33,20,6,22
83111,467,16,451,433,1,5,2,0,1
83112,804,29,775,756,0,3,1,2,2
83113,2067,160,1907,1807,5,12,1,4,7
83114,811,18,793,765,1,2,3,6,1
83115,445,14,431,410,0,0,1,1,0
83116,490,27,463,433,2,6,2,1,4
83118,1257,59,1198,1134,1,0,6,0,12
83119,243,4,239,230,0,1,0,2,1
83120,551,42,509,485,2,4,1,0,1
83121,10,0,10,10,0,0,0,0,0
83122,412,10,402,388,3,0,3,0,2
83123,507,11,496,470,0,8,2,0,4
83124,99,3,96,95,0,0,0,0,0
83126,479,13,466,458,0,0,0,1,0
83127,3818,197,3621,3443,0,12,25,2,26
83128,2216,207,2009,1902,5,5,15,0,9
83201,38921,3945,34976,31255,432,565,760,155,166
83202,24441,2345,22096,17937,74,2718,184,62,86
83203,87,13,74,1,0,67,0,0,0
83204,18408,1719,16689,15143,133,424,149,29,115
83209,474,56,418,320,38,3,42,0,0
83210,3085,1466,1619,1515,3,11,7,0,4
83211,6500,2585,3915,3690,16,27,14,7,6
83212,149,1,148,144,0,0,0,0,0
83213,1380,62,1318,1250,1,5,3,1,0
83214,725,40,685,643,4,1,6,2,1
83215,41,3,38,35,1,0,0,0,0
83217,792,40,752,724,0,5,2,2,2
83218,373,52,321,301,0,1,1,3,2
83220,112,3,109,108,1,0,0,0,0
83221,28354,4892,23462,20651,77,1675,136,25,82
83223,197,1,196,187,0,4,3,0,0
83226,2294,95,2199,2078,1,20,5,1,8
83227,157,6,151,138,0,1,1,0,0
83228,695,34,661,646,0,0,1,1,0
83232,438,23,415,404,3,1,0,0,0
83233,84,1,83,83,0,0,0,0,0
83234,1127,23,1104,1044,1,10,2,3,12
83235,83,6,77,73,0,1,0,0,0
83236,2423,278,2145,2060,3,35,3,3,7
83237,1559,227,1332,1287,4,6,2,0,1
83238,167,6,161,146,0,1,0,1,0
83239,609,18,591,566,3,0,4,0,0
83241,1924,138,1786,1729,0,6,3,6,2
83243,117,7,110,102,0,0,0,0,0
83244,281,29,252,240,1,8,0,1,1
83245,2266,68,2198,2104,4,15,8,0,2
83246,1038,25,1013,959,2,12,3,0,3
83250,1796,41,1755,1706,1,16,0,2,4
83251,1100,32,1068,1024,0,3,4,0,9
83252,4403,170,4233,4118,2,14,13,4,8
83253,157,9,148,141,0,1,0,0,0
83254,3803,145,3658,3552,3,18,3,1,0
83255,1121,56,1065,1029,0,4,0,0,1
83261,621,22,599,585,1,1,1,0,0
83262,1401,233,1168,1092,2,12,11,0,5
83263,9928,669,9259,8911,14,59,25,5,19
83271,488,6,482,467,0,0,0,0,2
83272,292,5,287,283,1,0,0,0,0
83274,10673,1161,9512,9040,29,52,32,4,34
83276,4311,199,4112,3947,0,36,4,7,10
83277,155,26,129,122,0,1,0,0,0
83278,416,11,405,374,2,6,5,0,2
83281,83,1,82,80,0,0,0,0,0
83283,143,1,142,140,0,0,0,0,0
83285,80,0,80,73,0,0,2,0,0
83286,1424,69,1355,1306,1,9,0,1,0
83287,313,6,307,295,1,0,2,0,0
83301,60789,10039,50750,45456,948,343,1316,187,164
83302,159,29,130,121,3,2,1,0,1
83311,560,34,526,513,0,3,2,0,0
83312,171,2,169,169,0,0,0,0,0
83313,3815,977,2838,2626,14,6,18,4,23
83314,897,242,655,626,0,0,2,0,1
83316,10295,2127,8168,7643,17,49,36,7,34
83318,18990,6076,12914,12112,51,92,119,23,72
83320,1050,214,836,786,2,3,4,4,9
83321,500,191,309,293,6,0,0,0,3
83322,54,0,54,48,0,0,0,0,0
83323,1962,493,1469,1418,8,2,8,0,4
83324,694,127,567,534,1,3,2,1,3
83325,995,245,750,721,0,1,6,0,4
83327,944,58,886,821,2,0,7,0,5
83328,6230,673,5557,5260,14,39,12,0,18
83330,6720,1772,4948,4597,8,30,23,1,17
83332,2434,286,2148,2026,6,13,7,2,12
83333,11775,3021,8754,8154,17,22,123,5,54
83334,2152,527,1625,1505,8,16,5,0,9
83335,1886,652,1234,1180,0,2,2,0,5
83336,5727,2023,3704,3469,13,34,20,4,17
83337,35,2,33,30,0,0,0,0,0
83338,21486,8379,13107,12272,39,111,73,22,62
83340,5647,732,4915,4639,6,3,56,2,23
83341,8838,1204,7634,7277,21,47,31,0,35
83342,1169,184,985,959,1,1,1,0,0
83344,1339,512,827,772,4,7,2,10,2
83346,1459,284,1175,1132,3,17,4,2,3
83347,3275,1029,2246,2140,2,9,6,4,10
83348,93,5,88,88,0,0,0,0,0
83349,923,149,774,718,0,5,1,1,1
83350,12975,4946,8029,7597,13,51,24,2,31
83352,3516,1303,2213,2062,5,14,7,2,1
83353,1774,54,1720,1637,6,0,10,0,7
83354,3,0,3,1,0,0,0,0,0
83355,5332,2400,2932,2723,6,23,8,2,23
83401,47114,7418,39696,37234,201,273,392,65,118
83402,28452,5389,23063,21386,179,208,275,21,102
83404,25491,2382,23109,21525,142,104,428,36,101
83406,19003,1641,17362,16311,63,75,271,22,68
83414,546,23,523,491,0,1,10,0,8
83420,2445,296,2149,2076,2,12,5,4,9
83421,349,21,328,313,0,4,0,0,2
83422,3871,742,3129,2977,10,13,27,0,13
83423,678,265,413,381,3,1,1,0,2
83424,260,85,175,173,0,0,0,0,0
83425,597,100,497,482,1,1,0,0,0
83427,2566,218,2348,2291,0,4,9,1,2
83428,527,16,511,466,2,6,12,0,3
83429,980,30,950,910,0,4,4,3,4
83431,914,106,808,791,1,4,1,0,0
83433,101,3,98,95,0,0,0,0,0
83434,1693,137,1556,1504,0,9,0,2,0
83435,670,162,508,495,0,2,0,0,2
83436,541,83,458,444,1,0,1,2,1
83438,93,11,82,82,0,0,0,0,0
83440,50567,4994,45573,42001,695,150,923,211,160
83442,23831,1966,21865,20883,62,107,103,26,84
83443,1154,120,1034,966,4,1,11,2,3
83444,1351,394,957,908,2,1,3,0,10
83445,7411,980,6431,6105,19,47,29,16,12
83446,47,4,43,38,0,0,0,0,0
83448,2590,264,2326,2246,9,1,10,0,6
83449,320,6,314,301,1,6,0,0,1
83450,1055,310,745,721,3,2,0,0,7
83451,987,154,833,793,2,1,2,0,3
83452,1773,152,1621,1563,2,0,5,0,0
83454,257,8,249,237,5,2,0,0,0
83455,5675,1022,4653,4400,4,12,19,0,24
83460,53,19,34,13,2,1,3,3,2
83462,508,8,500,477,3,1,2,0,1
83463,129,8,121,111,1,0,0,0,2
83464,363,34,329,307,1,1,1,0,0
83465,94,5,89,85,0,0,1,0,0
83466,299,13,286,268,0,1,2,1,5
83467,6169,208,5961,5659,12,39,20,4,29
83468,222,3,219,208,0,2,1,0,1
83469,53,0,53,49,0,0,1,1,0
83501,36793,1458,35335,32295,168,635,304,32,115
83520,179,5,174,159,1,6,0,0,0
83522,2166,94,2072,1972,19,23,6,0,1
83523,753,33,720,660,0,26,3,0,1
83524,1002,18,984,837,1,98,3,0,2
83525,416,20,396,343,0,7,1,0,6
83526,260,10,250,243,0,1,0,0,3
83530,5713,260,5453,5092,16,62,32,3,38
83533,210,1,209,204,0,2,0,0,2
83535,1167,34,1133,1033,0,46,1,0,3
83536,4216,164,4052,3456,9,365,4,0,24
83537,985,13,972,921,0,7,3,0,6
83539,1835,46,1789,1626,8,49,8,2,9
83540,2329,110,2219,610,12,1474,6,0,4
83541,1161,21,1140,1022,8,58,2,0,0
83542,162,3,159,149,0,0,1,0,1
83543,679,19,660,604,1,19,0,0,5
83544,6159,252,5907,5517,26,105,42,2,20
83545,427,9,418,375,0,27,5,0,1
83546,503,9,494,465,1,2,1,0,6
83547,291,9,282,273,0,0,0,0,0
83548,134,3,131,114,1,6,3,0,0
83549,836,31,805,757,2,5,0,0,6
83552,1207,17,1190,1104,3,12,2,0,7
83553,1057,12,1045,976,6,7,3,0,8
83554,547,13,534,511,1,4,3,0,1
83555,519,24,495,467,1,13,0,1,0
83602,51,1,50,43,1,0,0,0,0
83604,676,106,570,529,0,16,3,1,10
83605,38561,14557,24004,21359,291,227,316,84,197
83607,36024,9998,26026,23673,159,165,248,49,139
83610,979,18,961,898,0,2,5,1,2
83611,2596,101,2495,2322,2,18,9,3,16
83612,2162,64,2098,1977,2,12,3,0,13
83615,1927,86,1841,1734,0,12,7,2,13
83616,33311,2205,31106,28717,147,81,537,52,137
83617,17502,1627,15875,14719,29,119,93,20,77
83619,8638,1704,6934,6315,22,40,102,10,43
83622,2076,100,1976,1874,6,15,4,1,10
83623,1470,328,1142,1061,1,8,5,2,13
83624,1072,229,843,774,8,11,6,4,2
83626,1234,259,975,903,3,9,5,1,5
83627,656,198,458,420,0,7,7,1,5
83628,4996,1517,3479,3200,8,25,13,2,34
83629,1731,65,1666,1553,2,17,10,0,9
83631,1317,57,1260,1132,5,12,8,1,16
83632,315,14,301,285,1,4,0,0,1
83633,419,51,368,354,0,3,1,0,1
83634,33379,3930,29449,26941,399,317,279,40,117
83636,211,19,192,174,0,1,2,0,0
83637,270,9,261,246,0,2,0,0,4
83638,7306,413,6893,6492,14,26,39,3,49
83639,3170,812,2358,2170,17,19,14,3,17
83641,3627,662,2965,2750,8,5,6,0,14
83642,55465,5691,49774,44550,567,206,1334,110,227
83643,105,7,98,97,0,0,0,0,0
83644,14568,1488,13080,12015,35,69,70,16,93
83645,621,18,603,568,0,7,4,1,1
83646,69818,6100,63718,57458,566,216,1688,163,330
83647,22592,3836,18756,16137,443,202,523,61,116
83648,3191,624,2567,1790,237,8,226,34,9
83650,587,93,494,469,0,10,1,0,1
83651,34509,9397,25112,22355,257,191,399,143,191
83654,1752,67,1685,1586,0,11,5,0,4
83655,4843,483,4360,4029,5,38,28,2,22
83656,566,153,413,364,0,3,5,1,6
83657,194,14,180,164,0,0,0,0,2
83660,6317,1202,5115,4690,10,37,33,5,37
83661,10537,1953,8584,7775,22,85,65,19,53
83666,54,5,49,43,2,0,0,0,0
83669,13647,1008,12639,11697,43,51,122,19,87
83670,521,27,494,474,0,1,0,0,8
83672,8892,1623,7269,6648,17,65,72,5,50
83676,4950,1656,3294,3001,7,42,24,4,27
83677,44,1,43,43,0,0,0,0,0
83686,55343,11185,44158,40240,377,233,478,221,268
83687,37254,8857,28397,25479,315,199,391,95,165
83702,23951,1501,22450,20108,386,85,522,24,138
83703,18163,1334,16829,14789,576,86,343,25,78
83704,42430,5244,37186,31947,1241,253,1144,166,200
83705,27756,3062,24694,21188,946,186,644,82,149
83706,34446,2791,31655,27358,609,136,1381,94,350
83709,59461,5209,54252,47445,991,309,1901,245,297
83712,8908,475,8433,7602,82,25,267,7,35
83713,30056,2858,27198,23256,810,128,1249,72,158
83714,26181,2626,23555,21252,267,119,330,52,129
83716,21583,1390,20193,16842,103,81,1945,72,104
83720,0,0,0,0,0,0,0,0,0
83725,6,1,5,1,1,0,0,0,0
83801,7501,225,7276,6721,2,40,40,5,51
83802,52,4,48,46,0,0,0,0,0
83803,764,25,739,678,1,9,10,0,5
83804,1617,54,1563,1432,6,16,12,1,8
83805,8412,498,7914,7325,16,128,46,9,49
83806,257,3,254,226,0,3,5,0,0
83808,143,5,138,118,0,0,0,0,4
83809,510,16,494,455,0,0,8,0,2
83810,1114,22,1092,993,0,17,0,0,14
83811,1521,57,1464,1365,3,8,7,7,15
83812,64,4,60,56,0,1,1,0,0
83813,1189,30,1159,1103,0,3,4,2,5
83814,26966,1400,25566,23503,82,192,210,31,196
83815,39412,2087,37325,34195,122,335,452,47,193
83821,437,7,430,412,0,0,2,0,4
83822,2026,65,1961,1803,6,12,8,0,10
83823,1450,39,1411,1321,1,11,5,2,19
83824,348,12,336,178,1,129,3,2,1
83825,396,11,385,355,2,0,0,0,7
83826,100,13,87,77,0,0,3,0,2
83827,164,5,159,156,0,0,0,0,1
83830,702,14,688,577,0,6,1,1,5
83832,1701,49,1652,1547,0,27,3,0,6
83833,1492,48,1444,1351,4,8,8,0,4
83834,252,18,234,213,0,3,3,0,5
83835,23157,1067,22090,20459,50,147,207,22,120
83836,1041,6,1035,988,0,1,3,7,2
83837,3206,134,3072,2796,3,47,25,3,21
83839,1288,34,1254,1183,0,5,1,0,17
83840,556,28,528,493,1,0,5,0,2
83841,652,23,629,595,0,1,8,0,0
83842,173,9,164,151,0,0,0,0,4
83843,26739,1562,25177,22054,284,172,847,39,157
83844,2165,211,1954,1749,25,14,90,1,1
83845,1795,85,1710,1604,9,9,8,0,13
83846,708,21,687,639,0,10,1,0,4
83847,1685,92,1593,1497,2,8,10,0,6
83848,216,2,214,199,1,0,2,0,0
83849,1954,70,1884,1768,6,9,8,1,1
83850,2397,66,2331,2151,3,26,11,0,18
83851,1828,86,1742,1069,2,519,2,2,21
83852,1279,53,1226,1155,1,3,10,0,3
83854,49040,2879,46161,42291,160,385,355,73,228
83855,2115,52,2063,1942,4,19,1,1,6
83856,6429,173,6256,5814,9,76,19,4,42
83857,783,10,773,724,1,7,2,0,2
83858,17113,709,16404,15157,26,128,76,15,96
83860,7021,217,6804,6320,9,38,29,1,45
83861,6581,141,6440,5982,6,96,23,9,35
83864,19414,702,18712,17305,77,120,128,16,143
83866,321,9,312,264,1,4,0,1,3
83867,616,22,594,562,1,2,0,1,0
83868,923,23,900,838,1,14,1,0,10
83869,5488,246,5242,4835,11,43,21,2,19
83870,325,8,317,237,0,43,3,0,6
83871,2015,69,1946,1839,2,2,8,5,22
83872,793,37,756,692,1,3,0,0,4
83873,1587,64,1523,1395,1,31,5,1,7
83874,60,0,60,58,0,0,0,0,0
83876,1670,91,1579,1055,3,438,4,1,5
84001,719,28,691,664,0,7,1,0,0
84002,280,15,265,257,1,5,0,0,0
84003,52970,4086,48884,45270,249,162,727,382,174
84004,10259,392,9867,9321,41,12,94,24,25
84005,43113,4952,38161,34872,287,109,339,419,180
84006,829,71,758,683,3,10,1,12,6
84007,530,5,525,516,0,1,0,0,0
84008,0,0,0,0,0,0,0,0,0
84009,38347,3994,34353,29916,376,75,1658,463,154
84010,48439,3864,44575,40616,380,168,767,711,188
84013,1090,66,1024,949,2,6,0,6,2
84014,16870,1060,15810,14761,96,27,261,112,58
84015,68548,10396,58152,51304,1025,390,1529,614,251
84017,4076,516,3560,3420,7,3,21,3,5
84018,236,14,222,211,0,0,0,0,0
84020,51017,4728,46289,40534,654,270,2281,228,217
84021,3198,180,3018,2877,5,58,5,7,9
84022,423,50,373,299,16,8,15,5,2
84023,228,8,220,211,0,0,1,0,1
84024,61,13,48,45,0,0,2,0,0
84025,24596,1344,23252,21774,167,58,350,72,47
84026,910,38,872,249,1,580,1,0,0
84027,604,41,563,539,1,3,1,1,1
84028,955,53,902,860,4,1,2,0,0
84029,13269,1015,12254,11646,38,88,48,33,33
84031,278,11,267,261,0,0,0,0,0
84032,24766,4069,20697,19477,99,52,284,36,38
84033,1150,74,1076,1047,0,0,3,4,0
84034,181,10,171,64,0,95,2,0,3
84035,722,41,681,638,1,9,0,0,1
84036,8300,1174,7126,6834,32,15,40,7,12
84037,39763,2276,37487,35482,198,95,411,136,97
84038,439,13,426,417,0,0,0,0,0
84039,1065,62,1003,832,8,110,0,1,4
84040,26687,2499,24188,21780,333,95,579,116,138
84041,55289,8855,46434,41085,793,326,1221,410,207
84042,11330,1003,10327,9576,44,22,158,91,22
84043,76954,6698,70256,63535,411,236,1917,673,256
84044,29284,10069,19215,16441,403,171,338,781,115
84045,36898,3512,33386,30431,272,98,426,357,171
84046,698,20,678,662,1,0,0,2,1
84047,37146,8507,28639,23287,979,293,1587,546,238
84049,6655,372,6283,6049,15,13,37,5,19
84050,12059,324,11735,11351,12,31,57,0,9
84051,390,8,382,380,0,0,0,1,0
84052,1257,111,1146,996,0,101,3,1,4
84053,850,29,821,709,3,71,1,0,1
84054,21552,3653,17899,15158,277,145,747,572,67
84055,1473,134,1339,1296,1,3,6,1,2
84056,4088,699,3389,2614,246,11,83,40,9
84057,38401,9623,28778,25275,255,230,717,540,201
84058,33734,6906,26828,23319,459,162,749,517,162
84059,15567,2428,13139,11301,116,106,378,318,80
84060,8621,1631,6990,6381,53,12,237,7,38
84061,514,53,461,440,0,1,1,1,0
84062,47771,5143,42628,39294,236,123,572,364,186
84063,477,45,432,212,2,198,5,0,0
84064,744,29,715,690,5,0,0,4,1
84065,49295,3689,45606,41893,282,148,1109,346,200
84066,13287,1009,12278,10497,14,1184,61,31,46
84067,39194,6838,32356,28956,419,216,738,194,134
84069,492,14,478,457,0,0,1,0,0
84070,30885,5734,25151,21241,403,204,1514,312,173
84071,1946,138,1808,1705,9,3,2,4,16
84072,402,4,398,388,0,1,0,2,2
84073,211,6,205,187,1,12,0,0,0
84074,55001,7452,47549,43494,364,302,441,592,226
84075,32274,2785,29489,27009,332,73,625,149,115
84076,383,9,374,365,0,3,0,0,0
84078,29172,2459,26713,24745,74,520,138,92,95
84080,328,48,280,252,0,1,0,1,0
84081,51426,11584,39842,33952,724,239,1644,1111,219
84082,832,12,820,811,2,0,3,0,1
84083,1115,797,318,273,9,8,4,2,2
84084,32568,7611,24957,21230,368,227,1013,754,160
84085,419,9,410,113,0,276,0,0,0
84086,359,2,357,352,2,0,0,0,0
84087,16217,1343,14874,13499,93,59,246,256,52
84088,37856,8046,29810,25776,357,139,1238,667,170
84092,29492,1684,27808,25270,221,63,977,94,108
84093,23609,1386,22223,20079,146,45,856,114,83
84094,28751,2932,25819,22741,190,128,1047,236,144
84095,39278,3018,36260,31619,299,112,2395,371,202
84096,69086,8514,60572,54297,626,224,1659,764,277
84097,23038,2841,20197,18189,140,68,425,289,87
84098,20573,1729,18844,17363,95,33,436,19,104
84101,8140,1278,6862,5236,312,123,586,122,92
84102,18857,1920,16937,13676,369,154,1616,111,118
84103,22788,1966,20822,17971,360,88,974,145,148
84104,23487,11289,12198,7234,910,257,1228,1742,108
84105,22856,1822,21034,18698,234,86,695,93,116
84106,35892,4049,31843,27577,631,197,1396,287,160
84107,37713,6137,31576,25243,1666,373,1829,335,225
84108,21261,1116,20145,17173,159,61,1696,63,105
84109,24768,1382,23386,21187,180,90,903,66,92
84111,12162,2160,10002,7798,500,161,821,124,79
84112,3302,506,2796,1929,200,3,468,25,67
84113,173,28,145,95,11,0,22,4,1
84114,0,0,0,0,0,0,0,0,0
84115,27588,6509,21079,15376,1603,350,1933,312,201
84116,35327,15396,19931,13412,1602,412,1564,1453,189
84117,25675,2279,23396,20886,330,78,783,129,161
84118,41493,16892,24601,19853,538,295,1200,1240,181
84119,54143,22692,31451,21013,2189,660,3139,2649,181
84120,51212,19347,31865,22936,1319,390,2914,2602,160
84121,41628,2916,38712,34778,259,142,1380,129,191
84123,39489,8714,30775,25134,1204,331,1577,784,176
84124,22872,1669,21203,18758,251,87,983,94,88
84128,31406,11901,19505,15201,527,229,1495,999,87
84129,37421,8764,28657,23563,605,303,1792,907,162
84138,0,0,0,0,0,0,0,0,0
84150,0,0,0,0,0,0,0,0,0
84180,0,0,0,0,0,0,0,0,0
84301,900,44,856,836,2,12,3,0,0
84302,26564,2819,23745,22335,86,230,163,50,29
84304,38,1,37,37,0,0,0,0,0
84305,823,31,792,773,0,2,0,0,0
84306,575,29,546,518,0,4,3,0,2
84307,1592,214,1378,1290,2,14,27,7,5
84308,302,41,261,254,1,2,1,0,2
84309,654,29,625,597,0,0,2,0,4
84310,4907,191,4716,4503,21,17,32,7,17
84311,872,42,830,809,2,4,1,0,1
84312,4483,356,4127,3962,10,22,35,0,7
84313,93,3,90,85,0,1,1,0,0
84314,1157,66,1091,1033,6,3,7,9,2
84315,9635,749,8886,8417,46,35,94,12,26
84316,240,8,232,227,1,0,0,0,0
84317,2523,114,2409,2314,4,1,11,6,9
84318,5296,327,4969,4758,20,6,54,5,4
84319,9570,1552,8018,7546,21,39,73,67,23
84320,2411,260,2151,2074,5,9,8,5,7
84321,49550,7337,42213,38348,587,269,1126,290,138
84322,0,0,0,0,0,0,0,0,0
84324,1128,42,1086,1039,5,5,7,0,0
84325,2476,95,2381,2277,12,13,9,4,11
84326,2420,134,2286,2202,0,6,17,3,14
84327,947,32,915,898,2,0,0,0,5
84328,1829,46,1783,1731,1,2,6,5,3
84329,222,9,213,203,0,1,0,0,2
84330,505,22,483,478,0,1,0,0,1
84331,348,21,327,313,1,2,0,0,6
84332,8238,429,7809,7389,14,12,104,38,45
84333,3207,166,3041,2974,3,9,0,7,7
84334,249,21,228,208,2,1,3,0,0
84335,15504,1409,14095,13372,60,38,126,28,58
84336,281,33,248,238,1,2,2,0,2
84337,13880,1502,12378,11704,36,68,162,23,27
84338,512,63,449,433,7,0,0,0,0
84339,5847,263,5584,5344,40,24,22,8,19
84340,3834,272,3562,3409,7,13,22,9,13
84341,24181,2890,21291,18966,272,189,757,200,86
84401,42968,9768,33200,29537,765,362,625,128,185
84403,37847,7865,29982,26718,597,211,624,120,194
84404,66382,15888,50494,45851,843,375,691,231,219
84405,34285,4853,29432,27016,393,104,488,193,63
84408,367,54,313,222,33,4,18,8,26
84414,32471,2943,29528,27731,156,86,370,65,156
84501,13111,1692,11419,10687,40,157,47,26,34
84511,4603,275,4328,2742,15,1322,10,40,8
84512,920,16,904,179,1,699,7,1,0
84513,1554,72,1482,1439,0,9,7,1,2
84515,10,1,9,5,0,0,0,0,0
84516,186,7,179,177,0,1,0,0,0
84518,861,23,838,824,0,1,3,0,0
84520,1225,224,1001,940,1,7,2,0,7
84521,686,28,658,641,0,2,1,0,0
84522,336,12,324,297,0,7,1,0,1
84523,1625,43,1582,1530,0,17,3,0,0
84525,968,296,672,646,0,1,7,0,2
84526,3888,449,3439,3256,1,19,9,3,6
84528,2358,187,2171,2086,2,10,13,6,5
84529,205,43,162,148,1,0,0,0,3
84530,560,28,532,505,0,7,2,1,0
84531,448,10,438,15,0,420,0,0,1
84532,10203,1250,8953,7977,62,350,75,11,61
84533,105,6,99,85,0,6,2,1,0
84534,2653,42,2611,34,5,2534,0,1,0
84535,2323,312,2011,1806,6,93,7,2,10
84536,1637,5,1632,33,5,1567,0,3,5
84537,1285,39,1246,1200,0,7,4,0,6
84539,335,62,273,254,0,0,0,0,4
84540,70,10,60,44,3,2,3,0,1
84542,1629,202,1427,1346,7,16,5,0,4
84601,33986,10609,23377,19875,321,225,538,698,132
84602,2366,189,2177,1959,14,2,67,21,4
84604,45503,4952,40551,35764,350,172,1323,484,151
84606,33791,5662,28129,24504,287,192,845,453,121
84620,1169,35,1134,1109,2,1,1,1,0
84621,137,8,129,129,0,0,0,0,0
84622,1527,181,1346,1281,7,14,9,0,0
84623,307,129,178,173,0,1,0,1,2
84624,5836,941,4895,4703,6,20,31,4,12
84626,338,152,186,180,0,1,0,0,0
84627,5882,800,5082,4631,40,38,51,139,21
84628,697,46,651,631,2,0,2,3,1
84629,2583,70,2513,2450,5,3,8,2,4
84630,265,48,217,203,0,0,0,2,0
84631,2985,542,2443,2233,6,35,82,9,9
84632,1263,81,1182,1134,0,6,0,4,1
84633,1082,232,850,827,0,3,0,1,0
84634,3630,518,3112,2808,116,96,0,2,0
84635,764,130,634,619,1,3,0,0,0
84636,570,42,528,511,0,2,2,0,1
84637,688,45,643,580,2,36,8,0,1
84638,308,4,304,301,0,0,0,0,0
84639,998,56,942,924,0,0,0,0,3
84640,117,2,115,108,0,0,0,0,0
84642,3494,172,3322,3131,13,25,4,26,18
84643,633,40,593,573,0,13,0,1,1
84644,381,9,372,354,0,0,11,0,1
84645,3117,82,3035,2949,1,4,3,11,2
84646,1902,501,1401,1313,0,6,3,40,2
84647,4549,346,4203,3839,35,27,94,22,23
84648,6830,384,6446,6198,8,33,25,27,4
84649,789,6,783,758,0,3,2,0,0
84651,28416,3965,24451,23194,94,93,131,119,61
84652,850,25,825,793,0,3,1,3,0
84653,11103,558,10545,10105,63,31,42,11,18
84654,2584,225,2359,2288,2,4,2,6,0
84655,15287,2007,13280,12682,27,62,23,50,30
84656,364,19,345,336,0,1,2,0,1
84657,452,21,431,420,0,0,0,1,0
84660,45959,6089,39870,37276,209,162,245,336,184
84662,1403,77,1326,1268,3,0,3,7,7
84663,35647,5729,29918,27551,185,214,270,332,114
84664,11365,507,10858,10327,33,28,51,35,40
84665,571,32,539,513,5,8,1,0,2
84667,423,41,382,371,0,3,2,1,0
84701,8883,428,8455,7866,46,247,26,26,26
84710,162,3,159,139,1,8,1,0,0
84711,895,15,880,862,0,4,0,1,0
84712,190,8,182,179,0,0,0,0,0
84713,4316,574,3742,3539,23,50,25,8,8
84714,828,221,607,545,2,22,8,3,5
84715,416,12,404,384,0,9,1,0,0
84716,317,9,308,285,0,4,7,0,0
84718,190,7,183,180,0,0,1,0,0
84719,195,16,179,163,0,2,4,0,0
84720,23607,1884,21723,19755,269,318,374,150,64
84721,27329,2941,24388,22418,101,582,204,79,78
84722,681,43,638,613,2,1,0,0,3
84723,552,106,446,426,0,2,0,0,0
84724,1213,89,1124,1060,1,13,4,1,11
84725,2298,110,2188,2125,7,15,9,2,2
84726,954,40,914,889,0,11,4,2,0
84728,131,23,108,105,0,0,1,0,1
84729,328,10,318,309,0,2,0,0,1
84730,554,12,542,525,0,2,0,0,1
84731,186,7,179,177,0,1,0,0,0
84732,72,0,72,70,0,0,0,0,0
84733,127,5,122,115,1,1,0,0,1
84734,192,13,179,166,0,5,0,1,1
84735,262,3,259,255,0,0,0,0,0
84736,236,11,225,204,1,13,0,0,0
84737,21212,2119,19093,17794,73,163,144,119,86
84738,9064,766,8298,7751,22,102,82,56,42
84739,408,11,397,360,1,16,0,0,0
84740,212,11,201,198,0,0,0,0,0
84741,6034,274,5760,5419,21,92,52,1,16
84742,545,20,525,498,0,4,10,1,2
84743,134,0,134,134,0,0,0,0,0
84744,334,12,322,296,0,1,0,2,0
84745,4347,496,3851,3620,7,38,20,26,16
84746,1162,51,1111,1073,0,6,7,0,6
84747,969,29,940,901,0,3,2,1,2
84749,212,9,203,190,0,0,4,0,1
84750,390,3,387,378,0,1,0,0,1
84751,1662,365,1297,1236,0,18,7,6,1
84752,891,116,775,753,0,1,0,7,0
84753,21,1,20,18,0,0,0,0,0
84754,4004,169,3835,3668,13,22,4,8,9
84755,83,4,79,73,0,1,0,0,0
84756,447,126,321,302,2,4,3,0,1
84757,1653,90,1563,1510,4,9,10,0,3
84758,588,14,574,556,0,2,2,0,0
84759,2064,109,1955,1846,4,31,11,3,0
84760,824,31,793,768,0,3,1,0,1
84761,3210,219,2991,2895,1,13,14,4,5
84762,393,13,380,363,4,5,4,0,1
84763,226,11,215,198,2,2,0,0,4
84764,357,169,188,142,0,21,6,2,3
84765,7593,519,7074,6647,12,25,72,56,10
84766,166,9,157,146,0,0,2,0,2
84767,648,74,574,534,3,5,10,2,5
84770,44505,7816,36689,33170,392,579,407,498,156
84772,178,13,165,156,0,2,1,0,0
84773,250,16,234,225,0,1,1,0,1
84774,1865,90,1775,1690,2,11,17,1,19
84775,430,17,413,384,1,1,8,1,0
84776,488,30,458,440,0,10,0,0,0
84779,730,66,664,619,8,8,4,3,3
84780,28025,2704,25321,23431,122,194,291,248,86
84781,257,14,243,238,0,0,0,0,1
84782,907,38,869,843,1,1,0,0,4
84783,907,40,867,818,2,14,2,0,5
84784,1127,33,1094,1085,0,3,1,0,1
84790,52982,5396,47586,43639,253,386,726,596,174
85003,11042,3628,7414,5071,1366,359,213,8,43
85004,8833,2204,6629,4898,601,172,493,14,44
85006,23797,14152,9645,6826,1182,464,347,28,133
85007,14442,7022,7420,4395,1905,243,337,27,84
85008,59047,32189,26858,14826,6764,1783,1211,253,281
85009,50439,38797,11642,7129,2755,712,302,25,159
85012,8201,1535,6666,5328,395,170,336,1,31
85013,21970,5407,16563,12466,1587,578,779,43,146
85014,26381,7514,18867,14360,1516,880,698,22,196
85015,41436,18701,22735,12169,5274,1265,2239,47,247
85016,37326,10116,27210,21425,1927,789,1294,64,185
85017,45279,26931,18348,9082,4207,1259,2227,83,351
85018,37944,6402,31542,26884,1391,425,1056,27,157
85019,27677,19101,8576,4160,1947,413,1378,48,148
85020,34534,9164,25370,20811,1598,536,773,34,209
85021,40943,14131,26812,17934,4320,1387,1241,39,212
85022,51314,10741,40573,32241,2900,712,2202,87,274
85023,35241,8912,26329,19658,2100,554,2066,86,226
85024,26021,4073,21948,18026,818,179,1645,42,144
85026,0,0,0,0,0,0,0,0,0
85027,38343,7297,31046,24118,1382,503,3010,86,242
85028,19888,1986,17902,15974,294,91,538,16,82
85029,47101,16665,30436,22515,3309,945,1353,94,225
85031,31162,25578,5584,2992,1469,349,293,20,73
85032,68710,19576,49134,40010,2086,709,3297,115,318
85033,57980,46912,11068,5884,3081,593,440,64,148
85034,5033,2815,2218,1115,621,110,140,16,42
85035,51441,40192,11249,4334,4328,771,693,126,190
85037,50929,34802,16127,8535,4085,501,1467,128,188
85040,33993,21030,12963,4180,6023,728,740,308,136
85041,64639,42733,21906,8646,8535,971,1689,142,335
85042,45433,24238,21195,10711,6457,720,1564,173,210
85043,35800,26131,9669,4382,3288,377,637,103,144
85044,39559,6744,32815,24322,2893,1170,2260,111,219
85045,8090,1228,6862,5357,355,37,572,9,51
85048,34524,5153,29371,22466,1812,454,2631,47,162
85050,31591,3511,28080,22967,663,87,2788,26,124
85051,46123,20803,25320,15853,4206,1061,2244,83,225
85053,30136,7692,22444,17984,1632,399,912,32,133
85054,8849,806,8043,6397,246,35,888,6,176
85083,20898,2268,18630,14860,461,85,2180,22,77
85085,27875,2838,25037,19424,919,198,3013,31,156
85086,43223,4560,38663,34363,924,323,885,73,214
85087,9853,929,8924,8061,137,55,219,19,24
85118,13044,808,12236,11574,81,49,121,4,44
85119,22069,2940,19129,17651,238,164,211,22,56
85120,30605,5278,25327,23357,261,266,264,36,114
85121,2802,273,2529,16,5,2476,2,0,0
85122,55063,23198,31865,24752,2388,1609,983,156,178
85123,9965,3461,6504,5359,436,213,68,6,39
85128,15764,6302,9462,6063,1176,1464,108,10,73
85131,16723,9252,7471,4676,1114,383,220,119,45
85132,38848,11145,27703,21540,2626,1321,360,65,93
85135,519,426,93,82,1,3,2,0,0
85137,2021,801,1220,1111,11,13,8,0,8
85138,46914,13112,33802,23259,5338,1025,1255,233,286
85139,18137,5624,12513,8527,1644,925,396,54,107
85140,45381,10501,34880,30226,1458,332,697,121,220
85141,416,169,247,227,2,5,2,0,0
85142,80734,16009,64725,55358,2805,641,1871,155,302
85143,41720,10679,31041,25082,2405,404,751,142,210
85145,2572,757,1815,1591,54,19,33,3,14
85147,5390,555,4835,45,6,4712,1,0,1
85172,1132,718,414,324,28,32,13,0,2
85173,2458,1659,799,686,26,17,12,2,2
85191,187,26,161,147,0,4,1,0,0
85192,1367,820,547,486,4,17,2,0,1
85193,4450,2026,2424,1734,75,454,36,4,20
85194,7592,1842,5750,5114,174,116,68,12,26
85201,51187,20095,31092,21991,3152,2304,1190,190,251
85202,39626,11107,28519,20173,2781,1736,1509,275,243
85203,37962,12786,25176,20250,1408,1327,531,131,196
85204,63808,29462,34346,27662,2028,1027,996,322,260
85205,44137,7616,36521,31799,1240,446,921,118,211
85206,36713,6475,30238,26050,1296,342,1050,94,138
85207,50108,8712,41396,36881,1010,386,945,95,198
85208,36820,8736,28084,24522,933,445,618,94,129
85209,44192,7946,36246,31346,1339,340,1208,136,152
85210,40351,17661,22690,15741,2562,1267,1140,172,212
85212,48422,8711,39711,32929,1729,313,1943,166,172
85213,36572,6439,30133,26058,950,537,841,164,164
85215,16461,1735,14726,13371,227,139,317,6,79
85224,46919,10574,36345,25877,2699,888,4279,118,215
85225,73551,27491,46060,31751,4829,1271,4686,173,306
85226,40689,7320,33369,22900,2392,819,4995,100,164
85233,39006,7760,31246,24192,1462,387,3023,113,162
85234,51051,8562,42489,35762,1247,480,2311,112,228
85236,42,15,27,11,8,0,2,1,1
85248,38567,3311,35256,27219,1248,857,4527,49,159
85249,47414,6290,41124,30632,1829,242,5998,54,188
85250,16501,1571,14930,13472,235,93,418,19,61
85251,40073,6154,33919,28934,1167,484,1373,60,207
85253,17358,1108,16250,13964,168,39,1277,13,99
85254,46352,3734,42618,35806,574,158,3951,36,202
85255,44976,2534,42442,37444,611,63,2501,19,289
85256,4857,906,3951,81,22,3703,9,2,3
85257,29187,6014,23173,19384,933,587,945,33,132
85258,25203,1663,23540,21196,256,61,1085,26,80
85259,22548,1609,20939,17500,391,74,1932,16,75
85260,37967,2796,35171,29723,689,119,2977,24,162
85262,13366,548,12818,12040,133,35,271,7,41
85263,3382,89,3293,3164,11,9,27,2,9
85264,1421,163,1258,317,2,875,5,0,6
85266,11971,521,11450,10654,136,17,259,7,41
85268,24031,1250,22781,21048,265,103,561,9,95
85281,69218,15596,53622,34876,4221,1473,8973,252,361
85282,52351,11961,40390,29135,3536,1410,3281,250,276
85283,45736,12946,32790,21423,3138,3088,2814,174,227
85284,18638,2326,16312,12435,622,146,2143,18,101
85286,49407,8587,40820,25952,2836,482,8713,98,253
85295,51587,8752,42835,33253,2263,390,3840,121,258
85296,50418,8555,41863,33969,1881,324,2920,91,186
85297,36076,5962,30114,23901,1306,264,2647,66,180
85298,41816,5690,36126,29483,1330,154,2959,68,213
85301,67380,40893,26487,14490,7169,950,1721,91,275
85302,41369,14434,26935,19100,3172,658,1969,149,176
85303,34252,20553,13699,7283,2881,418,1885,72,182
85304,28125,7052,21073,16908,1360,303,1033,60,170
85305,14055,6164,7891,4683,1244,286,1008,15,72
85306,25663,5336,20327,16933,1062,335,649,42,143
85307,10742,4298,6444,4232,992,137,468,46,60
85308,66540,10005,56535,47224,1988,434,3613,98,267
85309,985,159,826,490,133,3,68,24,2
85310,19315,2298,17017,14964,324,118,707,18,96
85320,800,537,263,233,2,9,8,0,0
85321,3663,1143,2520,1678,25,646,62,3,9
85322,585,241,344,285,13,8,8,0,0
85323,44632,28286,16346,8467,4523,479,1208,176,256
85324,2720,195,2525,2297,16,29,17,2,16
85325,847,73,774,705,0,4,9,4,3
85326,72959,34297,38662,29006,4825,835,900,196,422
85328,208,40,168,156,0,0,0,1,1
85329,2438,2211,227,145,41,10,6,0,11
85331,31038,2149,28889,26451,211,80,840,24,133
85332,1912,181,1731,1581,11,17,16,0,11
85333,428,253,175,154,0,6,3,0,0
85334,775,270,505,446,8,6,4,0,1
85335,35815,17670,18145,12980,2406,366,653,133,156
85336,7810,7685,125,86,2,11,1,4,9
85337,2473,1569,904,412,8,414,14,0,2
85338,59313,21620,37693,27904,4549,421,1754,164,334
85339,50447,22707,27740,10295,9039,3845,2323,155,309
85340,33778,10137,23641,17674,2168,193,1777,61,173
85341,18,10,8,7,0,0,1,0,0
85342,1478,227,1251,1140,7,16,9,0,15
85343,164,58,106,94,1,4,3,0,0
85344,9137,2866,6271,3615,74,2139,69,7,18
85345,61024,21779,39245,29951,3622,741,1869,80,271
85346,2803,242,2561,2391,12,19,3,2,8
85347,310,142,168,155,3,0,1,0,4
85348,2083,346,1737,1607,8,12,15,27,11
85349,28039,24638,3401,1852,878,202,20,4,45
85350,18486,17036,1450,839,45,410,44,11,11
85351,29795,1376,28419,26809,534,89,322,17,74
85352,388,196,192,179,1,1,0,1,0
85353,42936,30688,12248,5420,4224,420,858,109,253
85354,7200,2856,4344,3837,51,80,24,0,64
85355,12930,2822,10108,8585,521,80,216,22,54
85356,3487,1293,2194,2035,30,16,18,3,11
85357,438,277,161,133,0,6,8,0,1
85360,222,31,191,174,2,3,3,0,0
85361,6954,1751,5203,4687,72,49,50,11,36
85362,569,51,518,476,14,8,2,0,2
85363,7056,2800,4256,3400,297,87,173,5,38
85364,73550,50994,22556,17350,1523,764,1175,80,236
85365,50166,23482,26684,22792,844,327,851,80,250
85367,21303,4323,16980,15718,158,156,208,32,56
85371,266,83,183,8,0,168,3,0,0
85373,19629,1624,18005,16699,290,74,251,6,45
85374,41182,5834,35348,31079,1674,194,723,54,121
85375,27944,620,27324,26253,275,62,239,3,71
85377,3515,157,3358,3212,28,14,35,2,7
85378,9368,3286,6082,4946,552,63,148,13,43
85379,49441,11170,38271,30037,3005,296,1760,137,243
85381,27008,5135,21873,18176,1025,166,1132,40,124
85382,42576,5759,36817,31901,1235,212,1772,43,146
85383,69617,8149,61468,51948,1489,243,4306,94,278
85387,16331,2543,13788,12270,454,72,245,33,59
85388,30611,6195,24416,19387,1796,200,923,77,144
85390,9102,1162,7940,7429,57,76,46,2,23
85392,40363,18175,22188,14043,3538,486,2072,156,272
85395,37157,8510,28647,22310,2259,452,1944,86,136
85396,32990,8255,24735,20800,1496,218,604,51,129
85501,12473,3969,8504,6726,83,1007,188,7,61
85530,2104,23,2081,11,2,2059,0,0,0
85531,761,98,663,626,3,12,2,0,0
85532,412,173,239,195,2,16,4,1,6
85533,2949,1720,1229,1045,18,79,10,0,15
85534,2522,762,1760,1609,7,21,3,0,6
85535,28,2,26,20,1,2,0,0,0
85536,369,38,331,302,6,3,0,0,3
85539,3618,1583,2035,1730,32,108,17,2,23
85540,4026,1880,2146,1741,55,175,55,1,13
85541,22974,2400,20574,18916,92,439,166,20,78
85542,3172,91,3081,36,2,3011,0,3,3
85543,4283,990,3293,3120,8,49,3,3,9
85544,2905,163,2742,2551,5,41,5,7,27
85545,523,41,482,456,2,8,1,0,1
85546,20100,7847,12253,10873,327,379,117,9,66
85550,4934,112,4822,25,0,4754,0,3,2
85551,396,290,106,105,0,0,0,0,0
85552,6887,1704,5183,4839,30,119,38,4,11
85553,1491,73,1418,1356,12,6,4,0,0
85554,735,39,696,663,5,9,2,0,1
85601,644,114,530,479,6,10,6,0,0
85602,10198,1672,8526,7544,89,67,61,43,74
85603,6342,2178,4164,3748,38,35,28,4,39
85605,629,343,286,249,0,5,4,0,0
85606,977,132,845,790,5,4,9,0,9
85607,17738,15723,2015,1609,84,41,116,3,41
85608,1983,820,1163,764,296,92,4,2,1
85609,325,25,300,268,0,3,10,0,3
85610,1053,334,719,653,5,12,7,0,4
85611,1017,159,858,793,2,6,7,1,3
85613,5239,1310,3929,2435,724,47,336,42,51
85614,25789,3526,22263,20977,223,78,283,32,63
85615,9073,1613,7460,6750,113,48,71,17,57
85616,5110,940,4170,3665,106,37,63,13,42
85617,1086,170,916,851,11,10,6,0,6
85618,1271,840,431,376,0,18,6,2,5
85619,113,31,82,68,1,2,0,0,2
85620,734,635,99,79,3,2,3,1,3
85621,21730,20453,1277,945,46,22,128,1,73
85622,6583,259,6324,6141,18,6,48,3,9
85623,4974,1269,3705,3450,23,24,33,9,25
85624,1222,417,805,746,2,1,5,0,7
85625,1871,272,1599,1482,9,17,6,0,4
85626,1006,958,48,36,2,3,2,0,5
85627,472,38,434,421,0,0,2,1,1
85629,29824,12190,17634,14816,756,194,489,54,152
85630,2585,293,2292,2142,7,19,15,0,16
85631,3179,1533,1646,1482,12,27,10,5,22
85632,812,178,634,596,1,7,1,0,0
85633,51,15,36,23,3,7,0,0,1
85634,5864,249,5615,55,8,5490,0,1,0
85635,35095,8818,26277,19758,2305,202,1287,244,257
85637,1264,176,1088,1003,9,6,5,3,5
85638,1886,286,1600,1466,3,13,4,1,7
85639,240,8,232,0,0,232,0,0,0
85640,339,145,194,173,2,6,3,0,1
85641,29538,6503,23035,19725,857,124,563,56,180
85643,8208,3776,4432,3900,117,71,54,5,33
85645,1917,994,923,829,12,20,7,4,10
85646,1653,253,1400,1336,10,12,5,1,10
85648,20720,18044,2676,2320,48,28,124,7,56
85650,14857,2605,12252,10190,531,48,506,51,84
85653,19885,5301,14584,12568,444,231,340,12,109
85654,94,30,64,35,22,1,0,0,0
85658,15791,2804,12987,11563,292,78,405,32,43
85701,5132,1928,3204,2551,196,79,126,2,38
85704,34430,7035,27395,23589,675,186,1574,53,129
85705,56711,25104,31607,23836,2334,1517,1649,115,234
85706,54853,44974,9879,5904,1521,1161,438,33,117
85707,734,382,352,207,74,4,31,10,0
85708,3837,720,3117,2224,357,16,142,44,37
85709,0,0,0,0,0,0,0,0,0
85710,57381,14694,42687,33885,3363,475,1630,188,302
85711,41518,14844,26674,19441,3078,573,1301,149,279
85712,33108,8164,24944,19516,2179,492,934,152,232
85713,46810,31375,15435,10490,1977,1500,441,44,174
85714,14232,11952,2280,1353,265,344,92,8,37
85715,18561,3504,15057,12832,580,120,539,17,92
85716,31521,8459,23062,18147,1681,546,935,151,172
85718,28706,3905,24801,20772,443,106,2076,35,166
85719,46242,11583,34659,26870,1983,661,2928,79,213
85721,0,0,0,0,0,0,0,0,0
85723,132,32,100,85,10,2,1,0,0
85724,0,0,0,0,0,0,0,0,0
85726,11,7,4,0,4,0,0,0,0
85730,39258,11751,27507,21228,2528,306,1250,94,159
85734,4855,1909,2946,1750,942,200,23,7,0
85735,10522,4777,5745,4904,140,228,67,5,65
85736,4569,1615,2954,2576,37,112,28,2,31
85737,22212,3067,19145,16764,326,43,1007,37,79
85739,18878,2677,16201,15138,147,69,207,18,44
85741,34131,10495,23636,19630,839,248,1290,78,161
85742,30057,7232,22825,19418,684,212,1039,29,170
85743,30441,7020,23421,20184,496,202,1089,37,160
85745,36774,17895,18879,14623,1190,586,1216,46,172
85746,43278,30942,12336,7694,775,2616,398,46,115
85747,27703,7031,20672,16730,1161,157,958,86,144
85748,18816,3500,15316,12911,629,110,746,26,107
85749,19009,2454,16555,14913,248,148,375,20,101
85750,25007,3015,21992,18920,356,86,1441,25,122
85755,18277,2062,16215,14458,261,53,749,11,62
85756,35345,20675,14670,10425,1719,551,860,66,105
85757,21712,13668,8044,3778,472,3051,199,34,79
85901,18701,2380,16321,14680,74,578,180,7,69
85902,16,0,16,4,0,12,0,0,0
85911,1915,22,1893,14,4,1842,20,0,0
85912,269,26,243,219,2,5,7,0,0
85920,677,79,598,563,2,7,0,0,2
85922,68,15,53,51,0,1,0,0,0
85923,499,26,473,449,0,3,0,0,8
85924,2851,272,2579,2344,5,39,10,3,35
85925,4332,856,3476,3182,11,147,19,0,15
85926,435,9,426,6,0,416,0,0,0
85927,176,25,151,140,0,5,0,0,0
85928,752,62,690,626,2,21,3,3,9
85929,8040,1291,6749,5948,30,383,79,2,16
85930,1122,51,1071,21,3,1024,1,1,0
85931,178,15,163,153,0,5,0,0,0
85932,481,28,453,440,2,1,0,0,0
85933,3639,365,3274,3088,10,60,17,4,8
85934,601,24,577,552,1,1,0,2,1
85935,3945,469,3476,2772,19,467,35,6,9
85936,4217,1034,3183,2796,44,190,19,1,11
85937,8434,864,7570,6766,23,356,27,25,38
85938,2100,535,1565,1396,3,80,8,0,14
85939,4213,508,3705,3429,15,157,16,0,5
85940,1580,168,1412,1283,6,62,3,0,10
85941,10575,87,10488,110,6,10223,47,2,7
85942,64,6,58,57,0,0,0,0,0
86001,37093,6399,30694,23865,854,2740,1128,115,166
86003,113,2,111,2,0,104,0,1,0
86004,38451,8187,30264,22057,361,5269,522,63,207
86005,16343,2188,14155,11335,172,1434,328,13,110
86011,3499,858,2641,2113,121,128,84,21,5
86015,1186,228,958,805,5,58,32,2,3
86016,59,2,57,0,0,56,0,0,0
86017,1131,82,1049,992,2,13,7,0,9
86018,1121,67,1054,959,16,28,3,6,10
86020,1852,44,1808,25,1,1750,1,1,0
86021,4133,33,4100,4045,0,5,3,0,1
86022,2058,73,1985,1598,12,308,6,0,4
86023,2420,462,1958,1280,57,457,83,0,3
86024,643,44,599,566,1,7,0,1,2
86025,5358,1281,4077,2137,91,1546,33,8,25
86028,34,2,32,24,4,0,0,0,2
86029,178,12,166,102,2,47,1,0,1
86030,1037,6,1031,11,0,1008,2,0,0
86031,1705,39,1666,11,0,1621,0,0,1
86032,1411,118,1293,934,5,303,2,3,2
86033,7734,78,7656,137,5,7405,2,0,0
86034,2116,53,2063,45,13,1959,14,0,2
86035,1694,15,1679,10,0,1634,0,0,0
86036,195,5,190,47,0,133,1,0,0
86038,117,16,101,92,0,4,0,0,2
86039,1438,12,1426,8,2,1407,4,0,0
86040,10179,708,9471,3614,49,5127,134,12,30
86042,1493,10,1483,25,0,1453,1,0,1
86043,1559,5,1554,6,2,1538,3,0,0
86044,4127,45,4082,94,5,3915,2,3,2
86045,10445,164,10281,222,22,9725,119,6,1
86046,6310,1580,4730,4065,78,155,73,10,34
86047,14168,3149,11019,3162,358,6925,73,9,33
86052,40,4,36,30,0,2,0,0,0
86053,2025,21,2004,7,1,1976,1,0,1
86054,1841,8,1833,9,1,1790,0,0,0
86301,25115,2660,22455,20231,171,326,538,37,115
86303,18201,1431,16770,15548,111,136,177,12,102
86305,19555,1360,18195,17062,76,97,191,11,100
86313,92,12,80,61,0,15,4,0,0
86314,39461,8875,30586,27425,328,369,623,65,146
86315,10354,1009,9345,8655,62,69,129,10,39
86320,2111,478,1633,1463,12,50,4,0,12
86321,2234,578,1656,1443,4,52,38,2,14
86322,12696,2029,10667,8880,69,1015,70,13,38
86323,18422,2636,15786,14480,74,123,131,23,83
86324,4544,632,3912,3395,27,187,47,5,27
86325,5472,602,4870,4501,33,43,49,3,27
86326,24465,5709,18756,17127,161,237,191,41,110
86327,11530,1106,10424,9622,87,134,102,11,35
86329,1288,211,1077,984,2,31,6,1,4
86331,515,23,492,460,0,1,2,2,1
86332,1716,180,1536,1420,2,10,11,0,13
86333,5886,625,5261,4795,26,38,28,11,37
86334,5261,1242,4019,3643,13,60,28,3,27
86335,5229,903,4326,3790,14,158,46,4,26
86336,11125,1315,9810,8985,61,60,249,3,65
86337,1312,166,1146,1010,13,46,12,0,6
86338,587,70,517,474,2,6,3,0,8
86343,88,7,81,76,0,0,0,0,0
86351,6398,536,5862,5386,44,56,136,10,31
86401,27684,3632,24052,21389,314,399,451,51,114
86403,17787,3076,14711,13496,116,123,175,25,35
86404,18312,2263,16049,14898,87,106,188,24,59
86406,24935,2994,21941,20305,121,170,287,26,81
86409,28860,3945,24915,22197,272,375,431,76,93
86411,202,10,192,182,0,3,0,0,0
86413,13436,2316,11120,9781,270,215,115,18,51
86426,15953,2907,13046,11679,195,143,259,22,49
86429,7708,1239,6469,5820,152,52,112,16,15
86431,417,48,369,342,1,5,3,1,5
86432,3158,798,2360,2217,17,43,13,0,5
86433,127,2,125,118,0,0,1,0,0
86434,1424,85,1339,112,5,1197,4,0,3
86435,224,11,213,23,6,178,0,1,0
86436,1938,166,1772,1633,9,27,14,2,3
86437,92,14,78,42,1,31,0,0,0
86438,945,107,838,721,13,18,4,2,10
86440,7310,1221,6089,4960,46,637,36,32,26
86441,1919,384,1535,1374,17,14,15,6,10
86442,34171,8722,25449,22600,401,294,473,62,127
86443,16,0,16,16,0,0,0,0,0
86444,1491,94,1397,1319,16,12,9,1,0
86445,354,25,329,302,1,5,3,1,1
86502,1032,10,1022,33,4,958,0,1,1
86503,9851,121,9730,246,35,9249,95,0,0
86504,5723,106,5617,134,17,5307,55,0,5
86505,6605,98,6507,55,12,6309,37,1,0
86506,1415,36,1379,10,0,1346,0,1,1
86507,1912,17,1895,5,1,1878,3,0,0
86508,606,16,590,5,1,570,3,1,1
86510,4815,34,4781,57,8,4619,17,0,2
86511,3603,53,3550,65,0,3435,1,1,1
86512,2146,56,2090,108,17,1893,11,1,4
86514,2399,34,2365,39,3,2280,14,5,0
86515,3634,69,3565,104,4,3405,0,0,0
86520,2361,35,2326,3,1,2273,0,0,0
86535,1051,2,1049,3,0,1039,0,0,2
86538,2355,19,2336,41,0,2270,0,0,5
86540,1099,2,1097,0,0,1083,0,0,0
86544,1060,15,1045,7,0,1022,2,0,0
86545,1414,17,1397,11,4,1358,12,2,0
86547,1094,17,1077,1,3,1043,2,0,0
86556,2398,92,2306,294,3,1936,11,0,5
87001,3785,587,3198,209,9,2935,9,3,5
87002,21225,12897,8328,7119,197,312,73,10,134
87004,10859,6346,4513,2624,59,1541,67,6,37
87005,613,145,468,352,0,85,1,0,0
87006,705,442,263,232,5,6,3,0,1
87007,1214,47,1167,17,1,1122,0,0,12
87008,2449,484,1965,1771,20,22,12,1,30
87010,1165,150,1015,917,18,9,13,0,3
87011,26,11,15,9,2,3,0,0,0
87012,256,203,53,41,0,4,1,0,0
87013,4445,781,3664,299,13,3253,5,2,11
87014,584,462,122,47,2,61,1,0,1
87015,12833,3348,9485,8564,56,145,60,7,100
87016,3091,1590,1501,1356,23,43,4,0,7
87017,367,303,64,47,0,3,4,0,1
87018,560,26,534,4,0,524,0,0,1
87020,11471,5572,5899,3134,168,2129,165,2,45
87021,2811,1322,1489,830,60,518,8,0,9
87022,678,72,606,7,0,592,2,0,1
87023,560,382,178,156,2,4,0,0,4
87024,2372,168,2204,161,1,2001,4,0,6
87025,1212,197,1015,919,8,24,19,0,3
87026,3991,335,3656,251,14,3208,19,5,104
87027,237,162,75,59,0,6,3,0,4
87028,113,67,46,37,0,0,4,0,0
87029,217,46,171,142,0,15,0,0,5
87031,45208,28391,16817,13660,502,1076,225,19,230
87032,347,113,234,192,3,11,6,0,0
87034,3190,78,3112,62,8,2990,4,0,0
87035,7285,2864,4421,3884,65,120,26,1,46
87036,1745,732,1013,900,19,30,5,1,17
87037,1170,36,1134,11,3,1098,1,0,0
87038,513,32,481,3,0,453,0,0,15
87040,474,11,463,3,0,451,0,0,8
87041,734,511,223,102,1,94,11,1,3
87042,3364,1844,1520,1307,21,76,17,0,16
87043,5090,1015,4075,3705,60,53,69,10,31
87044,378,215,163,95,1,46,2,2,6
87045,2184,88,2096,111,0,1946,1,1,2
87046,153,36,117,108,0,2,3,0,1
87047,5460,1088,4372,3979,36,50,44,1,54
87048,8888,2368,6520,5834,82,167,99,2,55
87049,143,73,70,43,5,20,0,0,0
87051,866,586,280,219,6,38,3,0,4
87052,3102,317,2785,6,0,2768,0,0,0
87053,967,145,822,47,0,769,1,0,0
87056,995,254,741,674,7,7,10,0,6
87059,9366,2555,6811,6148,52,112,54,2,88
87060,55,29,26,25,0,0,0,0,0
87061,295,177,118,104,4,4,0,0,0
87062,1709,1020,689,570,9,52,2,1,13
87063,248,159,89,77,0,3,0,0,5
87064,161,91,70,67,0,1,1,0,1
87068,4938,1794,3144,2050,13,861,14,2,53
87070,16,3,13,9,0,2,0,0,0
87072,635,33,602,4,1,587,0,0,0
87083,448,72,376,273,4,78,1,0,1
87101,19,13,6,5,1,0,0,0,0
87102,20610,11993,8617,5653,705,1213,282,17,143
87104,12537,6643,5894,4633,242,451,144,10,59
87105,54151,42521,11630,7755,534,2236,166,28,252
87106,26987,9696,17291,12255,1039,1355,1287,30,177
87107,30340,16302,14038,10876,537,1189,339,11,172
87108,36773,17717,19056,12263,1762,2626,828,37,214
87109,40740,14192,26548,19294,1298,2772,1422,26,217
87110,38441,15200,23241,17699,986,1611,1181,31,239
87111,56121,14365,41756,33494,1325,1870,2383,35,305
87112,42487,15401,27086,20852,1134,1766,1315,29,258
87113,16380,6540,9840,6675,288,477,1666,19,86
87114,69402,32644,36758,26934,2059,2963,1822,92,337
87116,4578,910,3668,2674,384,66,155,30,45
87117,0,0,0,0,0,0,0,0,0
87120,64643,34324,30319,21803,1817,2845,1579,50,302
87121,77802,63299,14503,8016,1808,2500,737,39,255
87122,18225,3752,14473,11700,174,112,1612,18,77
87123,44110,18657,25453,17648,1564,2163,2184,57,184
87124,59781,24545,35236,28307,1301,1728,1241,68,278
87144,46333,20177,26156,20390,1276,1682,783,74,230
87151,1297,660,637,439,112,85,0,0,0
87301,22438,6255,16183,3828,207,10544,677,15,96
87305,2698,118,2580,141,5,2395,3,3,1
87310,835,16,819,4,1,799,0,0,1
87311,5120,193,4927,57,2,4802,3,0,1
87312,575,33,542,76,2,449,3,0,0
87313,5383,103,5280,111,30,5016,52,3,1
87315,235,33,202,183,0,5,0,0,0
87316,1596,33,1563,14,1,1530,1,0,0
87317,1594,674,920,124,8,732,11,1,2
87319,2965,245,2720,110,10,2556,4,2,0
87320,717,11,706,2,0,699,0,0,0
87321,1964,88,1876,764,6,1025,13,0,4
87322,826,34,792,56,1,699,2,0,2
87323,4050,277,3773,418,10,3223,38,1,2
87325,2032,44,1988,35,8,1900,28,1,2
87326,2437,62,2375,187,3,2126,2,0,5
87327,7454,163,7291,107,7,7033,77,1,2
87328,2965,40,2925,17,13,2824,25,1,1
87347,343,50,293,179,2,99,1,0,0
87357,1459,51,1408,42,0,1320,12,0,1
87364,1553,26,1527,4,0,1508,2,0,0
87365,57,1,56,0,0,56,0,0,0
87375,4235,162,4073,62,8,3945,1,4,7
87401,44724,10579,34145,16826,363,14710,373,33,179
87402,11646,2597,9049,6413,74,1788,150,1,63
87410,16064,3743,12321,9815,36,1623,64,7,115
87412,766,327,439,294,4,87,13,1,3
87413,14652,4536,10116,5708,33,3846,71,4,56
87415,1708,391,1317,1087,1,119,4,1,16
87416,5310,153,5157,429,6,4603,4,3,2
87417,5838,663,5175,1507,16,3375,33,1,11
87418,1052,141,911,740,4,98,4,3,3
87419,296,52,244,215,1,7,0,2,3
87420,10462,158,10304,114,11,9958,107,8,1
87421,1717,103,1614,288,0,1237,18,1,1
87455,1641,24,1617,15,4,1551,32,1,1
87461,1313,14,1299,1,1,1278,1,0,0
87499,602,19,583,17,0,555,5,0,0
87501,15116,4174,10942,9819,105,158,224,5,114
87505,32078,11982,20096,17348,355,458,676,15,202
87506,15253,5980,9273,6627,60,1903,157,12,84
87507,51338,35111,16227,12980,407,773,776,16,304
87508,19156,7179,11977,10524,177,294,243,13,137
87510,1207,727,480,413,7,15,22,0,4
87511,2821,2386,435,331,9,51,3,0,21
87512,213,150,63,48,2,0,1,0,2
87513,1143,561,582,527,0,19,5,0,8
87514,1748,760,988,867,2,17,21,1,18
87515,279,254,25,19,0,4,2,0,0
87516,132,106,26,22,0,1,0,0,0
87517,460,49,411,362,1,6,2,0,7
87518,103,87,16,14,0,1,1,0,0
87519,399,279,120,111,0,7,0,0,0
87520,1448,844,604,532,10,21,6,0,6
87521,899,642,257,200,3,20,1,0,10
87522,3463,3005,458,392,11,13,1,1,7
87523,380,352,28,21,0,3,0,0,0
87524,203,152,51,41,0,0,3,0,0
87525,91,10,81,77,0,3,0,0,0
87527,990,578,412,371,3,6,1,0,8
87528,3641,502,3139,90,26,2892,54,1,28
87529,4846,2220,2626,2333,21,87,21,0,44
87530,916,704,212,193,0,10,1,0,0
87531,310,146,164,153,0,2,0,0,2
87532,19017,14294,4723,2581,83,1582,166,4,68
87535,1350,679,671,588,4,8,8,0,10
87537,2486,2106,380,278,11,50,3,0,10
87538,439,231,208,180,5,8,0,0,1
87539,287,235,52,44,1,3,0,0,0
87540,1052,206,846,761,3,9,24,1,9
87543,251,181,70,56,0,7,3,0,3
87544,13548,2416,11132,9128,129,76,1050,13,102
87547,5873,1019,4854,4320,28,40,173,2,36
87548,650,514,136,118,1,7,0,0,4
87549,1216,880,336,275,3,18,5,0,17
87551,347,198,149,137,0,1,1,0,5
87552,3308,2462,846,740,7,12,9,0,30
87553,1023,722,301,111,0,163,3,0,4
87554,45,35,10,4,0,2,1,0,0
87556,2259,1555,704,614,13,24,13,1,7
87557,6481,4144,2337,1987,12,127,24,1,42
87558,724,72,652,627,6,1,1,0,3
87560,1202,863,339,280,5,14,3,0,4
87562,505,308,197,181,2,2,1,0,2
87564,389,138,251,230,2,2,2,0,3
87565,317,220,97,75,0,11,2,0,1
87566,3377,1663,1714,225,12,1406,9,2,21
87567,1270,1060,210,166,0,24,1,1,4
87569,340,245,95,78,1,4,0,0,4
87571,11650,4946,6704,4756,59,1326,92,1,94
87573,79,49,30,24,3,0,1,0,0
87575,618,455,163,133,1,18,3,0,0
87577,546,177,369,317,8,6,2,0,19
87578,531,391,140,126,1,4,0,0,0
87579,795,584,211,168,4,14,1,0,4
87580,453,150,303,285,0,1,1,0,4
87581,85,57,28,26,0,0,0,0,0
87582,1432,1176,256,228,5,8,1,0,4
87583,245,191,54,36,0,0,0,0,5
87701,18387,14627,3760,2916,211,187,104,2,80
87710,1616,272,1344,1236,3,13,14,3,1
87711,590,511,79,75,0,2,1,0,0
87712,232,167,65,57,2,0,4,0,0
87713,223,180,43,39,0,1,0,0,0
87714,917,488,429,378,3,9,1,0,3
87715,636,553,83,74,0,0,2,0,0
87718,642,160,482,450,0,2,3,2,11
87722,535,393,142,132,0,7,1,0,0
87723,294,248,46,33,3,2,1,0,0
87724,98,74,24,24,0,0,0,0,0
87728,379,163,216,190,0,5,2,4,3
87729,78,22,56,54,0,0,0,0,0
87730,42,13,29,27,0,0,0,0,0
87731,437,151,286,221,26,24,3,0,3
87732,1064,878,186,161,0,3,2,0,3
87733,138,71,67,63,0,0,0,0,0
87734,148,85,63,53,0,2,1,0,2
87735,52,36,16,12,0,0,1,0,0
87736,269,228,41,37,1,2,0,0,0
87740,7138,3858,3280,3043,13,49,30,1,18
87742,497,274,223,189,2,4,3,0,5
87743,312,166,146,135,1,0,0,0,1
87745,714,434,280,250,1,9,2,0,0
87746,126,59,67,65,0,1,0,0,0
87747,1516,894,622,532,6,30,10,1,2
87749,67,13,54,50,0,0,0,0,1
87750,8,2,6,6,0,0,0,0,0
87752,378,289,89,70,4,4,2,0,0
87753,182,127,55,46,0,1,0,0,2
87801,9934,5658,4276,3237,95,340,265,8,55
87820,137,57,80,74,4,0,0,0,1
87821,640,86,554,513,3,14,0,0,5
87823,589,303,286,250,0,5,8,0,6
87824,219,29,190,188,0,0,0,0,0
87825,2802,543,2259,651,8,1522,9,0,4
87827,354,43,311,279,0,13,0,0,8
87828,279,184,95,90,0,1,0,0,0
87829,856,92,764,702,13,12,8,0,7
87830,854,230,624,559,13,6,0,0,13
87831,180,75,105,105,0,0,0,0,0
87832,520,232,288,248,2,11,4,0,3
87901,6515,1890,4625,4130,52,69,94,0,19
87930,834,613,221,204,3,2,3,1,0
87931,633,99,534,503,1,7,0,1,3
87933,50,27,23,19,0,0,0,0,0
87935,1817,255,1562,1450,8,10,15,0,4
87936,433,340,93,79,0,3,2,0,6
87937,3009,2684,325,279,5,7,1,1,6
87939,107,7,100,94,1,1,0,0,0
87940,450,374,76,67,0,1,1,0,2
87941,959,879,80,69,0,4,0,0,0
87942,1040,262,778,715,4,11,5,0,3
87943,235,61,174,162,0,5,0,0,2
88001,36831,24592,12239,9218,901,466,658,24,164
88002,940,197,743,542,88,2,28,1,9
88003,495,139,356,300,16,14,8,0,0
88004,605,6,599,558,32,6,0,0,0
88005,26997,16007,10990,9535,377,212,182,12,138
88007,24803,15390,9413,8433,218,118,108,13,69
88008,10239,8498,1741,1459,91,22,39,7,43
88009,25,2,23,19,0,0,0,0,0
88011,32885,14353,18532,15439,723,236,1003,21,140
88012,32550,21237,11313,9239,586,241,361,26,111
88020,704,202,502,467,5,3,3,0,11
88021,16431,14956,1475,1273,34,35,23,1,18
88022,1098,523,575,528,7,11,3,0,8
88023,2206,1771,435,350,11,33,5,0,16
88024,469,466,3,1,0,0,0,0,0
88025,227,20,207,201,0,2,0,0,0
88026,1590,1266,324,270,14,11,3,0,10
88027,683,630,53,44,0,2,0,0,2
88028,481,49,432,399,0,8,1,0,1
88029,1591,1349,242,210,5,6,4,0,2
88030,23831,15321,8510,7456,223,137,156,12,48
88034,81,51,30,29,0,0,0,0,0
88038,380,76,304,282,0,1,1,0,6
88039,402,47,355,337,2,1,0,0,1
88040,96,18,78,75,0,0,0,0,0
88041,954,373,581,529,5,9,2,0,9
88042,353,75,278,261,1,2,2,1,0
88043,1525,1058,467,407,10,7,0,0,4
88044,3289,2568,721,647,8,7,4,2,19
88045,3222,2166,1056,968,9,8,7,5,11
88046,718,451,267,206,5,11,2,0,6
88047,1897,1393,504,451,8,7,5,1,13
88048,3931,3673,258,201,4,15,1,2,18
88049,973,270,703,640,10,14,6,0,8
88051,112,18,94,85,0,1,2,0,1
88052,291,100,191,171,4,7,3,0,1
88053,269,39,230,213,3,6,2,0,0
88055,44,13,31,27,0,0,1,0,0
88056,237,30,207,190,0,3,1,0,6
88061,17429,7617,9812,8702,185,148,160,17,104
88063,11408,11086,322,224,14,5,11,0,39
88065,715,294,421,386,4,14,5,1,1
88072,2563,2351,212,156,12,15,0,1,8
88081,18079,15360,2719,2180,129,131,47,3,67
88101,45651,20859,24792,19386,2479,230,726,34,204
88103,35,9,26,13,6,0,1,0,1
88112,128,17,111,106,0,0,0,0,0
88113,75,30,45,41,1,1,0,0,0
88114,54,8,46,42,0,0,0,0,0
88115,26,4,22,21,0,0,0,0,0
88116,460,137,323,303,2,3,1,0,7
88118,216,39,177,171,0,2,0,0,2
88119,1582,627,955,898,3,4,4,3,0
88120,217,44,173,160,0,2,1,0,3
88121,135,7,128,121,0,0,0,1,0
88124,1043,176,867,807,0,11,1,0,4
88125,44,22,22,18,1,0,0,0,0
88126,45,19,26,23,1,1,0,0,0
88130,18027,8059,9968,8551,438,156,173,18,99
88132,229,33,196,193,0,0,0,0,0
88134,92,20,72,67,0,0,0,1,0
88135,1576,802,774,669,28,9,4,1,8
88136,58,11,47,45,0,0,0,0,2
88201,26471,11497,14974,13274,300,180,439,13,87
88203,30162,20039,10123,8535,554,168,150,13,136
88210,18571,9815,8756,7728,135,184,112,10,144
88220,40762,19739,21023,18283,643,308,456,33,251
88230,4658,3251,1407,1268,8,27,8,2,32
88231,3339,1747,1592,1425,33,17,3,0,13
88232,3026,1815,1211,1058,84,30,6,1,0
88240,42386,26238,16148,12236,2041,263,494,19,183
88242,8126,3789,4337,3924,70,35,43,0,30
88244,1247,747,500,328,103,69,0,0,0
88250,300,100,200,169,2,3,1,0,7
88252,2327,1435,892,816,11,11,0,0,0
88253,961,575,386,349,0,8,6,0,1
88254,183,38,145,144,0,1,0,0,0
88255,79,26,53,47,2,2,0,0,0
88256,1974,1345,629,579,9,15,10,0,1
88260,15569,10582,4987,4306,233,71,93,2,67
88262,33,8,25,17,0,2,0,0,1
88263,169,118,51,47,1,1,0,0,0
88264,48,16,32,25,0,2,1,0,0
88265,252,117,135,122,3,3,0,0,0
88267,1074,506,568,534,3,4,2,0,0
88268,9,2,7,6,0,0,0,0,0
88301,1341,551,790,702,6,29,6,1,7
88310,35935,11544,24391,19439,1735,351,779,103,216
88311,951,178,773,688,10,12,13,0,3
88312,2735,439,2296,2191,4,5,9,0,13
88314,215,96,119,110,0,2,0,0,2
88316,2304,489,1815,1694,9,8,10,0,22
88317,1953,251,1702,1564,8,13,3,0,19
88318,352,108,244,228,0,1,0,0,2
88321,146,66,80,72,0,4,0,0,1
88323,23,7,16,16,0,0,0,0,0
88324,100,50,50,47,0,0,0,0,0
88325,949,114,835,778,2,3,7,0,15
88330,3810,705,3105,2125,391,12,132,37,25
88336,313,195,118,93,1,7,3,0,1
88337,2325,605,1720,1531,23,22,13,4,17
88338,189,47,142,131,0,0,0,0,2
88339,768,95,673,631,3,7,2,0,3
88340,4022,425,3597,82,5,3444,5,0,4
88341,650,109,541,488,0,9,0,0,8
88342,35,3,32,26,2,0,0,1,0
88343,58,36,22,11,0,0,4,0,1
88344,145,17,128,121,0,1,0,0,2
88345,8423,2512,5911,5213,28,228,87,5,49
88346,3128,1632,1496,1222,13,140,18,1,19
88347,149,16,133,121,0,1,0,0,3
88348,394,237,157,143,1,3,1,1,6
88349,22,5,17,10,3,0,0,0,4
88350,349,41,308,295,1,1,1,0,3
88351,165,71,94,85,0,0,0,0,5
88352,4747,1982,2765,2336,32,199,17,0,23
88353,305,232,73,53,1,0,3,0,0
88354,103,7,96,93,1,0,0,0,0
88355,152,43,109,100,6,0,0,0,0
88401,6813,3467,3346,2962,88,46,44,0,28
88410,92,11,81,77,1,0,0,0,0
88411,78,2,76,76,0,0,0,0,0
88414,50,21,29,28,0,0,0,0,0
88415,3194,1416,1778,1571,64,53,5,3,14
88416,206,53,153,143,0,0,2,0,0
88417,80,34,46,43,0,0,0,0,0
88418,303,94,209,197,0,1,0,0,1
88419,183,35,148,131,0,2,1,0,0
88421,45,35,10,8,0,0,1,0,0
88422,43,7,36,29,0,0,0,0,0
88424,121,20,101,94,1,1,0,0,0
88426,1204,241,963,923,0,7,0,1,4
88427,150,14,136,129,0,0,0,0,1
88430,90,19,71,66,0,0,0,0,1
88431,37,23,14,12,0,0,0,0,0
88434,303,95,208,192,1,3,4,0,0
88435,3593,2783,810,589,63,38,46,0,21
88436,134,9,125,123,0,0,0,1,0
88439,21,11,10,10,0,0,0,0,0
89001,876,49,827,781,4,0,5,4,8
89002,37603,6273,31330,25304,1470,161,1664,205,178
89003,902,162,740,652,13,15,7,2,5
89004,266,14,252,225,0,6,6,1,5
89005,14941,1364,13577,12425,154,78,220,15,54
89007,1142,304,838,765,8,0,8,0,0
89008,1242,96,1146,1037,38,17,6,3,0
89010,333,108,225,190,2,8,3,0,0
89011,34456,8023,26433,16737,3242,145,3619,274,187
89012,35211,4983,30228,22485,1728,120,3377,205,215
89013,261,25,236,220,3,2,1,0,0
89014,40761,9824,30937,20225,3882,172,3233,412,278
89015,41203,8966,32237,24238,3179,298,1481,293,210
89017,187,13,174,166,0,2,0,2,1
89018,1026,177,849,717,9,2,15,5,1
89019,2501,557,1944,1530,176,16,114,14,8
89020,1158,493,665,546,42,13,7,4,14
89021,3270,294,2976,2797,12,13,20,1,13
89022,133,13,120,99,7,2,7,1,0
89025,1194,351,843,585,8,192,9,0,7
89026,161,13,148,96,40,0,12,0,0
89027,17547,4291,13256,12005,182,120,321,35,67
89029,8927,1462,7465,6246,393,80,225,35,55
89030,56399,37770,18629,5422,10596,153,748,305,218
89031,73386,25230,48156,22584,14496,229,5011,868,394
89032,47324,20137,27187,9218,11831,131,2960,481,297
89034,2900,109,2791,2658,22,7,35,2,8
89039,242,17,225,205,0,3,0,2,0
89040,3265,364,2901,2688,18,19,29,1,7
89042,938,37,901,875,3,0,0,1,0
89043,1250,99,1151,973,123,7,10,3,0
89044,27576,3594,23982,16976,1304,71,3710,104,120
89045,1574,152,1422,1280,9,42,7,8,6
89046,562,68,494,418,21,7,7,3,4
89047,121,9,112,92,0,11,0,0,0
89048,25166,3617,21549,18425,704,183,578,126,165
89049,2499,266,2233,1985,59,26,32,5,10
89052,59987,8240,51747,35214,3249,143,8461,469,326
89054,52,8,44,36,1,0,2,0,0
89060,11857,2085,9772,8341,402,129,160,43,49
89061,7891,1106,6785,5785,259,58,232,28,42
89070,5192,1271,3921,1710,2008,41,159,1,2
89074,52243,9924,42319,29494,3487,179,4956,436,311
89081,40772,14010,26762,9867,10071,136,3456,476,266
89084,31369,6540,24829,12483,5849,107,3667,299,194
89085,4261,740,3521,2147,459,14,427,54,45
89086,6149,1713,4436,1650,1908,15,371,52,30
89101,42465,24534,17931,7794,6671,146,1541,195,353
89102,36035,16290,19745,9377,4977,156,3171,329,236
89103,49461,16414,33047,14928,7671,128,7301,483,283
89104,41662,23333,18329,9531,4570,168,2339,141,236
89106,27695,11233,16462,3262,10607,131,1017,194,155
89107,37665,20011,17654,10143,3677,140,1720,293,175
89108,73637,33673,39964,20297,11587,287,3267,614,436
89109,7728,1656,6072,3574,1070,41,867,32,73
89110,73954,48061,25893,12195,7375,211,3184,337,332
89113,35829,6183,29646,13946,3415,86,9489,398,186
89115,67043,35814,31229,11223,14304,282,1977,349,364
89117,57497,10430,47067,28869,5832,158,8234,430,424
89118,22588,4331,18257,8055,4130,92,4427,210,142
89119,48895,18424,30471,13582,8252,259,5137,458,436
89120,24813,8877,15936,10523,1948,129,1722,202,135
89121,68692,29754,38938,22058,8717,370,3694,660,386
89122,55522,20859,34663,16985,7240,205,6452,625,276
89123,55584,12117,43467,26666,4175,180,7375,937,389
89124,671,76,595,503,10,33,22,0,3
89128,37882,9408,28474,17003,4895,165,3591,286,246
89129,54067,11650,42417,28056,5860,191,4188,405,291
89130,34212,7819,26393,17595,4252,145,1813,210,176
89131,49985,8595,41390,30340,4077,179,2708,401,273
89134,24024,2172,21852,17495,1046,49,2091,72,122
89135,31763,3518,28245,20328,1285,64,4635,101,180
89138,21504,2476,19028,12964,636,37,3862,52,130
89139,44960,8191,36769,13074,5851,134,13928,614,229
89141,37437,6966,30471,15932,3053,115,7749,437,212
89142,36108,20611,15497,6383,3533,128,3739,250,181
89143,13249,2579,10670,7334,1343,62,779,84,86
89144,19533,2643,16890,11832,1066,50,2603,90,102
89145,24886,6887,17999,11930,2077,106,2169,174,168
89146,19777,6233,13544,6953,2634,71,2600,133,126
89147,55642,12484,43158,21074,6493,173,11599,451,286
89148,61281,11146,50135,23104,6169,159,15358,638,331
89149,41805,7469,34336,23073,4470,132,3004,287,236
89156,30067,16604,13463,6963,3804,126,1004,168,159
89158,477,29,448,310,10,0,115,0,1
89161,332,30,302,269,4,0,12,0,0
89166,26038,5107,20931,13439,2669,78,2337,166,152
89169,25938,9432,16506,7166,5978,150,1513,176,223
89178,42157,8475,33682,16919,3269,121,9422,515,210
89179,11852,2366,9486,4877,751,35,2731,148,59
89183,40517,9710,30807,15449,3602,154,7129,1075,185
89191,658,125,533,284,141,5,34,9,6
89301,6879,1195,5684,4679,355,301,94,11,18
89310,558,57,501,437,0,30,0,2,5
89311,169,41,128,101,3,9,0,0,0
89314,168,19,149,17,1,119,1,1,0
89315,55,11,44,43,0,0,0,0,0
89316,1085,115,970,904,1,13,2,0,8
89317,381,31,350,340,1,3,0,0,1
89318,1035,118,917,806,21,22,9,4,2
89319,371,22,349,310,0,7,1,4,1
89402,221,11,210,195,0,3,4,0,3
89403,16824,2784,14040,12352,82,178,288,44,90
89404,65,2,63,62,0,0,0,0,1
89405,49,15,34,31,0,0,0,0,0
89406,25204,3534,21670,17687,397,999,631,86,139
89408,23201,4148,19053,16181,294,345,487,96,107
89409,195,15,180,160,0,8,0,0,0
89410,11169,1454,9715,8765,39,147,218,13,61
89411,1342,52,1290,1217,1,10,18,0,10
89412,257,31,226,198,5,7,0,0,2
89413,792,26,766,694,2,0,28,0,7
89414,290,31,259,229,1,10,0,0,8
89415,3534,397,3137,2630,156,87,62,8,13
89418,381,61,320,283,1,1,2,1,1
89419,5157,1259,3898,3082,320,189,102,3,16
89420,47,4,43,31,0,7,0,0,3
89421,458,20,438,131,0,287,1,0,0
89422,138,9,129,119,0,6,2,0,0
89423,11050,981,10069,9193,36,84,185,10,48
89424,563,40,523,23,1,486,0,0,0
89425,371,67,304,290,1,3,1,1,0
89426,162,18,144,135,0,0,0,0,3
89427,809,97,712,59,3,611,0,0,0
89428,160,9,151,146,0,1,0,0,1
89429,8132,767,7365,6467,39,113,80,19,44
89430,468,64,404,371,3,6,3,0,2
89431,40219,18016,22203,15637,1327,385,2429,506,168
89433,22065,11164,10901,8741,342,255,371,197,89
89434,28154,6983,21171,16504,692,210,1968,274,88
89436,47393,8843,38550,31006,1068,333,3000,203,249
89437,0,0,0,0,0,0,0,0,0
89438,26,3,23,20,0,1,0,0,1
89439,2154,182,1972,1765,8,12,59,0,18
89440,908,36,872,793,3,16,9,1,8
89441,13887,1622,12265,10447,115,608,267,34,37
89442,1212,127,1085,315,7,687,6,5,4
89444,2939,303,2636,2426,11,34,20,2,5
89445,16896,4516,12380,10940,105,278,153,29,190
89446,112,7,105,67,31,0,2,0,0
89447,8305,1978,6327,5394,64,425,51,9,14
89448,1905,140,1765,1578,8,4,65,7,19
89449,2896,424,2472,2214,16,8,77,4,8
89450,65,15,50,42,0,0,3,2,3
89451,9531,1513,8018,7275,29,25,227,12,59
89460,13461,1761,11700,10305,47,469,159,28,52
89496,157,20,137,83,27,0,7,0,5
89501,3948,418,3530,2775,184,57,218,20,29
89502,47062,19811,27251,19566,1683,752,2754,368,261
89503,28737,5098,23639,18526,899,227,1883,193,149
89506,43321,14529,28792,22229,909,376,2222,480,232
89508,13394,2175,11219,9758,138,144,201,43,89
89509,34817,5199,29618,24938,643,178,1710,183,188
89510,1874,210,1664,1312,16,192,25,4,13
89511,29143,3196,25947,22159,330,126,1595,41,197
89512,30148,11471,18677,12345,1868,286,2083,422,192
89519,9610,755,8855,7637,58,23,587,12,49
89521,39119,5157,33962,27120,530,185,3441,122,172
89523,36646,5437,31209,25041,624,214,2887,133,178
89557,1023,134,889,623,39,1,129,0,0
89701,29213,8121,21092,17501,837,534,695,46,129
89703,10370,986,9384,8186,59,302,236,16,88
89704,4503,311,4192,3744,28,31,45,3,29
89705,5266,1154,4112,3561,26,58,135,18,33
89706,20778,6282,14496,12441,195,260,444,48,79
89801,26250,7673,18577,15648,323,1049,371,41,137
89815,15856,1649,14207,12976,39,249,86,16,64
89820,5226,1202,4024,3555,7,199,27,8,14
89821,700,54,646,594,1,6,0,3,3
89822,1982,204,1778,1607,8,32,9,3,10
89823,177,25,152,137,0,2,0,0,0
89825,884,424,460,404,3,7,10,2,8
89826,33,1,32,30,0,2,0,0,0
89828,329,16,313,304,0,1,0,1,0
89830,130,9,121,111,1,4,2,1,0
89831,49,6,43,36,1,6,0,0,0
89832,1338,47,1291,54,3,1185,3,9,2
89833,164,9,155,151,0,3,0,0,1
89834,136,10,126,112,0,10,0,2,0
89835,1689,368,1321,1139,8,75,2,5,11
89883,4683,3076,1607,1344,14,48,65,5,12
90001,55859,49791,6068,559,4604,75,177,13,288
90002,53150,41348,11802,499,10323,58,195,30,195
90003,72764,55836,16928,939,13996,133,302,47,499
90004,58585,27410,31175,11974,2202,90,14826,33,419
90005,37987,16720,21267,4625,2128,79,13285,28,172
90006,58229,40103,18126,3156,2264,65,11549,34,298
90007,40944,20934,20010,6372,4179,90,7999,65,285
90008,33041,7992,25049,2136,19873,54,1037,36,327
90010,5400,621,4779,885,296,11,3314,8,44
90011,102308,91467,10841,1144,7666,123,798,30,437
90012,33851,9779,24072,6153,4056,80,12618,47,187
90013,15589,3833,11756,4567,3622,183,2351,49,137
90014,9254,2112,7142,3216,1498,34,1733,18,100
90015,27324,12758,14566,5509,2735,58,5106,38,194
90016,46512,24002,22510,4827,13130,79,2173,32,487
90017,27295,15022,12273,4114,2222,67,4913,13,180
90018,50179,29966,20213,3422,11794,93,2760,44,432
90019,62002,27468,34534,10962,9980,93,10468,41,581
90020,38694,12850,25844,4920,2105,47,17554,13,254
90021,5192,1908,3284,1324,1359,70,257,24,57
90022,64517,61718,2799,1197,319,120,707,10,173
90023,45939,43744,2195,857,465,59,439,12,174
90024,52862,6868,45994,26362,1924,141,15042,75,403
90025,45466,6897,38569,25065,1299,58,9047,57,302
90026,63329,30324,33005,18437,2369,109,9460,42,401
90027,44471,9119,35352,26233,1362,60,5193,55,260
90028,32330,9099,23231,14882,2923,90,3095,51,501
90029,34695,18107,16588,9007,1163,50,5202,38,190
90031,37333,24365,12968,3348,694,85,8051,19,143
90032,43506,33376,10130,3351,1043,140,4758,25,183
90033,46081,40615,5466,1564,998,63,2270,32,132
90034,57152,15889,41263,23145,4029,56,10537,102,490
90035,30294,3236,27058,20762,1850,49,2091,14,488
90036,39549,4157,35392,23589,2253,55,6784,26,472
90037,63706,49012,14694,1338,10772,91,939,23,440
90038,27414,14148,13266,8391,1409,40,2202,23,229
90039,28059,9579,18480,11817,545,47,4666,24,154
90040,12089,11413,676,279,87,39,169,3,43
90041,26654,8651,18003,8938,549,65,6958,34,140
90042,58295,35150,23145,12745,1105,153,7015,27,358
90043,46179,15412,30767,2389,24662,104,852,37,413
90044,94354,60930,33424,1182,28858,150,559,152,640
90045,41035,7520,33515,19649,4303,76,6144,116,377
90046,49987,6151,43836,35133,2132,73,3149,46,436
90047,50154,19067,31087,849,27579,87,472,81,387
90048,22604,2294,20310,16127,876,31,1932,26,168
90049,36980,2724,34256,28057,573,22,3322,20,243
90052,13,5,8,5,3,0,0,0,0
90056,8184,761,7423,1142,5147,21,426,2,94
90057,45510,30328,15182,3047,2368,116,8682,23,252
90058,3751,2895,856,104,503,8,151,2,31
90059,43551,30664,12887,569,11211,61,218,35,199
90061,29570,19254,10316,405,9020,22,136,67,170
90062,32524,20915,11609,951,8924,58,514,18,309
90063,50227,47092,3135,1305,310,70,1026,12,162
90064,27553,4365,23188,15656,728,25,4875,31,180
90065,44328,24612,19716,10408,817,78,6711,39,204
90066,55304,14409,40895,27125,1862,108,7852,96,476
90067,3344,166,3178,2553,50,1,445,5,25
90068,24361,3030,21331,16832,1053,27,1761,20,214
90069,20584,2113,18471,15376,602,26,1325,21,168
90071,907,315,592,158,336,4,39,5,10
90073,936,171,765,477,219,4,20,3,3
90077,8874,530,8344,6687,145,5,899,4,74
90079,16,8,8,2,1,0,0,0,0
90089,5172,888,4284,1886,738,20,1513,14,7
90094,12746,1395,11351,6612,1184,16,2597,27,107
90095,1,0,1,0,0,0,1,0,0
90201,95810,91209,4601,2624,509,168,591,60,267
90210,21134,1296,19838,16829,354,13,1393,10,152
90211,8260,569,7691,5961,200,4,946,3,62
90212,11451,940,10511,8394,300,4,1081,0,113
90220,50412,32372,18040,877,15322,74,385,320,224
90221,52561,41592,10969,493,9266,59,175,249,229
90222,32397,23717,8680,331,7538,45,145,89,139
90230,32743,9758,22985,12104,2882,41,5494,54,233
90232,16452,3640,12812,7880,901,24,2621,56,183
90240,26495,19592,6903,3679,582,42,2040,26,161
90241,44921,33721,11200,5808,1348,94,2860,75,269
90242,42939,32553,10386,4891,2000,115,2411,148,261
90245,17272,2976,14296,10636,394,45,1804,61,88
90247,48543,23426,25117,2965,8289,67,11927,263,284
90248,11295,4821,6474,979,1633,18,3245,70,69
90249,27125,10939,16186,2866,7167,61,4676,118,189
90250,97653,52363,45290,11796,21068,147,7566,795,821
90254,19736,2071,17665,14569,195,31,1370,20,152
90255,71157,68805,2352,982,454,23,383,20,248
90260,33338,20354,12984,5234,2445,78,3728,190,269
90262,67099,59309,7790,1208,5270,63,394,180,274
90263,1972,92,1880,1102,158,62,548,5,0
90265,15186,1253,13933,12094,246,24,662,14,113
90266,35506,3072,32434,25353,305,28,3995,29,240
90270,25113,24378,735,361,106,29,80,1,66
90272,22849,1407,21442,18352,180,16,1475,17,154
90274,25307,1968,23339,15244,313,32,6061,13,181
90275,42452,4552,37900,20561,1088,37,13479,32,304
90277,37856,5922,31934,24103,1007,135,3915,61,258
90278,42188,7793,34395,22227,1260,68,7100,130,324
90280,92678,87993,4685,2287,884,119,609,33,332
90290,6640,595,6045,5204,78,22,239,6,70
90291,28442,5224,23218,18563,1327,58,1362,50,270
90292,27681,2848,24833,18983,1265,23,2725,29,292
90293,12633,1757,10876,7885,623,19,1357,23,109
90301,36270,22431,13839,1375,10146,71,1005,78,247
90302,29264,13665,15599,1999,11409,59,622,55,261
90303,24490,15146,9344,520,7630,33,251,170,167
90304,26058,22879,3179,884,1131,29,547,154,143
90305,15367,2202,13165,477,11614,32,180,18,159
90401,8167,1062,7105,5023,585,19,885,6,73
90402,12295,738,11557,9624,111,8,991,12,117
90403,25278,2347,22931,18443,402,31,2283,17,206
90404,21995,5414,16581,11065,1646,24,2286,44,223
90405,27966,4146,23820,18614,902,51,2166,31,204
90501,43990,18306,25684,9329,2341,76,11428,293,300
90502,18977,6944,12033,2946,1296,54,6771,225,101
90503,45386,6566,38820,15491,1518,83,18546,116,403
90504,32503,8064,24439,8111,1403,51,12582,179,230
90505,36643,5112,31531,15422,930,55,12665,82,144
90506,0,0,0,0,0,0,0,0,0
90601,32625,24116,8509,5394,452,98,1810,43,132
90602,25521,20094,5427,3509,346,84,890,40,136
90603,21174,12390,8784,6520,210,57,1382,30,101
90604,40110,27960,12150,7946,595,128,2402,63,221
90605,40189,31955,8234,5273,351,80,1679,89,164
90606,32078,28058,4020,2460,321,116,629,45,145
90620,46564,16862,29702,11909,1207,92,14332,261,206
90621,36972,17310,19662,4320,1246,81,13005,110,136
90623,15906,2976,12930,3362,782,20,8054,79,59
90630,49965,10604,39361,16268,1526,88,18701,255,201
90631,69533,39576,29957,17719,1096,153,9001,65,298
90638,46967,20600,26367,12777,953,125,10684,101,235
90639,1511,254,1257,868,52,1,244,4,6
90640,62678,49047,13631,4460,470,105,7798,66,196
90650,102891,73612,29279,8933,3875,294,13691,370,486
90660,62013,56188,5825,2601,383,130,2064,30,266
90670,17761,13513,4248,1781,504,34,1549,42,70
90680,30045,14740,15305,4912,553,51,8800,159,171
90701,16434,5832,10602,2610,629,26,6879,58,65
90703,49735,7284,42451,6324,3162,59,30786,193,237
90704,3715,1967,1748,1530,39,4,30,11,13
90706,79179,45246,33933,10812,10128,183,9855,531,376
90710,26605,11696,14909,4759,3188,18,5703,203,103
90712,32332,11141,21191,10033,3155,105,5697,328,175
90713,28755,9132,19623,12724,1319,68,3484,140,178
90715,20999,9118,11881,3057,1917,42,5854,175,94
90716,14098,10835,3263,750,547,17,1734,32,56
90717,22044,8270,13774,7519,1195,62,3562,144,142
90720,22955,4833,18122,12279,449,46,3738,93,100
90723,53770,43645,10125,2277,4977,94,1703,225,208
90731,61270,32960,28310,17347,4398,244,3207,284,461
90732,21397,6345,15052,10439,1198,52,2113,62,165
90740,24769,3101,21668,16452,370,52,3588,45,84
90742,748,109,639,539,5,0,42,5,4
90743,466,49,417,360,0,2,36,1,4
90744,53074,46545,6529,2131,1807,92,1335,305,237
90745,59937,25523,34414,4751,5142,113,21278,1149,283
90746,27147,6612,20535,1219,15514,55,2422,277,160
90747,22,4,18,1,4,0,0,0,4
90755,11923,4233,7690,2834,1559,34,2603,81,50
90802,41686,15133,26553,13990,6169,177,3496,195,447
90803,32192,5906,26286,20988,1047,66,2159,78,217
90804,39370,18249,21121,8773,4998,143,5168,148,209
90805,95350,56677,38673,6886,16774,190,10414,1545,480
90806,41611,21630,19981,3899,6232,88,7834,386,217
90807,32412,9712,22700,10420,4704,68,5305,229,172
90808,39747,10535,29212,20653,1527,67,3898,175,213
90810,38529,20431,18098,2414,4683,76,8990,784,134
90813,54565,34112,20453,4440,7058,128,6814,305,288
90814,19042,5170,13872,9657,1263,50,1446,68,152
90815,41837,10037,31800,21167,2145,78,5268,176,245
90822,54,13,41,29,11,0,1,0,0
90831,0,0,0,0,0,0,0,0,0
90840,8,5,3,0,2,0,0,0,0
91001,36578,11066,25512,13900,6896,36,2346,25,271
91006,31949,4821,27128,6130,349,33,19643,7,116
91007,33804,4553,29251,5696,613,49,21817,36,153
91008,1010,230,780,366,18,4,349,1,5
91010,26730,14058,12672,5448,1456,57,4926,17,128
91011,20588,1720,18868,11127,133,24,6407,2,128
91016,41852,16789,25063,14030,2061,68,6927,30,248
91020,8439,1442,6997,4308,100,14,2173,5,50
91024,11268,1923,9345,7046,153,20,1408,10,67
91030,26927,5579,21348,9692,638,28,9134,9,172
91040,21588,5557,16031,13259,303,46,1499,20,116
91042,28036,6870,21166,17375,353,35,2349,15,119
91046,141,23,118,99,0,0,13,0,0
91101,20583,5436,15147,7951,1294,34,4857,46,125
91103,26887,13704,13183,5435,3853,51,2795,14,172
91104,34707,12844,21863,14159,2683,47,3193,48,194
91105,13869,2201,11668,7514,626,16,2704,5,75
91106,24172,6550,17622,9315,1282,36,5694,24,156
91107,33729,8796,24933,13622,1546,37,8013,28,186
91108,12777,915,11862,3598,60,4,7658,7,24
91125,161,36,125,54,7,0,40,0,6
91201,22608,3695,18913,15932,314,8,1848,13,72
91202,22875,2775,20100,15919,385,25,2843,10,80
91203,16930,2648,14282,9927,543,29,3093,12,80
91204,17302,5044,12258,8156,553,39,2932,20,78
91205,36693,8724,27969,21388,522,31,4948,15,128
91206,33252,4975,28277,21357,556,29,4990,22,100
91207,10369,1156,9213,7690,107,1,1077,4,23
91208,16776,1874,14902,11450,186,8,2574,9,59
91210,555,81,474,300,24,0,116,0,0
91214,31097,3907,27190,16786,221,45,8557,22,130
91301,24790,2798,21992,18102,315,33,2081,6,159
91302,25468,2004,23464,19063,604,39,2236,19,193
91303,28457,16731,11726,6146,1324,42,3121,27,193
91304,52386,23028,29358,16888,2476,74,7592,66,333
91306,46669,23058,23611,11068,1974,80,8703,68,296
91307,24855,4099,20756,14486,736,32,3935,13,150
91311,39014,10997,28017,16990,1896,59,7093,58,269
91316,28777,4280,24497,19395,1164,29,2034,27,206
91320,44462,8816,35646,27087,464,66,5247,42,320
91321,33560,16671,16889,11966,961,66,2521,30,178
91324,29500,11246,18254,9593,1672,48,5633,32,192
91325,35250,13123,22127,12465,1857,46,6096,58,333
91326,38041,6103,31938,16457,1236,46,12397,35,238
91330,2273,1027,1246,446,509,4,264,8,0
91331,100720,86571,14149,5001,2391,140,5367,56,364
91335,76650,39382,37268,21439,3015,130,9763,53,484
91340,34610,31377,3233,1607,585,82,565,22,111
91342,96429,72809,23620,12483,3473,222,5525,58,519
91343,62595,36701,25894,12012,2538,69,9445,80,411
91344,52481,16702,35779,23296,1546,84,8548,81,334
91345,18895,12931,5964,3148,516,69,1856,19,73
91350,41514,11361,30153,20722,1590,87,5328,55,234
91351,34684,17193,17491,11850,1225,86,2907,52,198
91352,47274,32651,14623,9925,750,72,2867,41,323
91354,33962,6783,27179,17192,1124,49,6739,51,226
91355,32886,7233,25653,18644,962,89,4048,33,190
91356,30664,5197,25467,20391,1245,33,2064,23,196
91360,43046,10284,32762,26485,594,92,3204,64,255
91361,20262,2166,18096,15317,218,39,1467,15,90
91362,35803,6199,29604,23099,555,55,3752,46,183
91364,27071,3176,23895,18945,1149,33,1971,10,233
91367,46498,6388,40110,27505,2614,73,6934,41,368
91371,14,1,13,5,2,1,0,0,1
91377,13898,1118,12780,9199,167,11,2676,7,75
91381,20862,3747,17115,9452,807,40,5553,26,157
91384,28585,11753,16832,11314,1900,60,2196,52,186
91387,45749,18459,27290,16839,2961,79,5224,64,262
91390,20128,5020,15108,11939,562,46,1343,20,117
91401,39621,15779,23842,18103,1813,55,2217,57,280
91402,70140,48733,21407,7656,1889,101,10582,52,378
91403,25329,3378,21951,16989,1223,16,2132,32,179
91405,55319,31778,23541,14572,2715,78,4366,63,416
91406,53252,29366,23886,14842,2535,57,4375,43,402
91411,24984,12250,12734,8397,1348,24,1854,4,170
91423,32635,4773,27862,21868,1595,55,2272,27,268
91436,15189,1213,13976,11695,314,9,1105,7,97
91501,21157,3075,18082,14299,535,24,2260,19,103
91502,11665,3699,7966,5700,479,23,1218,7,63
91504,26678,6550,20128,14725,659,35,3528,21,118
91505,32371,8428,23943,17546,853,71,3517,33,261
91506,19338,5151,14187,10397,458,71,2113,19,96
91601,39429,14545,24884,16788,3200,66,2686,64,265
91602,19647,3405,16242,12199,1158,41,1554,14,134
91604,30947,3339,27608,21825,1201,40,2463,16,273
91605,54341,31925,22416,14346,1904,51,4968,45,240
91606,43955,23306,20649,14865,1682,76,2657,49,240
91607,30502,6190,24312,18783,1688,62,1983,34,254
91608,37,6,31,15,5,2,0,0,0
91701,38778,13322,25456,17330,1916,90,4232,61,182
91702,62328,42329,19999,8747,1689,148,7862,76,275
91706,73313,54728,18585,2425,618,93,14631,42,264
91708,14381,4584,9797,2820,1734,57,4481,19,96
91709,78530,22105,56425,18512,3119,126,31462,125,378
91710,82576,45725,36851,17421,3521,215,13270,90,388
91711,38122,9670,28452,18045,1812,92,5907,50,285
91722,36111,23558,12553,5187,1036,85,5374,41,169
91723,19653,12220,7433,3679,662,78,2439,36,115
91724,27180,14304,12876,6889,881,85,3949,41,161
91730,68883,29519,39364,19776,7564,182,8436,181,416
91731,28197,17830,10367,1124,265,34,8620,6,83
91732,60137,39023,21114,2156,411,93,17808,25,213
91733,41990,30715,11275,872,135,39,9940,4,91
91737,24568,7698,16870,10394,1605,35,3600,27,143
91739,42411,14762,27649,12521,4161,50,8966,118,246
91740,26644,11864,14780,9648,708,65,3185,18,139
91741,26999,7538,19461,14232,331,60,3584,8,138
91744,81817,66061,15756,2999,822,119,10811,117,304
91745,54280,24380,29900,5860,532,95,22315,59,173
91746,29509,23843,5666,1083,306,45,3851,42,120
91748,44737,12986,31751,3076,590,45,27136,53,137
91750,33376,11924,21452,15306,992,87,3563,49,190
91752,38610,22420,16190,7693,2289,92,4879,112,186
91754,33300,10531,22769,1381,208,43,20459,33,98
91755,27637,6161,21476,993,150,21,19826,12,76
91759,432,43,389,361,4,2,4,0,3
91761,60306,39441,20865,8857,3701,122,6430,128,342
91762,62524,43283,19241,8823,2765,146,5828,126,334
91763,37631,27025,10606,3972,1520,74,4269,42,134
91764,55322,39473,15849,6621,3919,150,3621,165,277
91765,46449,9084,37365,7126,1590,53,27061,72,157
91766,70701,51828,18873,5326,2955,155,9007,84,308
91767,51654,35199,16455,7044,3419,134,4421,75,259
91768,35568,25360,10208,4330,1884,107,2870,76,144
91770,59360,18929,40431,2042,288,48,37349,27,155
91773,34592,12883,21709,14046,1194,88,4852,26,198
91775,24252,5943,18309,4449,249,31,12689,4,116
91776,38031,10314,27717,1969,353,39,24709,28,81
91780,35751,7536,28215,4742,279,46,22235,11,155
91784,26718,7329,19389,13564,958,65,3521,31,149
91786,55763,28719,27044,16181,3890,148,4592,120,329
91789,41235,7863,33372,4121,892,13,27277,25,146
91790,46364,27734,18630,4960,1373,98,11222,57,259
91791,34267,17287,16980,4894,1157,76,9956,51,189
91792,30683,13825,16858,2058,1253,45,12753,45,94
91801,53669,18260,35409,4950,997,78,27996,41,222
91803,29374,11731,17643,2002,348,59,14625,29,84
91901,17688,3200,14488,12312,239,457,350,52,117
91902,17902,8485,9417,5743,555,56,2050,72,109
91905,1799,456,1343,979,54,171,21,6,13
91906,3904,1358,2546,1938,70,251,53,7,27
91910,79613,51478,28135,14550,2976,167,7220,341,320
91911,85442,63281,22161,10044,2692,158,6538,317,326
91913,55923,24402,31521,8553,3970,83,15385,260,269
91914,17522,8259,9263,3611,700,42,3786,67,96
91915,33218,15672,17546,5743,2296,34,7291,139,133
91916,1720,290,1430,1287,5,10,16,0,9
91917,1126,702,424,341,17,5,15,1,6
91931,481,59,422,406,1,0,1,0,0
91932,26013,13293,12720,8702,860,96,1488,116,119
91934,693,229,464,381,25,10,7,3,6
91935,8841,2384,6457,5646,129,36,176,12,62
91941,33895,8149,25746,19121,2127,82,1974,146,181
91942,40813,10011,30802,22602,2384,144,2530,220,239
91945,27814,12929,14885,7512,3219,81,2377,230,154
91948,87,13,74,65,1,1,2,0,0
91950,57849,38582,19267,4636,1964,114,10827,281,164
91962,1860,282,1578,1416,10,6,28,1,16
91963,1101,791,310,259,22,12,1,0,0
91977,60795,28580,32215,16580,6447,188,5048,383,357
91978,9949,3784,6165,4021,925,24,535,51,82
91980,145,109,36,18,1,0,3,1,0
92003,4781,1249,3532,2939,81,12,214,10,20
92004,3414,1313,2101,1917,13,20,25,0,20
92007,10981,1454,9527,8360,39,17,382,23,81
92008,27282,5034,22248,19028,293,87,1121,64,165
92009,44816,5515,39301,31882,467,65,3801,61,229
92010,18887,3361,15526,12011,227,50,1841,37,96
92011,23757,3391,20366,16278,244,57,2240,34,134
92014,13203,932,12271,10424,73,20,928,6,97
92019,45108,9046,36062,30156,1554,256,1604,123,190
92020,60454,17149,43305,32684,3681,186,2729,263,395
92021,70584,21636,48948,37759,3695,239,2799,251,344
92024,51190,7924,43266,37374,244,98,2279,41,310
92025,51586,28430,23156,16946,1106,167,2761,92,225
92026,52797,20711,32086,23100,1142,155,4996,138,228
92027,56840,30897,25943,18069,1077,209,4131,120,249
92028,51614,20627,30987,25916,737,175,1644,156,221
92029,21236,4940,16296,12448,396,64,2095,38,126
92036,3735,649,3086,2669,63,47,49,4,40
92037,41260,4683,36577,27919,435,53,5613,45,248
92040,43640,9860,33780,27998,1000,750,1017,116,264
92054,38667,14042,24625,19335,1091,113,1504,282,234
92055,9684,2936,6748,5233,871,115,355,122,9
92056,53750,16995,36755,27588,1594,149,3760,496,284
92057,57844,21893,35951,23095,2562,145,5632,734,346
92058,45389,16691,28698,19613,3105,277,2609,552,238
92059,1872,731,1141,282,3,770,18,1,7
92060,288,40,248,230,0,2,8,0,0
92061,2246,962,1284,868,14,280,34,2,13
92064,48884,9020,39864,28945,663,81,6647,107,236
92065,37047,9704,27343,23871,307,254,674,83,218
92066,330,56,274,234,6,7,4,0,4
92067,9344,754,8590,7265,76,10,771,14,61
92069,49407,22553,26854,18006,998,104,4988,181,280
92070,1093,188,905,563,7,292,6,2,3
92071,60163,12543,47620,37838,1270,226,3477,280,416
92075,12051,1786,10265,9040,68,18,507,6,63
92078,52347,13538,38809,28883,962,92,5592,76,290
92081,28745,8109,20636,15674,823,71,2127,138,132
92082,20860,6811,14049,10907,172,1229,636,48,121
92083,39219,23568,15651,10697,992,131,1771,301,198
92084,49941,24709,25232,19825,890,163,1809,252,297
92086,1490,353,1137,976,23,40,37,4,1
92091,1571,96,1475,1319,2,1,79,0,7
92092,5251,971,4280,1753,169,0,2268,0,0
92093,5076,861,4215,3085,298,4,435,2,2
92096,35,16,19,11,2,0,1,1,3
92101,47505,10245,37260,26662,3531,237,3859,123,379
92102,39783,23956,15827,8363,3349,87,2528,143,175
92103,33311,5720,27591,22179,921,88,2250,62,230
92104,44265,14283,29982,21471,2770,104,2770,119,260
92105,66579,33868,32711,8481,8777,168,12836,159,283
92106,20214,2860,17354,14726,502,67,780,42,151
92107,28684,3985,24699,20987,424,84,854,68,284
92108,24266,5322,18944,11865,1788,62,3341,124,187
92109,44671,6204,38467,32542,651,113,1728,93,464
92110,31048,6358,24690,17749,1477,87,2963,95,265
92111,46686,13256,33430,18955,2263,135,9079,170,296
92113,50457,39246,11211,3495,4573,150,1726,176,250
92114,66248,29996,36252,6111,11275,142,15403,607,295
92115,64251,20257,43994,23511,7024,208,9143,229,390
92116,31523,8406,23117,17382,1599,89,1834,69,243
92117,51505,12352,39153,28916,946,104,5288,183,364
92118,20629,3582,17047,14250,816,61,623,44,118
92119,24298,4395,19903,15205,1106,51,1595,117,123
92120,30768,5733,25035,18474,1581,93,2486,126,155
92121,4658,592,4066,2009,63,4,1574,7,34
92122,45646,5496,40150,21934,712,50,14584,69,286
92123,30937,6908,24029,13316,2422,137,5316,205,235
92124,30530,5588,24942,16887,1838,109,3149,170,330
92126,74788,10793,63995,18317,2626,121,37583,349,360
92127,52274,5373,46901,24004,855,50,18092,97,293
92128,49083,5370,43713,26866,1015,55,12517,109,254
92129,52415,5862,46553,22797,1159,69,18393,161,279
92130,61595,5676,55919,31458,617,52,19580,46,380
92131,36394,3518,32876,18931,733,56,10435,66,207
92132,0,0,0,0,0,0,0,0,0
92134,396,101,295,188,71,3,21,4,0
92135,1610,388,1222,774,278,8,76,14,3
92136,7014,1568,5446,2957,1496,49,560,49,44
92139,35771,14695,21076,4136,3940,100,10760,370,110
92140,2183,860,1323,1022,85,26,96,9,4
92145,6057,1835,4222,2932,582,42,528,97,25
92147,256,89,167,105,30,5,9,0,8
92154,84027,58318,25709,8815,3957,128,9839,328,313
92155,210,22,188,172,0,5,1,0,0
92161,66,27,39,38,0,0,0,1,0
92173,29703,27951,1752,760,265,15,440,16,75
92179,3824,1361,2463,958,1357,55,37,8,6
92182,27,9,18,10,0,0,3,0,0
92201,66989,51133,15856,11973,1322,211,1159,21,259
92203,31366,14418,16948,13828,695,121,1132,34,157
92210,4757,310,4447,4135,37,10,128,4,22
92211,26403,4693,21710,18945,510,55,1320,29,97
92220,32947,14693,18254,12036,2314,1019,1744,32,131
92222,64,32,32,25,0,3,0,0,3
92223,59924,24201,35723,23635,4293,362,4609,109,305
92225,21104,12437,8667,5343,2115,178,314,22,70
92227,27492,23448,4044,3128,307,31,243,11,69
92230,2650,1403,1247,815,139,52,72,3,20
92231,39542,37995,1547,607,76,6,669,4,100
92233,7019,5241,1778,579,1024,42,37,13,9
92234,51509,30898,20611,14787,1108,268,2931,53,250
92236,42220,40656,1564,869,136,83,149,10,164
92239,292,101,191,173,4,0,2,0,0
92240,40920,25515,15405,10195,2666,196,837,65,231
92241,9270,4409,4861,4204,143,37,141,13,47
92242,1231,184,1047,914,9,63,10,1,1
92243,49149,42193,6956,4800,823,85,640,17,173
92249,6975,6783,192,132,12,6,22,1,6
92250,7883,6282,1601,1387,25,13,33,4,25
92251,25851,20208,5643,3300,1379,64,514,20,74
92252,8463,1666,6797,5721,258,74,165,18,43
92253,37422,12751,24671,21034,636,124,1438,45,177
92254,12414,12105,309,161,37,15,18,2,43
92256,3517,736,2781,2424,50,24,59,6,15
92257,1676,827,849,671,61,27,24,3,7
92258,1236,861,375,230,53,21,33,0,4
92259,328,78,250,219,6,8,3,0,4
92260,31641,8914,22727,19834,510,71,1164,35,134
92262,26593,8153,18440,14760,1444,172,1061,36,157
92264,19254,3576,15678,13425,451,89,978,25,90
92266,198,44,154,130,4,3,1,0,1
92267,86,4,82,74,0,0,0,0,3
92268,489,39,450,420,2,4,3,0,7
92270,16999,2260,14739,13032,311,50,727,27,90
92273,1694,1499,195,123,31,6,11,0,7
92274,19251,17370,1881,1206,94,204,125,10,76
92275,1390,1007,383,309,16,8,10,0,5
92276,7953,4721,3232,2751,91,27,193,0,19
92277,23988,5608,18380,12895,1939,183,1066,332,180
92278,6371,1614,4757,2715,1077,106,640,11,53
92280,26,5,21,14,1,3,0,0,1
92281,2122,1860,262,232,10,0,5,0,0
92282,1350,645,705,527,54,15,30,9,1
92283,2695,931,1764,374,8,1247,9,2,23
92284,25931,5854,20077,17013,758,189,644,68,108
92285,2769,599,2170,1768,85,24,109,5,21
92301,38912,24669,14243,4503,7052,91,981,240,276
92304,17,9,8,6,0,0,1,0,0
92305,581,127,454,408,5,2,7,0,1
92307,41649,15389,26260,19068,3219,232,1218,119,292
92308,42469,15885,26584,20022,2937,170,1394,110,195
92309,452,345,107,76,2,4,8,5,1
92310,8102,2141,5961,3559,1066,90,508,145,55
92311,34524,15353,19171,10265,5238,400,863,371,197
92313,13150,6297,6853,4497,828,47,813,40,142
92314,10411,2377,8034,7162,71,71,110,26,65
92315,5148,1244,3904,3455,47,21,105,6,45
92316,31463,26422,5041,2959,1069,75,439,61,104
92317,1089,260,829,777,9,6,12,0,8
92320,10036,2901,7135,6167,166,51,276,12,38
92321,1310,436,874,789,15,1,11,1,7
92322,1441,281,1160,1015,17,5,15,2,11
92324,58626,43221,15405,6584,4542,182,2573,125,277
92325,9892,2458,7434,6540,115,63,157,8,72
92327,484,144,340,274,12,14,5,7,0
92328,640,122,518,440,16,20,10,1,9
92332,97,24,73,56,2,2,10,0,0
92333,510,72,438,387,11,2,11,0,2
92335,96605,80787,15818,7754,4064,221,2076,244,448
92336,100594,55881,44713,16648,11314,230,12746,179,670
92337,36394,26574,9820,2986,2995,79,2779,66,240
92338,0,0,0,0,0,0,0,0,0
92339,1053,178,875,801,6,1,10,0,7
92341,458,50,408,360,11,4,11,2,1
92342,6955,1946,5009,3808,435,31,308,20,48
92344,23166,12214,10952,7444,1455,140,906,29,146
92345,86499,50473,36026,26776,4036,359,1557,182,476
92346,57812,28644,29168,15999,5571,243,4820,178,258
92347,888,414,474,384,14,6,17,5,14
92350,258,54,204,76,31,0,84,0,5
92352,7038,1307,5731,5166,61,23,112,14,49
92354,22626,6374,16252,6306,2008,51,6539,66,152
92356,6050,2019,4031,3292,141,53,175,10,47
92358,834,219,615,521,23,3,38,1,10
92359,8900,3679,5221,3943,337,36,412,31,24
92363,5634,1374,4260,3149,119,633,64,17,31
92364,40,6,34,28,2,1,0,0,2
92365,2214,563,1651,1339,54,27,123,10,8
92368,858,528,330,254,11,10,11,0,0
92369,1481,515,966,457,418,2,75,4,7
92371,16345,6394,9951,8119,249,114,732,43,97
92372,5594,1637,3957,3425,24,26,258,2,40
92373,35348,8610,26738,19350,1561,110,3727,53,174
92374,43587,18868,24719,15873,2325,162,4098,139,234
92376,84548,65929,18619,6089,8625,201,1749,266,333
92377,20734,12543,8191,3480,3222,73,648,61,162
92378,677,292,385,362,1,2,1,1,7
92382,5721,1144,4577,4037,55,34,85,15,47
92384,24,2,22,17,0,2,0,0,0
92385,221,28,193,166,3,0,6,0,4
92386,2477,515,1962,1698,22,12,34,2,30
92389,123,6,117,104,0,2,1,0,0
92391,2239,763,1476,1312,23,14,40,3,6
92392,62294,35028,27266,12292,9248,217,2437,227,474
92394,41057,22973,18084,5858,8222,291,1740,267,251
92395,47556,23071,24485,13700,6366,221,1895,218,313
92397,5485,950,4535,4048,25,36,124,1,46
92398,1234,341,893,752,42,12,17,6,1
92399,55794,19039,36755,31411,800,273,1564,83,311
92401,2016,1217,799,201,432,2,74,16,8
92404,64270,42342,21928,10058,7939,254,1471,273,335
92405,32165,22778,9387,4239,3439,135,518,88,202
92407,67814,41703,26111,12574,7769,184,3256,136,398
92408,13488,8007,5481,1506,1221,54,2257,66,59
92410,51651,40563,11088,3633,4896,128,1396,112,234
92411,27014,22335,4679,766,2814,73,518,98,93
92415,2,0,2,0,2,0,0,0,0
92501,22017,12775,9242,5730,1516,91,977,70,139
92503,90011,55496,34515,20176,3984,337,6952,261,439
92504,54642,30849,23793,16280,2881,211,2414,142,301
92505,50919,31881,19038,10360,2771,148,3806,253,276
92506,45185,16364,28821,22073,2009,142,2206,108,247
92507,63191,32334,30857,15320,5536,329,6991,129,411
92508,35415,12116,23299,14081,2726,75,4406,92,176
92509,78166,57488,20678,13702,2378,175,2430,172,410
92518,806,188,618,408,117,2,54,4,10
92521,40,20,20,3,0,0,14,0,1
92530,59098,33506,25592,17975,2529,224,2301,207,262
92532,27560,11236,16324,9440,2302,89,2909,86,173
92536,3737,808,2929,2415,34,80,165,3,24
92539,4966,1286,3680,2708,46,285,423,5,29
92543,39323,19815,19508,12716,3862,278,901,132,186
92544,50007,23329,26678,20410,2632,399,996,139,189
92545,44072,17862,26210,18312,3688,223,1835,144,216
92548,7408,4814,2594,2138,115,31,111,9,22
92549,4234,731,3503,3149,41,32,90,3,21
92551,34294,22487,11807,3055,5716,79,1679,153,229
92553,76761,53301,23460,7419,9880,166,3443,438,364
92555,43580,21664,21916,7243,8131,112,4282,175,312
92557,54549,31028,23521,10130,7880,181,2712,243,324
92561,1648,222,1426,1174,19,114,18,2,7
92562,64270,18772,45498,33260,2868,276,4769,249,338
92563,73224,22164,51060,30087,5193,288,10166,294,438
92567,9729,6309,3420,2817,136,24,106,27,35
92570,59015,43947,15068,9258,2965,203,1104,102,243
92571,59450,44683,14767,4507,6237,137,2246,160,358
92582,21161,12702,8459,4627,1853,155,982,96,88
92583,34674,20784,13890,8416,2650,736,739,136,169
92584,55517,19680,35837,24280,3487,206,4456,273,293
92585,24887,11713,13174,8571,1828,100,1328,86,161
92586,22188,6721,15467,12028,1519,94,840,85,90
92587,17529,5358,12171,10448,337,60,410,39,84
92590,4840,1658,3182,2308,191,31,369,11,24
92591,42021,12180,29841,20682,2025,178,4161,115,268
92592,79740,19847,59893,41304,2914,1050,8939,331,397
92595,34405,13453,20952,15445,1272,182,1920,174,203
92596,31081,10587,20494,12902,1966,133,3205,167,140
92602,29581,3031,26550,8365,520,12,16013,28,121
92603,20137,1435,18702,9495,169,23,7663,11,147
92604,27151,3199,23952,11609,363,26,10208,36,198
92606,23383,2805,20578,7681,565,24,10765,45,170
92610,12545,1738,10807,6059,172,30,3540,19,85
92612,31822,3733,28089,13558,721,38,11853,36,246
92614,28456,3490,24966,11723,690,27,10652,38,182
92617,25232,7625,17607,6555,1480,12,7549,9,90
92618,57488,5188,52300,19122,1079,66,28498,52,369
92620,64424,5353,59071,17948,1059,57,36524,86,267
92624,7170,1655,5515,4823,35,15,232,6,41
92625,12017,797,11220,9852,55,14,701,8,44
92626,50885,14761,36124,25532,783,108,6615,279,291
92627,61764,26166,35598,29154,528,124,2872,133,330
92629,25939,4641,21298,18640,233,51,1059,24,122
92630,66359,18816,47543,30517,1021,107,12116,123,306
92637,17644,939,16705,12206,158,9,3796,10,35
92646,56788,8167,48621,36903,388,113,7257,141,322
92647,60455,18027,42428,28352,929,129,9218,206,338
92648,46691,7704,38987,29748,467,136,5439,107,339
92649,34082,5477,28605,22028,322,62,3974,71,231
92651,24096,2223,21873,19255,183,25,987,18,130
92653,30077,7196,22881,16232,409,32,4418,44,160
92655,8878,2815,6063,1152,47,13,4630,16,25
92656,53473,10129,43344,29661,960,48,8806,152,336
92657,10294,733,9561,6449,73,8,2447,1,45
92660,36259,3433,32826,27215,300,30,3242,29,201
92661,3457,273,3184,2901,16,5,114,8,6
92662,2490,160,2330,2167,7,3,58,3,11
92663,20812,2816,17996,15824,179,40,881,32,110
92672,41067,8695,32372,28377,507,141,1199,103,201
92673,29642,4645,24997,21460,191,80,1486,40,169
92675,35203,13702,21501,18595,139,106,1195,22,148
92676,1997,286,1711,1476,7,13,77,5,13
92677,64355,10510,53845,42824,766,115,6306,67,344
92678,651,125,526,465,7,2,20,0,3
92679,31016,3969,27047,21335,388,47,3203,30,174
92683,90946,22367,68579,17980,856,149,46481,417,252
92688,44688,9991,34697,25089,737,67,5834,84,222
92691,47918,10695,37223,28564,581,65,5042,101,253
92692,46434,7721,38713,29402,575,52,5838,51,203
92694,36637,5148,31489,23989,368,57,4553,35,175
92697,0,0,0,0,0,0,0,0,0
92701,48789,42579,6210,3089,300,78,2095,53,175
92703,65621,50026,15595,2914,653,96,11217,93,178
92704,82841,58674,24167,6421,733,141,15438,203,204
92705,45902,19457,26445,19320,466,52,4469,110,197
92706,35621,25753,9868,5402,319,48,3327,84,109
92707,56456,46546,9910,4434,468,91,3988,135,172
92708,57192,8919,48273,22230,531,73,22573,130,236
92780,56034,29230,26804,15279,1130,80,8055,171,295
92782,29266,4681,24585,10651,527,23,11483,29,134
92801,63163,38760,24403,9328,2034,104,10862,259,318
92802,41914,26037,15877,6445,972,92,7167,192,177
92804,86127,41410,44717,16770,2610,185,22022,548,382
92805,74633,53122,21511,10130,1260,100,8261,191,194
92806,40649,23533,17116,9307,965,95,5442,124,171
92807,37627,9612,28015,18595,644,73,6637,82,212
92808,20056,3244,16812,10432,383,34,4815,22,95
92821,41335,11915,29420,16306,704,95,10424,52,205
92823,6010,1061,4949,1962,80,6,2659,2,25
92831,38953,15133,23820,13385,1032,78,7319,86,229
92832,26277,13744,12533,7045,650,75,3727,53,143
92833,52598,19580,33018,10552,851,93,19829,100,214
92835,25450,5644,19806,11016,427,43,7004,26,105
92840,54365,23749,30616,8139,552,72,20351,250,173
92841,34376,11293,23083,5567,364,41,15969,155,148
92843,45480,20150,25330,3468,277,66,20558,205,165
92844,23668,6379,17289,2337,231,19,14098,97,91
92845,16520,3432,13088,9041,173,21,2667,46,106
92860,26376,9501,16875,13222,1563,140,877,33,127
92861,5843,724,5119,3641,47,2,1116,5,13
92865,20859,8945,11914,7855,317,50,2724,42,67
92866,15935,6772,9163,7023,263,43,1113,26,79
92867,44927,17662,27265,18853,494,76,5708,96,239
92868,27127,14075,13052,7264,826,61,3835,108,140
92869,36349,13512,22837,15605,371,71,5084,68,168
92870,52749,19886,32863,19554,953,108,10046,69,219
92879,47243,26192,21051,11167,2717,153,5174,133,251
92880,75365,28968,46397,16686,5888,126,20190,223,425
92881,31590,11406,20184,12453,1561,111,4357,107,169
92882,67894,35002,32892,20532,2571,197,6854,180,338
92883,34836,11416,23420,14758,2619,77,4054,73,195
92886,50001,9199,40802,26475,499,63,11150,49,266
92887,20770,3545,17225,11095,315,39,4686,17,122
93001,33859,13948,19911,16867,529,126,759,29,217
93003,50558,16077,34481,28425,837,215,2113,100,289
93004,31942,11765,20177,16429,461,83,1470,40,175
93010,46223,14119,32104,23900,1207,82,4147,102,300
93012,37550,8036,29514,21847,658,79,4579,73,245
93013,16299,7273,9026,7884,112,38,377,9,100
93015,18789,14106,4683,3848,81,74,230,9,98
93021,38103,12753,25350,19377,591,53,3230,33,208
93022,6172,1778,4394,3912,17,25,82,5,41
93023,20937,4519,16418,14591,106,88,487,20,122
93030,59011,46196,12815,5614,1360,113,4392,120,200
93033,79539,67335,12204,4186,1015,126,5603,156,202
93035,28070,12857,15213,11383,691,91,1800,79,175
93036,48656,34293,14363,8111,1248,88,3378,149,239
93040,1927,1730,197,153,1,7,6,0,14
93041,22918,12835,10083,6772,817,108,1236,131,133
93042,17,2,15,9,2,0,0,0,0
93043,523,113,410,305,60,8,22,1,4
93060,33859,26897,6962,5903,99,80,228,14,124
93063,55076,14499,40577,30606,801,170,6014,68,313
93064,57,13,44,28,1,0,13,0,0
93065,73943,21885,52058,39480,1101,136,7347,111,416
93066,3141,1166,1975,1648,18,7,131,5,19
93067,734,114,620,545,4,1,26,4,3
93101,30513,14893,15620,12783,432,99,988,18,200
93103,20029,10147,9882,8338,243,74,469,9,113
93105,26003,6050,19953,17459,215,68,906,22,201
93106,5203,1183,4020,1951,50,1,1781,1,47
93108,11243,1014,10229,9297,66,38,274,19,61
93109,11041,2001,9040,7783,132,34,465,14,63
93110,16317,4948,11369,9371,174,52,817,36,96
93111,18468,4750,13718,11158,145,48,1453,20,106
93117,53430,16661,36769,23961,843,80,8863,27,335
93201,1260,1065,195,152,2,10,6,0,0
93202,4154,3107,1047,734,110,7,71,1,10
93203,20777,19385,1392,932,162,24,101,6,34
93204,13720,11560,2160,1729,102,76,83,13,37
93205,2081,220,1861,1644,21,35,22,2,13
93206,1940,1482,458,371,25,16,10,0,5
93207,311,18,293,257,0,11,7,0,2
93208,135,8,127,116,0,6,3,0,0
93210,18581,11946,6635,4992,669,117,382,31,71
93212,23138,16118,7020,3335,2881,197,188,36,82
93215,53626,40422,13204,2537,2699,160,7124,40,122
93218,979,826,153,107,1,2,23,0,5
93219,9324,8505,819,218,55,4,484,1,14
93220,214,100,114,89,7,0,4,1,0
93221,15024,6988,8036,7047,69,108,219,19,67
93222,2192,367,1825,1589,30,20,55,3,12
93223,10487,9197,1290,1037,32,42,47,0,33
93224,388,62,326,295,3,4,3,0,2
93225,4775,1072,3703,3341,30,29,76,4,16
93226,297,8,289,267,1,11,3,0,3
93227,137,117,20,11,5,0,0,0,1
93230,68412,36208,32204,23749,2701,422,2473,98,374
93234,6745,6450,295,171,29,11,52,0,8
93235,4651,4056,595,490,13,13,29,0,9
93237,169,31,138,127,0,1,2,0,4
93238,1603,163,1440,1295,11,16,24,1,10
93239,1376,1313,63,39,1,7,0,1,5
93240,5691,708,4983,4385,34,111,59,4,23
93241,15707,15082,625,459,13,18,42,0,32
93242,3073,2046,1027,928,22,12,18,2,7
93243,1386,470,916,787,17,5,29,0,15
93244,229,59,170,151,3,1,0,1,1
93245,38045,16415,21630,13437,2361,946,2601,181,189
93246,941,247,694,425,125,14,73,2,0
93247,18210,15386,2824,2192,59,60,241,17,69
93249,2590,2535,55,35,5,0,5,0,5
93250,14892,13993,899,568,83,20,130,4,42
93251,250,137,113,99,2,2,0,0,1
93252,1499,477,1022,881,14,30,15,2,9
93254,780,459,321,277,2,10,1,1,1
93255,630,88,542,460,0,33,3,2,3
93256,5754,4945,809,578,105,17,31,0,25
93257,79569,54462,25107,17925,445,1594,2875,231,354
93258,1921,1468,453,128,5,6,272,3,0
93260,221,15,206,186,3,1,0,0,2
93261,2513,2385,128,33,1,0,88,0,3
93262,20,3,17,15,0,0,0,0,1
93263,22341,17807,4534,3473,300,48,244,9,133
93265,4117,801,3316,2984,29,41,68,6,21
93266,1521,1206,315,249,17,12,2,0,11
93267,6119,4670,1449,1270,5,38,31,1,23
93268,18502,9022,9480,8256,180,143,168,52,75
93270,5637,4364,1273,1060,3,32,91,2,12
93271,1930,254,1676,1501,6,7,25,2,12
93272,3468,2785,683,620,13,6,3,0,11
93274,78493,49766,28727,22434,1827,393,1643,63,437
93276,177,24,153,131,2,0,0,0,3
93277,53196,25318,27878,22323,1052,404,1922,52,247
93280,28182,23755,4427,2505,1434,72,139,15,45
93283,1880,233,1647,1424,2,71,13,3,2
93285,2457,222,2235,1975,1,42,18,5,23
93286,9735,7581,2154,1785,42,56,78,1,39
93287,221,28,193,163,0,12,1,1,3
93291,63366,37129,26237,18481,848,247,4541,52,333
93292,43316,23218,20098,15818,598,273,1870,32,197
93301,14518,6887,7631,4590,1834,118,359,23,92
93304,50837,35492,15345,7642,4800,241,1150,43,270
93305,38392,29017,9375,5712,2239,226,260,18,130
93306,74623,49426,25197,18352,2416,511,1651,86,396
93307,88338,71268,17070,7942,5145,334,1957,50,409
93308,56037,16792,39245,33189,1555,551,910,58,317
93309,61079,30141,30938,19642,5902,384,2379,110,385
93311,52466,18894,33572,19668,2700,248,8497,65,328
93312,58714,17155,41559,32251,1519,355,4373,67,313
93313,58322,32598,25724,11244,3481,230,8844,92,374
93314,33619,9524,24095,19218,645,227,2174,23,214
93401,29877,5364,24513,20890,315,73,1320,38,161
93402,14500,2300,12200,10482,81,56,736,13,85
93405,23331,4222,19109,15616,238,54,1683,21,169
93407,462,67,395,301,8,3,67,1,4
93408,0,0,0,0,0,0,0,0,0
93409,3806,1209,2597,762,1687,29,41,15,5
93410,7929,1215,6714,5096,160,1,1094,0,141
93420,30540,5774,24766,21625,214,126,1008,16,134
93422,33041,6279,26762,23124,451,183,904,30,203
93424,1256,113,1143,1057,5,2,31,0,12
93426,1260,236,1024,912,6,23,11,0,19
93427,5864,1866,3998,3512,33,30,117,5,36
93428,5951,1312,4639,4270,10,14,95,4,28
93429,153,67,86,75,0,0,1,0,0
93430,2849,348,2501,2286,12,11,49,1,13
93432,1174,219,955,868,4,6,12,1,1
93433,12643,3962,8681,7209,131,66,511,18,84
93434,8120,7139,981,619,37,42,171,2,11
93436,56730,29014,27716,20376,2147,355,2030,159,233
93437,3560,800,2760,1851,314,14,215,36,20
93440,2048,1023,1025,896,8,28,23,1,8
93441,1295,240,1055,977,0,7,9,0,13
93442,11390,1869,9521,8449,79,46,324,19,55
93444,22293,8575,13718,11958,159,84,530,29,93
93445,7040,3358,3682,3110,57,36,134,12,39
93446,45979,14663,31316,27437,544,193,861,94,239
93449,8096,987,7109,6281,63,38,314,10,54
93450,541,370,171,144,3,3,4,3,1
93451,4820,2397,2423,2107,44,24,59,4,26
93452,522,324,198,168,1,2,13,0,2
93453,3045,559,2486,2244,8,23,28,0,23
93454,40994,28790,12204,8584,430,128,1749,64,266
93455,45282,17611,27671,22409,536,232,2050,66,199
93458,59927,51109,8818,4936,433,163,2414,21,195
93460,5728,1206,4522,4015,51,160,49,5,32
93461,1503,838,665,566,19,5,8,2,4
93463,8731,2250,6481,5886,66,31,132,3,43
93465,10121,1907,8214,7404,34,61,167,13,41
93501,5772,2423,3349,2002,938,56,78,6,53
93505,14880,5461,9419,4550,3382,84,377,46,96
93510,7591,2168,5423,4769,99,32,159,9,71
93512,243,36,207,159,1,20,1,1,6
93513,1870,296,1574,1032,2,441,14,2,5
93514,14361,3078,11283,8777,57,1458,226,8,64
93516,2114,558,1556,1151,168,28,44,5,11
93517,768,213,555,470,19,24,6,1,4
93518,1138,171,967,870,17,21,12,1,4
93519,64,8,56,45,2,1,3,0,0
93522,37,1,36,34,0,2,0,0,0
93523,3293,658,2635,1938,270,13,115,29,20
93524,80,20,60,24,12,0,7,1,0
93526,628,92,536,401,1,51,4,1,8
93527,2315,341,1974,1640,16,32,40,4,15
93528,113,7,106,89,0,0,8,0,0
93529,619,102,517,489,0,3,10,2,5
93530,71,13,58,51,0,0,0,0,0
93531,531,94,437,400,4,6,4,1,0
93532,2373,508,1865,1661,27,11,36,0,15
93534,43906,19204,24702,10758,9829,212,1705,54,330
93535,82149,44885,37264,14402,16560,335,2181,114,636
93536,74283,25514,48769,29002,10771,288,4321,115,532
93541,488,164,324,293,3,13,1,0,6
93543,14132,10114,4018,2867,607,38,124,5,60
93544,1126,353,773,638,49,5,34,0,0
93545,2072,777,1295,936,7,240,21,1,5
93546,8545,2626,5919,5345,35,18,120,18,51
93549,235,66,169,143,3,5,1,0,0
93550,82379,57071,25308,9681,11065,271,1751,134,492
93551,56001,22523,33478,19511,6194,176,4445,126,401
93552,42468,30120,12348,4418,5284,90,1258,32,289
93553,1921,693,1228,1006,66,9,37,3,14
93554,45,4,41,37,3,0,1,0,0
93555,32810,6948,25862,20257,1293,202,1525,165,173
93558,51,7,44,34,0,2,1,0,0
93560,21581,9235,12346,8079,2077,153,634,43,103
93561,31091,7105,23986,20926,422,214,568,34,215
93562,1633,354,1279,1044,86,22,15,1,12
93563,143,55,88,49,31,1,2,0,0
93581,3660,1790,1870,868,867,44,32,3,12
93591,7450,4879,2571,1716,479,38,56,10,54
93601,1858,190,1668,1504,1,20,16,1,19
93602,3402,397,3005,2462,16,254,31,6,15
93603,280,47,233,215,0,1,0,0,7
93604,627,69,558,510,1,4,3,0,2
93605,144,7,137,116,0,5,4,0,3
93606,1352,1182,170,48,0,1,114,2,2
93608,1173,1118,55,33,2,2,4,0,7
93609,5694,4073,1621,1126,23,28,328,0,19
93610,23859,11956,11903,8315,1924,206,541,42,105
93611,47041,13081,33960,24647,896,259,5448,74,254
93612,37368,15208,22160,15225,1188,363,3342,157,205
93614,11574,1660,9914,8506,68,346,215,6,78
93615,5373,5036,337,208,7,0,81,0,18
93616,2225,1797,428,251,13,2,130,0,2
93618,30709,26218,4491,3363,81,59,521,23,123
93619,50032,10879,39153,27333,1058,242,7742,49,308
93620,10311,7189,3122,2497,252,28,67,12,42
93621,520,64,456,370,18,37,5,0,0
93622,9884,9005,879,731,39,9,18,4,38
93623,75,12,63,51,1,4,0,0,2
93624,806,771,35,26,0,1,3,0,0
93625,8194,5266,2928,1558,99,37,1044,0,59
93626,2132,397,1735,1333,47,61,134,5,2
93627,188,152,36,27,0,0,4,0,3
93628,329,41,288,273,1,0,4,2,1
93630,21103,16056,5047,3187,82,63,1325,7,117
93631,16843,8220,8623,7298,62,60,529,16,107
93633,37,6,31,24,0,0,0,0,1
93634,55,11,44,36,1,1,1,1,0
93635,48510,35531,12979,8908,964,162,1397,281,244
93636,14004,4817,9187,7615,193,75,569,13,67
93637,40202,29033,11169,7643,917,246,1341,30,241
93638,51106,43519,7587,4907,979,283,704,19,138
93640,13865,12986,879,484,202,55,45,1,41
93641,587,97,490,408,23,20,12,0,2
93643,3130,354,2776,2170,14,312,28,6,16
93644,7751,1056,6695,5907,22,157,131,3,36
93645,297,38,259,207,1,12,14,0,5
93646,10492,9761,731,526,26,13,83,5,7
93647,11143,9878,1265,396,11,12,722,0,31
93648,15393,14827,566,341,37,11,107,3,16
93650,3744,2429,1315,633,239,50,259,11,5
93651,1445,181,1264,1142,2,9,19,1,5
93652,410,366,44,33,3,0,6,0,0
93653,1050,152,898,719,7,43,19,1,14
93654,30620,23138,7482,5722,96,73,846,9,200
93656,6459,4795,1664,1362,57,26,49,2,21
93657,37464,26173,11291,8411,229,133,1669,32,149
93660,4173,3946,227,146,33,5,9,1,20
93662,30774,24297,6477,3998,184,111,1505,11,163
93664,614,85,529,463,1,8,9,1,10
93665,537,430,107,37,53,1,0,0,1
93666,668,615,53,37,3,0,1,0,7
93667,2294,279,2015,1687,12,138,29,0,22
93668,1054,882,172,145,4,1,1,1,7
93669,316,48,268,217,0,24,4,0,0
93670,80,77,3,3,0,0,0,0,0
93673,667,587,80,62,0,1,0,0,4
93675,3820,791,3029,2585,22,54,103,0,28
93701,12037,8535,3502,1058,956,153,945,3,61
93702,45741,35539,10202,2645,1689,258,4897,43,155
93703,34840,22483,12357,4281,1981,215,4931,35,163
93704,28573,12566,16007,11751,1294,209,1487,53,147
93705,38125,22762,15363,7922,3649,294,2102,60,184
93706,40965,26665,14300,4372,5538,251,3272,30,179
93710,30552,12658,17894,11115,2121,234,2859,67,179
93711,37901,10664,27237,20140,1657,141,3495,54,234
93720,47814,12027,35787,24552,1675,200,6788,41,294
93721,7899,4523,3376,1751,1016,81,219,20,23
93722,87364,42935,44429,18819,7221,562,14462,174,512
93723,12037,4842,7195,3116,487,33,3079,8,118
93725,26162,17897,8265,2529,1026,113,4049,33,133
93726,42366,22539,19827,9435,3033,379,5275,56,203
93727,83212,38613,44599,15884,4333,449,21051,90,431
93728,16191,9727,6464,4230,781,190,632,11,122
93730,13687,2216,11471,7540,214,39,2898,14,91
93737,6596,1958,4638,2327,97,35,1840,12,57
93740,1213,475,738,523,96,0,54,0,20
93741,84,49,35,32,1,0,2,0,0
93901,29700,17723,11977,8470,562,135,1533,74,144
93905,64209,59785,4424,1787,246,88,1692,44,203
93906,66381,50364,16017,7850,982,206,5178,201,303
93907,23315,13166,10149,7502,280,90,1267,73,125
93908,13188,3286,9902,8279,85,31,777,31,76
93920,1140,335,805,717,10,3,11,1,8
93921,2956,176,2780,2561,13,11,93,2,15
93923,12338,896,11442,10030,70,28,681,25,52
93924,6609,830,5779,5148,40,21,131,13,35
93925,1515,1302,213,195,0,3,4,0,0
93926,9187,8402,785,484,27,26,129,10,29
93927,19976,18492,1484,933,74,32,183,11,75
93928,259,61,198,124,23,3,23,9,8
93930,16206,13504,2702,2006,44,39,256,20,81
93932,533,154,379,332,10,2,10,2,4
93933,27218,8593,18625,9303,1608,72,4789,486,182
93940,30454,5565,24889,19401,721,98,2473,168,164
93943,55,10,45,27,3,1,5,0,0
93944,3395,512,2883,2247,187,14,195,51,3
93950,15082,2142,12940,10656,168,44,993,36,109
93953,4271,251,4020,3299,37,7,433,7,22
93954,371,330,41,32,0,0,1,2,0
93955,32703,15592,17111,9600,1779,129,3052,465,212
93960,26093,20606,5487,2300,1971,132,532,90,134
93962,692,232,460,386,3,2,16,6,5
94002,28513,3645,24868,13610,348,22,8344,132,300
94005,4836,863,3973,1941,88,10,1526,24,56
94010,44045,4888,39157,22652,338,22,12890,137,393
94014,48677,16144,32533,4662,1093,66,24697,329,300
94015,63489,11048,52441,9084,1414,63,38260,439,658
94018,3513,536,2977,2562,20,7,131,0,10
94019,15483,4868,10615,8922,96,22,847,21,54
94020,1732,280,1452,1290,8,5,60,7,10
94021,171,24,147,129,2,0,1,0,0
94022,20842,962,19880,11320,96,24,7067,37,111
94024,23263,1059,22204,12302,122,11,8225,24,166
94025,42354,7596,34758,23466,1082,35,7077,387,230
94027,7270,494,6776,4781,94,11,1415,45,22
94028,6904,449,6455,5311,24,0,577,2,33
94030,23212,2620,20592,6864,170,16,12155,216,173
94037,2811,389,2422,2063,14,0,129,5,23
94038,3176,1058,2118,1770,32,4,158,3,23
94040,36501,6120,30381,14825,472,21,12851,59,281
94041,15604,3160,12444,6577,249,21,4609,40,88
94043,31414,5152,26262,12076,523,66,11513,134,198
94044,38675,7378,31297,18757,684,101,8187,258,364
94060,1513,709,804,714,7,2,20,2,3
94061,36704,13485,23219,16563,500,37,3819,228,221
94062,26689,3911,22778,17950,255,26,2686,82,186
94063,35836,22342,13494,7596,698,85,3505,425,187
94065,12781,986,11795,5195,168,7,5547,37,88
94066,44147,12451,31696,13031,721,75,13927,1130,441
94070,31585,3508,28077,19243,263,43,5984,85,222
94074,282,59,223,192,0,1,8,0,2
94080,66592,21821,44771,12001,1186,129,27156,1005,521
94085,24031,6822,17209,4680,374,33,11060,103,152
94086,50175,8987,41188,13032,682,67,25180,109,261
94087,58344,4954,53390,19581,640,52,30325,96,294
94089,23255,4609,18646,5988,438,35,10987,131,132
94102,39432,8072,31360,13066,4985,255,10645,185,285
94103,37843,7659,30184,12624,3583,187,11462,154,283
94104,576,59,517,183,45,1,262,0,2
94105,14841,1273,13568,5790,628,18,6310,11,150
94107,34012,3837,30175,14946,1525,63,11049,168,301
94108,13097,984,12113,4037,259,19,7267,15,63
94109,58501,7338,51163,29372,2187,127,16082,110,397
94110,68336,22160,46176,28747,2142,105,10644,179,508
94111,4306,293,4013,1838,116,8,1836,14,32
94112,79314,22029,57285,11979,2402,81,39776,227,387
94114,33683,3587,30096,22134,598,44,4732,43,234
94115,35853,3330,32523,18738,3343,57,7781,107,279
94116,44092,3341,40751,14384,467,50,23236,44,270
94117,38451,4197,34254,24403,1771,45,5016,33,324
94118,42356,4035,38321,20865,899,24,13220,42,531
94121,43115,3545,39570,18142,706,48,17680,70,328
94122,57160,4757,52403,22287,892,57,25281,82,431
94123,26131,1985,24146,19248,254,37,3032,25,155
94124,39445,10564,28881,3298,9849,137,12935,862,290
94127,20686,2084,18602,10210,625,14,6152,24,160
94128,2,1,1,0,0,0,0,0,0
94129,3647,457,3190,2449,87,12,314,3,40
94130,2747,746,2001,762,441,25,537,32,29
94131,28810,3706,25104,15921,956,30,5913,42,256
94132,27723,4210,23513,7732,2167,53,11983,107,195
94133,26751,1818,24933,10566,610,10,12525,70,132
94134,41695,9276,32419,3883,2874,39,23733,538,166
94158,11327,1408,9919,3691,656,24,4811,56,119
94188,3,0,3,0,0,0,2,0,0
94301,17299,1150,16149,10268,300,10,4278,53,102
94303,48281,21056,27225,10037,3378,26,9594,2048,278
94304,4569,368,4201,2453,146,1,1347,7,15
94305,20961,2441,18520,10429,1049,23,5094,238,204
94306,28659,2500,26159,12840,545,24,10722,50,248
94401,35249,13370,21879,10303,804,60,7778,1035,322
94402,25879,3875,22004,12939,242,26,6795,180,139
94403,45057,9808,35249,17857,619,86,13239,420,442
94404,37323,2809,34514,12240,541,36,19306,193,279
94501,64116,8273,55843,27303,4019,168,18517,329,486
94502,14164,1162,13002,4849,380,5,6590,27,70
94503,22069,6779,15290,4589,1430,44,7644,146,105
94505,15445,2881,12564,9794,722,36,880,71,64
94506,25361,2011,23350,13389,400,30,7965,17,138
94507,15495,1139,14356,11487,115,16,1813,17,98
94508,3233,833,2400,1684,107,8,182,6,257
94509,69931,28840,41091,17708,12521,287,5702,902,470
94510,27174,4009,23165,16156,1328,62,3160,102,128
94511,2131,447,1684,1453,56,8,48,7,11
94512,86,23,63,62,0,0,0,0,0
94513,67394,18348,49046,31024,4259,173,8480,295,408
94514,1248,618,630,567,25,9,8,3,0
94515,6834,3083,3751,3387,26,24,125,7,18
94516,212,11,201,184,2,0,3,0,1
94517,12525,1518,11007,8794,210,23,1050,17,61
94518,27209,7035,20174,13468,837,76,3802,98,208
94519,18677,5123,13554,9024,536,34,2422,95,131
94520,38383,18606,19777,10225,1857,72,5254,296,286
94521,42885,8555,34330,22394,1356,117,7094,157,269
94523,35272,5025,30247,21020,889,91,5449,103,249
94525,3288,644,2644,1965,200,13,182,10,26
94526,33064,2943,30121,23556,243,44,4109,32,166
94528,1054,63,991,874,5,5,61,0,0
94530,26360,3160,23200,11644,1432,28,7751,51,319
94531,45342,13122,32220,8849,10744,132,8868,535,355
94533,77380,28490,48890,17628,12695,276,11880,834,434
94534,42296,8182,34114,16065,4149,97,10061,338,229
94535,4259,901,3358,2124,471,26,239,47,15
94536,73172,11979,61193,16269,2095,195,38326,382,485
94538,66424,12009,54415,11088,1648,170,38223,313,494
94539,54026,2181,51845,6556,471,61,43068,76,189
94541,69736,32883,36853,11513,7537,164,13125,1240,424
94542,15691,4101,11590,3963,1941,27,4504,199,73
94544,79769,37591,42178,8432,6022,177,21446,2655,441
94545,33786,10127,23659,4042,2192,65,14331,1398,193
94546,46687,9858,36829,18003,2578,111,12506,236,344
94547,26016,4320,21696,3688,4084,27,12037,141,224
94548,420,169,251,233,1,0,3,1,0
94549,28637,2341,26296,20257,225,22,3552,26,177
94550,49959,9082,40877,30224,846,109,6280,96,273
94551,40358,10331,30027,19924,772,96,6404,122,250
94552,14721,1517,13204,5280,552,13,6354,20,89
94553,49756,10187,39569,29041,1611,157,4859,161,282
94555,36887,2845,34042,4253,894,44,27259,196,147
94556,16134,1386,14748,10174,160,11,3071,20,72
94558,65473,23739,41734,36522,385,181,1594,80,346
94559,28137,11198,16939,14443,267,207,729,64,139
94560,47533,14362,33171,8945,1466,90,19603,657,248
94561,44545,16293,28252,17300,3538,116,4000,255,273
94562,1,1,0,0,0,0,0,0,0
94563,19496,1299,18197,13081,189,19,3363,16,114
94564,19024,5094,13930,5555,2050,63,4811,73,192
94565,100341,47218,53123,15092,14629,276,17237,959,654
94566,45055,4702,40353,21897,692,93,14829,57,282
94567,633,153,480,428,6,10,4,2,2
94568,72590,8352,64238,18149,2740,376,38858,202,340
94569,210,24,186,159,0,2,5,0,1
94571,10439,1736,8703,6642,812,57,602,42,37
94572,9622,2850,6772,2352,1399,30,2259,66,94
94573,96,55,41,37,0,0,0,0,0
94574,8317,2692,5625,5083,20,22,184,10,38
94575,933,276,657,398,42,2,112,19,3
94576,141,23,118,104,0,0,2,2,2
94577,48868,14973,33895,11025,5622,139,14284,316,237
94578,40957,14673,26284,6346,6835,113,10773,437,235
94579,21869,4731,17138,3780,1097,41,11308,178,67
94580,29590,10807,18783,5831,1608,70,9706,261,135
94582,49311,3127,46184,10949,1477,55,30987,99,204
94583,38444,4084,34360,16757,741,47,14295,80,243
94585,29764,8642,21122,7014,5414,109,5734,364,212
94586,943,147,796,631,4,1,107,6,7
94587,70121,15075,55046,7686,3004,113,40269,774,276
94588,36398,3354,33044,13424,645,48,16982,56,196
94589,32290,11602,20688,4035,6554,91,7877,398,226
94590,39981,12930,27051,10274,8783,196,4632,325,391
94591,56305,12664,43641,12583,9643,183,16583,563,434
94592,1082,178,904,377,106,2,321,11,9
94595,17716,1157,16559,13232,217,14,2182,22,93
94596,22861,2879,19982,14369,668,25,3333,50,137
94597,23661,2991,20670,13657,704,38,4427,34,215
94598,26826,2386,24440,17189,356,27,4792,35,198
94599,3540,376,3164,2929,60,15,70,2,6
94601,54166,28699,25467,5874,8201,244,8866,287,262
94602,29702,5052,24650,12049,4351,71,5690,139,175
94603,36681,22153,14528,1300,9413,95,2141,476,201
94605,44294,12874,31420,7205,17396,113,3429,400,312
94606,40768,9031,31737,7971,6502,171,14697,164,246
94607,31067,5180,25887,7644,8188,121,7538,276,272
94608,33073,4695,28378,11787,7536,56,6162,102,325
94609,23578,3275,20303,10641,4953,112,2320,133,221
94610,31261,3559,27702,15929,4242,37,4679,63,258
94611,40262,3555,36707,23607,3012,73,6293,53,310
94612,19773,2971,16802,5772,4392,78,5180,149,111
94613,346,90,256,135,55,3,32,0,1
94618,16946,1418,15528,11015,721,19,2195,22,106
94619,24867,5209,19658,7679,5034,79,4769,113,183
94621,35816,21090,14726,1833,9575,127,1716,332,166
94702,17637,2458,15179,8383,2569,30,2432,47,214
94703,20805,2761,18044,10564,2645,51,2897,26,202
94704,25259,4123,21136,9108,1173,48,8963,41,202
94705,13591,1183,12408,8961,468,21,1727,23,139
94706,21134,2764,18370,9453,744,17,6280,11,167
94707,12781,904,11877,9007,217,9,1486,7,105
94708,11553,744,10809,8185,214,0,1396,11,96
94709,12514,1325,11189,6316,492,10,3403,29,106
94710,9552,2119,7433,3827,1545,57,1150,77,111
94720,7478,1859,5619,2696,295,4,2200,0,21
94801,33486,21852,11634,3793,4656,67,1781,157,234
94803,26457,6778,19679,7677,3632,103,6004,139,342
94804,45108,19681,25427,7419,9596,101,5707,245,391
94805,14958,5166,9792,4579,1578,31,2408,86,231
94806,64589,32747,31842,6921,9927,121,11567,327,681
94901,43338,17293,26045,20807,610,126,2334,95,354
94903,30514,5567,24947,19609,558,49,2593,75,243
94904,12718,1383,11335,9498,150,10,724,14,133
94920,13010,798,12212,10355,113,12,865,15,101
94922,176,26,150,127,5,1,2,0,0
94923,1287,157,1130,1008,6,0,27,0,19
94924,1507,157,1350,1202,12,6,25,5,10
94925,10204,1088,9116,7410,72,8,807,14,103
94928,47062,13816,33246,24583,1035,245,4163,161,378
94929,227,12,215,203,0,0,6,0,1
94930,8729,988,7741,6700,104,20,277,18,69
94931,9119,2003,7116,5911,116,45,356,24,64
94933,1226,95,1131,994,16,2,32,0,12
94937,935,151,784,711,2,0,6,8,11
94938,683,68,615,530,1,10,6,0,9
94939,7465,558,6907,5859,67,14,416,6,63
94940,319,116,203,201,0,0,0,0,0
94941,31480,2237,29243,24507,270,44,2215,28,215
94945,17876,4154,13722,11055,348,42,1147,31,115
94946,624,110,514,464,3,1,12,0,8
94947,24870,5904,18966,15020,537,37,1770,47,197
94949,17588,4500,13088,10146,528,30,1332,32,128
94950,60,12,48,30,0,0,5,0,3
94951,4172,691,3481,3071,25,21,128,11,24
94952,33619,6222,27397,23951,317,128,846,99,200
94954,38301,9536,28765,23449,562,101,2188,86,260
94956,1684,296,1388,1271,9,1,34,6,7
94957,1858,91,1767,1643,1,0,32,0,11
94960,15920,1408,14512,12687,105,21,537,13,126
94963,506,38,468,413,8,2,6,5,5
94964,4264,939,3325,1277,1728,86,89,23,25
94965,11447,1075,10372,7950,866,17,852,21,68
94970,620,36,584,524,3,3,14,1,8
94971,372,43,329,303,1,5,4,0,1
94972,146,61,85,68,0,0,2,0,0
94973,1516,126,1390,1236,6,2,28,0,8
95002,2039,1143,896,319,19,3,486,8,7
95003,24706,4000,20706,18043,180,91,909,35,148
95004,4348,1879,2469,2089,21,11,111,5,66
95005,6551,728,5823,5202,27,30,113,4,47
95006,9454,1032,8422,7357,40,25,216,18,81
95007,883,94,789,685,9,11,15,1,13
95008,49038,9302,39736,22953,1191,104,12120,145,291
95010,9080,1929,7151,6030,91,25,412,5,67
95012,11858,10030,1828,1233,55,21,264,26,39
95013,108,54,54,36,1,2,5,0,0
95014,62585,2444,60141,13550,379,54,43887,26,241
95017,969,252,717,633,5,2,16,0,7
95018,8003,958,7045,6231,56,35,133,8,75
95019,6603,5694,909,685,37,14,81,4,12
95020,68090,37648,30442,19418,1222,177,6496,159,352
95023,56973,35924,21049,16547,417,192,1969,109,260
95030,13585,964,12621,9704,82,18,1972,6,80
95032,28109,2607,25502,17430,260,29,5879,29,174
95033,9565,885,8680,7394,49,17,517,10,75
95035,80440,10605,69835,7868,1579,100,57330,319,333
95037,53126,17695,35431,23787,972,149,7255,173,315
95039,1617,1096,521,403,13,4,48,1,9
95041,602,72,530,464,4,0,12,0,0
95043,709,237,472,418,5,5,10,3,1
95045,4323,2133,2190,1762,44,20,164,4,34
95046,6361,2996,3365,2604,44,9,407,17,25
95050,39031,9609,29422,13224,1003,63,12736,128,307
95051,61466,9476,51990,16589,973,89,31420,198,347
95053,2582,412,2170,1376,93,0,514,6,14
95054,25024,3121,21903,4955,666,35,15119,58,128
95060,47931,9845,38086,30232,778,222,3370,62,379
95062,36268,8844,27424,23054,387,119,1411,66,231
95064,8806,3632,5174,2395,690,5,1601,4,24
95065,8444,1721,6723,5770,75,18,281,9,56
95066,15483,1892,13591,11325,89,42,949,14,131
95070,32419,1292,31127,12194,106,24,17222,42,162
95073,10549,1830,8719,7651,58,24,336,13,61
95075,470,189,281,244,3,1,5,0,7
95076,84433,61415,23018,18033,330,217,2227,36,346
95110,20495,11275,9220,4451,678,85,3125,37,152
95111,60593,29065,31528,4875,1596,132,23352,266,213
95112,60754,26449,34305,14202,2499,206,14635,193,341
95113,2658,469,2189,880,278,9,841,8,17
95116,51222,31631,19591,3570,1008,115,13696,162,197
95117,30137,10756,19381,7848,1701,36,8257,202,192
95118,32764,8391,24373,14293,747,84,7166,110,168
95119,10050,2789,7261,3372,281,13,2967,27,68
95120,38341,2911,35430,17937,298,56,14769,35,155
95121,37609,10429,27180,2833,844,62,22520,117,143
95122,54056,31109,22947,1847,958,77,18951,296,195
95123,70040,20780,49260,23865,2550,121,18305,269,444
95124,50054,8459,41595,24321,730,75,13104,83,298
95125,54000,14442,39558,26528,1523,112,8196,142,301
95126,37372,12879,24493,12698,1955,97,7639,131,194
95127,63749,35501,28248,7802,1066,154,17289,216,273
95128,34776,12298,22478,11959,1312,83,6981,136,249
95129,41819,3047,38772,8728,503,38,27936,74,145
95130,13584,2481,11103,4868,351,14,5051,19,77
95131,30975,4639,26336,2903,694,62,21608,107,163
95132,40426,6050,34376,4908,650,37,27230,171,132
95133,30080,6677,23403,2399,619,52,19515,116,90
95134,29746,3920,25826,6307,795,28,17535,136,141
95135,20734,2152,18582,4927,342,20,12649,20,78
95136,45971,13431,32540,13232,2003,99,14631,143,278
95138,19530,3537,15993,4103,470,33,10511,59,90
95139,6764,1842,4922,2625,168,11,1576,32,42
95140,276,58,218,146,2,0,39,0,5
95148,45819,10616,35203,3696,1076,73,28907,197,150
95202,6949,3224,3725,1195,1614,47,452,20,27
95203,18064,9883,8181,3667,2099,168,1248,77,120
95204,30719,14280,16439,9702,2205,192,2474,154,157
95205,40720,30256,10464,3943,2577,187,2507,137,131
95206,69350,41431,27919,4402,8347,254,12229,486,317
95207,52465,21645,30820,12637,7416,180,7286,392,280
95209,44660,14344,30316,11464,4880,143,10800,356,238
95210,41378,14892,26486,4588,5264,150,14300,449,199
95211,1832,417,1415,770,483,0,102,24,1
95212,30111,8211,21900,4921,2064,83,13171,332,130
95215,27118,16799,10319,7113,1379,167,873,54,67
95219,29392,8182,21210,9911,3090,69,6150,175,197
95220,7241,2497,4744,4155,51,25,190,31,40
95221,549,53,496,445,5,1,3,3,0
95222,4888,636,4252,3813,41,66,56,8,16
95223,4050,350,3700,3380,6,12,62,4,18
95224,367,33,334,294,2,2,1,0,0
95225,605,87,518,462,3,8,11,0,0
95226,48,12,36,33,0,0,0,0,0
95227,1009,223,786,740,0,3,10,1,4
95228,4571,626,3945,3480,40,22,84,7,19
95230,786,276,510,442,5,5,5,0,9
95231,4808,3019,1789,974,426,5,266,13,10
95232,170,10,160,146,2,1,2,1,1
95233,363,30,333,304,1,5,0,0,0
95236,4476,1629,2847,2533,14,20,51,7,13
95237,3259,1131,2128,1892,17,7,43,11,21
95240,49102,22723,26379,18784,556,183,4790,80,240
95242,27341,6847,20494,16575,290,85,1904,63,128
95245,2126,179,1947,1758,10,21,21,5,7
95246,1307,112,1195,1036,4,13,22,5,13
95247,3963,351,3612,3286,10,35,38,4,36
95248,266,46,220,175,1,9,1,0,7
95249,3983,486,3497,3004,40,56,64,10,44
95251,753,93,660,599,3,9,4,2,8
95252,14260,2442,11818,10186,155,124,287,21,77
95253,286,162,124,119,0,0,1,3,0
95254,525,68,457,391,4,2,25,1,9
95255,1956,188,1768,1481,1,95,20,4,12
95257,454,34,420,358,2,12,6,0,3
95258,4054,1292,2762,2259,52,3,213,11,29
95301,40886,22361,18525,12952,1508,223,2177,70,183
95303,722,380,342,294,1,6,18,0,2
95304,16210,5374,10836,6493,1139,85,2080,74,97
95305,416,49,367,343,1,4,1,0,2
95306,936,136,800,708,5,9,10,0,9
95307,46346,29458,16888,10715,726,193,3522,271,160
95309,9,2,7,1,1,0,0,0,0
95310,1794,161,1633,1456,9,26,19,3,8
95311,1997,238,1759,1520,7,16,19,2,9
95312,251,147,104,87,0,3,11,0,2
95313,1351,745,606,537,4,4,8,0,8
95315,12875,9981,2894,2098,35,44,413,19,27
95316,7206,2553,4653,4108,28,28,79,7,38
95317,750,558,192,172,3,0,5,0,0
95318,413,46,367,306,3,11,9,1,7
95319,2130,1172,958,803,35,35,31,4,3
95320,13148,4383,8765,7675,46,52,197,7,54
95321,3745,363,3382,3014,29,21,54,11,26
95322,10381,6718,3663,3060,66,19,213,7,56
95323,1266,475,791,722,2,7,8,0,3
95324,7148,1784,5364,4934,7,35,82,2,21
95325,47,15,32,29,0,1,0,0,0
95326,10429,4356,6073,5299,61,59,202,12,51
95327,8837,2025,6812,5238,825,143,127,17,48
95328,3925,2731,1194,817,27,27,195,15,23
95329,2747,575,2172,1826,12,39,52,3,9
95330,29065,11571,17494,4963,2057,79,8590,336,211
95333,2752,1940,812,685,18,9,34,2,10
95334,16594,11348,5246,1702,98,63,3114,26,49
95335,412,23,389,349,0,3,5,0,1
95336,47281,20112,27169,18876,1459,288,3687,268,232
95337,44476,16801,27675,13872,2131,197,8668,383,372
95338,11019,1204,9815,8447,74,303,187,8,65
95340,38606,18039,20567,13953,1755,220,2913,56,251
95341,33194,23522,9672,4061,1408,131,3318,61,104
95345,633,144,489,395,4,35,13,0,8
95346,1106,89,1017,921,1,11,14,4,6
95348,35066,17341,17725,8689,1800,146,5406,60,179
95350,55344,21239,34105,24621,2004,382,3229,533,346
95351,48668,35089,13579,7490,1197,199,3054,226,228
95354,26765,12679,14086,10079,1060,214,941,218,173
95355,62337,20520,41817,28808,2464,284,5875,658,305
95356,33070,10372,22698,15012,1234,143,3944,450,191
95357,12692,5742,6950,5211,291,39,710,139,61
95358,32131,20686,11445,8557,516,119,1209,153,124
95360,13892,9312,4580,3541,324,34,232,40,46
95361,35019,9815,25204,21904,220,210,758,85,186
95363,29309,18090,11219,6131,1763,97,1764,322,181
95364,24,4,20,16,0,0,2,0,0
95365,4502,4179,323,174,51,5,33,11,11
95366,18239,4571,13668,11426,176,64,951,24,97
95367,25421,14185,11236,8399,474,84,1207,136,117
95368,13896,7631,6265,4472,329,30,682,134,41
95369,816,291,525,462,2,7,3,0,7
95370,28090,3115,24975,22209,96,299,457,51,167
95372,1838,243,1595,1426,6,18,16,5,13
95374,1856,1014,842,787,9,5,1,1,11
95375,113,4,109,98,0,1,0,0,0
95376,53781,24934,28847,14856,3040,190,7569,421,309
95377,34590,10034,24556,8913,2237,104,10454,430,265
95379,3816,434,3382,2884,6,218,27,11,7
95380,42912,22414,20498,15966,699,210,1876,145,226
95382,38702,11573,27129,20605,702,172,3555,133,157
95383,4157,394,3763,3415,5,32,24,7,31
95385,515,278,237,193,7,1,9,2,1
95386,10750,5027,5723,4811,135,41,130,33,72
95387,739,619,120,86,9,1,13,0,0
95388,13878,10419,3459,2407,165,55,548,8,36
95389,594,82,512,420,8,6,18,1,8
95391,24709,3253,21456,4678,1749,93,13310,153,189
95401,37272,14500,22772,17797,811,305,1692,156,184
95403,44705,15532,29173,22128,1029,399,2901,203,264
95404,38034,10129,27905,22657,638,225,2005,147,221
95405,22015,3805,18210,15318,342,101,843,218,105
95407,42504,24282,18222,12129,993,468,2698,210,224
95409,27741,4319,23422,19719,358,144,1563,148,137
95410,974,49,925,821,6,6,10,5,6
95412,275,78,197,170,0,9,0,0,7
95415,1496,744,752,673,7,9,8,0,0
95417,168,23,145,132,1,2,1,0,2
95419,192,9,183,143,4,2,8,0,4
95420,396,42,354,301,0,3,2,0,5
95421,1409,117,1292,1147,8,30,27,1,13
95422,17017,5436,11581,9395,558,300,167,23,93
95423,4232,586,3646,2924,107,100,84,2,31
95425,11252,4029,7223,6363,71,102,107,17,61
95426,1921,167,1754,1534,8,32,10,0,13
95427,492,67,425,364,0,6,1,2,3
95428,3017,720,2297,1118,8,964,15,1,10
95429,106,23,83,73,0,4,1,0,1
95430,45,0,45,44,0,0,0,0,0
95431,0,0,0,0,0,0,0,0,0
95432,443,73,370,320,3,2,10,0,4
95435,53,25,28,28,0,0,0,0,0
95436,5265,699,4566,4022,40,51,66,5,36
95437,14608,3300,11308,9843,134,140,213,18,104
95439,747,280,467,404,8,0,25,0,5
95441,1915,728,1187,1036,4,8,29,4,15
95442,2955,743,2212,1968,12,13,67,12,16
95443,134,11,123,98,14,0,5,0,0
95444,710,158,552,478,2,3,14,0,7
95445,2362,464,1898,1737,11,16,30,2,21
95446,4690,730,3960,3445,49,65,40,2,47
95448,16245,5010,11235,10109,64,84,205,20,96
95449,1422,406,1016,749,1,183,19,0,2
95450,372,48,324,278,1,4,10,2,8
95451,11747,2951,8796,7631,132,161,155,10,57
95452,1141,109,1032,916,6,1,18,4,7
95453,11978,2342,9636,8154,106,549,209,12,51
95454,2796,338,2458,2034,12,191,26,0,17
95456,798,50,748,697,11,0,8,0,3
95457,3231,668,2563,2194,55,56,34,7,25
95458,3394,600,2794,2343,39,92,62,8,24
95459,581,117,464,404,1,16,3,1,8
95460,2364,147,2217,2039,13,6,25,1,20
95461,2689,571,2118,1889,6,41,24,3,10
95462,1249,92,1157,1016,7,13,23,4,16
95463,218,18,200,186,0,2,2,0,0
95464,2725,465,2260,1643,46,266,60,10,21
95465,1959,152,1807,1652,2,5,22,0,12
95466,1219,520,699,634,8,6,7,2,4
95467,6031,1038,4993,4339,64,36,96,14,28
95468,1398,248,1150,920,8,119,6,2,12
95469,1855,345,1510,1341,6,17,5,0,17
95470,6041,1484,4557,3795,14,290,53,6,56
95471,677,88,589,517,12,5,9,0,6
95472,28430,3462,24968,22211,192,124,567,50,239
95476,34575,10549,24026,21437,177,104,820,67,130
95480,64,1,63,0,0,57,1,0,1
95482,33276,11786,21490,17306,258,1002,1093,55,197
95485,2671,533,2138,1784,17,100,31,0,25
95486,71,5,66,50,4,0,1,0,3
95488,240,17,223,190,0,2,11,0,3
95490,14227,2756,11471,9724,103,530,158,14,95
95492,27819,9269,18550,15863,223,196,753,55,101
95493,218,31,187,170,4,0,2,0,5
95494,291,108,183,155,0,0,5,0,1
95497,1159,101,1058,993,3,3,17,0,2
95501,23323,3629,19694,15029,479,793,1142,196,167
95503,24488,2902,21586,17344,270,745,1138,105,208
95511,268,48,220,177,1,17,2,1,2
95514,228,15,213,162,3,11,2,0,2
95519,18421,1818,16603,13543,155,795,266,26,138
95521,21581,3984,17597,14293,501,457,480,49,204
95524,1691,127,1564,1349,4,28,22,6,16
95525,1701,114,1587,1312,8,103,10,2,8
95526,520,47,473,374,0,19,5,0,7
95527,556,38,518,438,0,21,3,1,0
95528,996,71,925,796,3,37,2,0,10
95531,23223,4610,18613,13695,815,1351,786,23,103
95536,2753,318,2435,2178,10,40,24,0,21
95537,313,54,259,193,3,13,10,0,1
95538,635,51,584,498,1,51,6,0,3
95540,14055,2727,11328,9732,71,374,161,18,90
95542,2519,260,2259,1953,24,50,43,5,37
95543,738,59,679,560,6,41,5,1,4
95545,170,12,158,141,2,2,1,0,4
95546,3641,145,3496,357,2,2900,3,0,11
95547,1270,109,1161,1039,6,17,4,0,5
95548,1205,110,1095,468,18,450,5,3,2
95549,898,84,814,729,6,8,23,0,10
95550,151,14,137,102,2,7,3,1,4
95551,1871,315,1556,1124,42,240,14,3,18
95552,552,20,532,444,0,26,20,0,10
95553,1054,120,934,806,13,20,9,0,11
95554,297,30,267,228,0,10,0,0,3
95555,415,39,376,278,3,27,3,3,7
95556,650,33,617,314,2,240,4,2,7
95558,548,39,509,454,3,7,2,0,0
95559,163,30,133,124,2,0,3,0,2
95560,1548,256,1292,1089,26,16,12,1,11
95562,3475,490,2985,2560,28,103,26,1,17
95563,589,42,547,420,1,54,7,3,5
95564,438,28,410,329,8,16,6,7,5
95565,875,149,726,600,7,30,5,2,6
95567,1931,485,1446,1039,1,243,24,1,10
95568,164,24,140,82,3,35,0,1,6
95569,211,13,198,177,0,9,1,0,1
95570,2543,196,2347,1976,6,135,35,2,15
95571,297,55,242,200,21,7,0,2,0
95573,1750,151,1599,1193,10,173,19,4,23
95585,471,40,431,380,2,9,11,0,1
95587,144,7,137,121,0,1,6,0,3
95589,1648,148,1500,1304,7,20,17,0,18
95595,146,3,143,124,0,9,1,0,0
95601,284,30,254,221,1,9,0,0,8
95602,18364,2792,15572,14063,92,143,288,26,53
95603,28021,3347,24674,21739,222,255,575,36,165
95604,49,5,44,38,0,0,0,0,1
95605,14204,5897,8307,5303,637,99,1249,163,89
95606,243,64,179,150,2,2,2,1,1
95607,311,72,239,226,2,0,3,0,1
95608,65367,9263,56104,41832,3230,310,5190,288,406
95610,46592,9187,37405,30003,1786,279,1809,230,266
95612,1317,580,737,619,6,3,57,2,5
95613,135,12,123,106,0,2,0,0,2
95614,3891,348,3543,3196,16,42,55,5,16
95615,762,422,340,291,0,0,12,2,6
95616,51003,8810,42193,26492,1283,179,10564,215,323
95618,27472,4409,23063,13808,635,39,6474,42,197
95619,4816,836,3980,3536,19,60,44,2,41
95620,21439,9347,12092,9349,574,93,754,69,148
95621,42941,8369,34572,27491,1614,252,1878,192,265
95623,4267,523,3744,3361,17,50,66,3,27
95624,66575,12552,54023,23551,4811,254,19444,1014,413
95625,175,55,120,101,4,2,5,0,0
95626,5766,1115,4651,3870,101,45,248,22,35
95627,3899,2143,1756,1405,87,24,94,1,15
95628,42824,5751,37073,30611,947,197,2162,102,288
95629,1036,105,931,844,6,0,13,1,10
95630,74787,8431,66356,43911,1115,204,15641,170,467
95631,6362,512,5850,5219,19,96,47,10,39
95632,31470,13733,17737,14157,547,165,1159,87,122
95633,3017,240,2777,2480,6,15,29,8,28
95634,3109,352,2757,2416,46,35,21,3,21
95635,1236,108,1128,1027,9,7,16,0,9
95636,1109,98,1011,884,4,17,15,0,6
95637,322,80,242,215,9,0,5,0,2
95638,2295,558,1737,1425,43,20,94,1,9
95639,273,150,123,99,0,10,3,2,4
95640,12831,2689,10142,8072,1045,199,185,27,62
95641,2266,653,1613,1383,40,14,53,2,7
95642,7544,1089,6455,5676,59,127,146,8,43
95645,1715,1093,622,531,9,7,16,0,3
95646,188,7,181,158,6,5,5,0,1
95648,54483,10619,43864,36340,817,216,3149,130,205
95650,13446,1406,12040,10557,50,113,427,11,69
95651,763,64,699,602,4,8,20,2,12
95652,914,195,719,348,190,14,55,18,14
95653,579,506,73,59,2,1,5,2,0
95655,4767,849,3918,2298,452,19,628,41,60
95658,6532,628,5904,5252,27,53,131,4,62
95659,724,171,553,470,4,1,21,2,1
95660,35368,11645,23723,14782,3210,255,2507,319,236
95661,32847,5004,27843,21817,611,146,3042,74,183
95662,32688,4223,28465,24242,467,181,1037,74,244
95663,2905,264,2641,2310,12,29,73,5,20
95664,1329,108,1221,1092,1,10,32,2,9
95665,4657,508,4149,3689,50,45,47,16,48
95666,5398,503,4895,4398,22,70,60,9,31
95667,37283,4679,32604,29121,182,424,422,51,218
95668,872,177,695,572,8,9,45,4,2
95669,2431,469,1962,1748,8,37,23,9,17
95670,57988,12377,45611,28308,4632,275,7502,534,416
95671,5667,2072,3595,1061,2227,65,101,15,27
95672,4700,474,4226,3716,21,30,136,8,31
95673,16290,4367,11923,9427,359,107,875,73,76
95674,855,164,691,594,13,8,14,2,0
95675,390,34,356,314,1,12,6,1,6
95676,120,92,28,25,0,0,1,0,2
95677,28351,4261,24090,19318,484,151,1942,70,163
95678,45136,9400,35736,26811,1079,206,4063,207,242
95679,91,15,76,68,0,0,0,1,0
95680,121,62,59,53,4,0,0,0,0
95681,1324,326,998,878,8,9,11,0,2
95682,30233,4136,26097,23120,187,177,649,43,166
95683,6550,759,5791,4896,167,29,271,13,39
95684,3283,313,2970,2613,10,33,39,17,32
95685,4542,498,4044,3624,22,67,66,0,12
95686,1338,811,527,365,36,5,78,0,2
95687,69837,18421,51416,31140,7751,290,5873,481,473
95688,39571,10428,29143,20823,1760,133,3200,197,250
95689,1274,108,1166,1038,3,9,10,1,8
95690,2270,1136,1134,879,31,9,123,0,5
95691,39849,11417,28432,16903,1869,207,5898,418,292
95692,4975,1025,3950,3257,68,49,171,12,19
95693,7549,1509,6040,4813,161,70,407,29,43
95694,9629,4941,4688,3978,65,35,120,26,40
95695,38956,18287,20669,16630,548,237,1475,85,176
95697,396,297,99,80,0,8,2,0,0
95698,213,57,156,139,2,0,5,0,1
95699,175,8,167,148,0,0,1,1,5
95701,986,57,929,837,6,22,9,2,7
95703,1943,223,1720,1567,3,12,16,0,5
95709,4874,606,4268,3788,22,37,53,4,61
95713,9156,831,8325,7412,36,90,86,13,58
95714,360,26,334,308,1,0,3,1,0
95715,98,1,97,87,0,1,0,0,2
95717,243,26,217,185,0,3,8,2,0
95720,133,4,129,116,4,1,5,0,0
95721,32,6,26,23,0,0,2,0,0
95722,4682,399,4283,3941,10,21,36,2,35
95726,8985,950,8035,7031,45,73,132,8,53
95728,457,43,414,358,2,1,12,0,6
95735,87,11,76,71,0,0,4,0,0
95736,339,48,291,187,32,6,31,9,5
95742,16260,2256,14004,6422,1130,65,4870,118,97
95746,22166,1995,20171,16191,216,72,2179,23,114
95747,75019,10434,64585,44724,2004,239,12072,202,339
95757,55257,9235,46022,11816,6168,130,23097,763,342
95758,64517,13865,50652,18140,7588,173,18837,910,449
95762,47354,5106,42248,32135,652,98,5918,96,298
95765,43120,5663,37457,26760,704,143,6399,120,249
95776,26612,12951,13661,7797,491,111,3914,124,135
95811,12463,2838,9625,5682,1592,130,919,58,260
95814,12208,2487,9721,5593,1805,106,1265,58,104
95815,27838,12011,15827,7747,3577,257,2283,247,162
95816,18606,3533,15073,11568,669,58,1253,26,130
95817,14270,3695,10575,6291,1796,98,1141,63,136
95818,22375,4017,18358,12142,1812,90,2306,149,179
95819,20812,3205,17607,14280,415,88,1248,235,101
95820,36848,15450,21398,11282,3406,256,3870,423,196
95821,39310,7464,31846,19441,3355,234,4803,237,223
95822,45215,14569,30646,11332,6198,206,8903,1098,275
95823,81212,28302,52910,9362,15190,311,20920,2523,495
95824,31524,13748,17776,4101,2678,167,8701,882,135
95825,36081,8455,27626,14782,4569,137,4829,275,222
95826,39902,9995,29907,18115,3944,190,4141,303,279
95827,21566,4931,16635,10120,2269,88,2166,307,172
95828,63116,16818,46298,9884,7788,293,23418,1433,363
95829,32123,5696,26427,8101,2821,98,12764,525,138
95830,1015,238,777,430,44,9,181,14,17
95831,43099,7784,35315,14234,5278,136,11823,266,239
95832,11930,3883,8047,1010,2115,38,3708,533,62
95833,40195,15286,24909,10724,5575,219,5143,482,294
95834,35617,8886,26731,8232,5665,131,9632,541,254
95835,41399,7875,33524,11847,5487,102,12456,414,290
95837,242,33,209,183,1,1,12,0,2
95838,41340,15365,25975,8894,5910,220,7640,996,242
95841,21873,4121,17752,12287,2292,117,1280,131,135
95842,34196,8021,26175,16241,3917,164,2921,312,213
95843,48234,8312,39922,25082,3814,274,6712,388,275
95864,24249,3431,20818,16210,733,71,1921,74,183
95901,35840,10624,25216,17621,1405,486,2792,150,168
95903,2412,430,1982,1370,201,6,98,25,18
95910,64,4,60,51,0,0,0,0,2
95912,4942,3211,1731,1497,32,19,45,7,23
95913,369,114,255,239,0,9,0,0,0
95914,693,83,610,517,2,11,15,0,2
95915,52,11,41,33,0,7,0,0,1
95916,1680,113,1567,1265,20,81,48,2,12
95917,3264,1087,2177,1863,30,42,93,0,15
95918,2259,215,2044,1761,11,44,60,3,28
95919,1411,102,1309,1130,16,27,25,6,13
95920,267,99,168,154,2,3,1,2,1
95922,666,33,633,557,4,6,3,5,9
95923,53,4,49,39,0,0,2,2,0
95925,281,45,236,181,5,5,6,4,6
95926,41259,8588,32671,26888,829,289,1634,167,246
95928,38378,7615,30763,25354,658,430,1559,79,272
95929,0,0,0,0,0,0,0,0,0
95930,253,25,228,191,0,11,3,0,0
95932,7832,4246,3586,2907,66,200,96,39,17
95934,322,30,292,252,0,14,1,0,3
95935,750,98,652,505,4,22,15,1,6
95936,361,32,329,289,0,2,2,0,4
95937,1554,861,693,521,82,9,16,7,4
95938,3740,497,3243,2962,20,32,31,3,28
95939,545,57,488,281,16,167,0,2,0
95941,480,47,433,376,2,18,3,0,3
95942,1576,133,1443,1271,12,13,17,0,21
95943,774,115,659,610,1,11,2,0,9
95944,45,6,39,36,0,2,0,0,0
95945,26302,2703,23599,21085,119,197,340,35,180
95946,9964,852,9112,8225,43,58,129,14,58
95947,1583,128,1455,1209,8,124,2,3,11
95948,11603,5082,6521,5426,78,122,384,13,48
95949,20720,1576,19144,17256,84,151,296,24,91
95950,413,271,142,129,2,1,1,0,1
95951,2385,2025,360,248,16,10,45,3,7
95953,11357,5120,6237,4069,128,71,1392,42,45
95954,8556,740,7816,6974,37,96,99,9,46
95955,1403,718,685,625,5,14,5,3,3
95956,458,25,433,393,3,8,5,0,3
95957,669,168,501,456,0,9,3,0,2
95958,45,15,30,17,0,0,7,0,3
95959,18621,1347,17274,15649,97,142,228,18,149
95960,762,48,714,582,7,19,12,1,5
95961,30717,10805,19912,13476,1102,349,2386,165,186
95962,1316,97,1219,1113,8,13,23,0,9
95963,16250,7353,8897,7715,55,160,267,17,94
95965,21548,3319,18229,12663,435,520,2834,50,119
95966,31591,4690,26901,20841,655,934,1835,79,145
95968,1512,519,993,761,8,72,65,1,5
95969,5710,494,5216,4747,21,39,78,6,7
95970,535,146,389,346,0,22,2,1,9
95971,5672,454,5218,4604,56,80,44,7,46
95972,84,4,80,71,1,2,0,0,0
95973,39609,7049,32560,27450,507,350,1614,100,201
95974,142,17,125,115,3,0,1,0,0
95975,1702,104,1598,1420,8,28,21,5,21
95977,1797,176,1621,1442,10,20,19,2,6
95978,137,20,117,84,2,0,0,0,2
95979,519,54,465,398,28,7,4,2,9
95981,191,18,173,142,0,4,2,0,2
95982,3283,516,2767,2430,10,45,32,0,18
95983,401,31,370,327,1,14,3,0,2
95984,139,6,133,108,1,7,1,2,3
95986,121,1,120,112,1,3,0,0,0
95987,6270,4791,1479,1153,49,20,99,19,29
95988,8842,2991,5851,4908,50,170,315,15,36
95991,43345,16442,26903,17296,1077,414,5223,150,309
95993,37783,8366,29417,15201,536,303,11280,80,232
96001,33914,3512,30402,25609,463,735,895,65,164
96002,35158,4455,30703,24735,373,735,1974,78,204
96003,45185,4466,40719,34497,559,759,1671,63,285
96006,473,33,440,381,3,14,3,0,6
96007,24056,3230,20826,17555,159,645,640,45,133
96008,1237,113,1124,976,38,21,16,6,8
96009,481,72,409,376,3,4,3,0,5
96010,154,6,148,134,0,5,3,0,0
96011,148,11,137,100,0,13,2,0,3
96013,4020,479,3541,2995,8,215,23,6,12
96014,237,16,221,200,0,2,3,0,0
96015,364,47,317,276,5,5,3,0,3
96016,399,30,369,334,0,5,3,2,0
96017,169,19,150,135,2,1,0,0,4
96019,10491,957,9534,7973,76,287,251,14,80
96020,2407,177,2230,2052,3,18,29,2,4
96021,17123,7920,9203,7828,43,210,315,25,88
96022,16528,1810,14718,12778,71,331,273,7,74
96023,1102,361,741,628,3,15,21,0,0
96024,859,48,811,659,3,11,31,0,16
96025,2225,251,1974,1745,16,23,29,3,20
96027,1953,106,1847,1622,6,49,13,4,3
96028,1679,242,1437,1303,3,57,4,2,15
96029,138,23,115,88,1,6,2,0,6
96031,118,11,107,81,0,19,0,0,0
96032,2593,251,2342,1820,18,232,21,2,10
96033,429,25,404,359,3,2,7,0,11
96034,345,35,310,260,4,3,8,0,3
96035,3175,1402,1773,1537,11,56,34,4,11
96037,312,35,277,237,1,10,2,0,1
96038,586,43,543,455,8,9,9,0,7
96039,1037,82,955,558,6,279,6,1,23
96040,283,35,248,186,0,35,2,5,3
96041,5574,277,5297,3064,8,104,1923,7,19
96044,1015,84,931,787,2,44,17,1,19
96046,304,17,287,251,3,2,9,0,4
96047,888,59,829,716,4,19,8,11,3
96048,698,47,651,575,1,9,14,1,3
96050,476,42,434,362,3,19,15,0,3
96051,1136,72,1064,926,3,16,20,1,8
96052,1498,103,1395,1165,24,42,8,4,20
96054,288,19,269,243,0,7,1,0,2
96055,3951,928,3023,2672,13,72,28,2,18
96056,1444,256,1188,1078,7,36,10,2,8
96057,1202,96,1106,974,7,9,12,4,6
96058,659,266,393,334,4,13,17,0,3
96059,572,25,547,487,5,16,13,0,2
96061,90,20,70,54,0,0,0,0,0
96062,994,69,925,835,1,12,5,0,5
96063,125,6,119,111,2,4,0,0,0
96064,4387,400,3987,3409,22,120,141,1,25
96065,409,24,385,257,0,81,4,0,7
96067,7145,591,6554,5864,69,52,110,5,34
96068,185,53,132,85,26,10,1,1,0
96069,1052,84,968,877,1,13,8,2,5
96071,127,4,123,117,0,3,1,0,0
96073,4614,277,4337,3925,17,31,60,7,24
96074,312,75,237,175,35,14,3,0,0
96075,427,40,387,314,17,20,2,0,2
96076,276,26,250,196,7,5,16,1,6
96078,57,30,27,20,0,7,0,0,0
96080,29672,5992,23680,20554,209,565,438,59,132
96084,515,62,453,395,0,21,6,0,1
96085,63,1,62,47,0,6,0,1,2
96086,300,14,286,236,0,28,2,0,3
96087,547,36,511,436,0,18,10,2,2
96088,4781,305,4476,4037,13,107,54,9,27
96090,451,108,343,270,5,22,2,1,5
96091,574,26,548,493,3,7,4,0,5
96092,419,137,282,232,2,9,4,0,1
96093,4140,283,3857,3312,22,124,65,7,21
96094,6908,945,5963,4847,219,96,257,4,49
96096,763,59,704,606,5,14,21,1,3
96097,10131,1098,9033,7223,78,675,179,10,50
96101,5238,684,4554,3913,59,244,52,9,26
96103,1611,101,1510,1413,6,13,10,1,14
96104,613,83,530,486,0,16,0,0,6
96105,568,39,529,476,3,10,5,1,9
96106,522,3,519,501,1,2,3,1,0
96107,1100,186,914,811,7,56,11,0,2
96108,129,20,109,100,0,2,1,0,0
96109,888,71,817,699,8,9,9,1,4
96110,101,18,83,74,0,1,0,4,0
96111,80,3,77,66,0,0,0,0,0
96112,219,23,196,115,0,71,0,0,4
96113,1898,538,1360,909,239,96,42,1,7
96114,3101,289,2812,2529,4,47,19,4,12
96115,169,6,163,159,0,1,0,0,1
96116,150,30,120,101,0,4,4,0,0
96117,337,32,305,263,0,9,9,1,2
96118,1447,204,1243,1135,6,15,3,1,6
96119,82,20,62,47,0,0,3,0,0
96120,955,70,885,595,4,211,7,0,3
96121,334,16,318,284,1,4,4,0,5
96122,4070,721,3349,3010,12,56,25,19,14
96123,100,22,78,71,0,1,4,0,0
96124,343,21,322,306,0,0,0,0,1
96125,291,42,249,231,0,0,2,0,3
96126,273,31,242,221,0,0,0,0,2
96128,535,66,469,414,0,21,2,1,3
96129,266,41,225,199,4,6,2,0,0
96130,22121,6086,16035,11732,1945,678,361,268,95
96132,53,10,43,37,1,1,0,3,0
96133,175,61,114,96,1,6,0,0,0
96134,2028,1070,958,860,4,20,5,1,2
96135,82,6,76,71,0,0,0,0,0
96136,116,16,100,85,0,3,2,0,0
96137,3265,288,2977,2667,15,57,15,4,13
96140,1115,54,1061,998,3,5,12,4,4
96141,600,33,567,532,1,1,10,1,0
96142,973,45,928,837,2,2,2,1,4
96143,3965,1753,2212,1987,5,10,76,8,32
96145,3189,224,2965,2754,6,3,48,7,15
96146,1194,62,1132,1041,5,0,17,0,12
96148,993,361,632,587,0,3,9,0,2
96150,29518,7418,22100,18843,185,152,1362,24,180
96155,8,2,6,5,0,0,0,0,0
96161,19651,3415,16236,14834,35,48,315,16,113
96701,42833,3178,39655,4637,736,24,22786,3044,73
96703,2638,221,2417,565,6,1,121,875,6
96704,6818,652,6166,2830,47,21,914,874,30
96705,2536,262,2274,224,5,4,1376,138,7
96706,80299,9524,70775,10915,2177,77,34457,6186,246
96707,47181,6223,40958,7440,1303,81,14664,5172,187
96708,10993,1232,9761,6029,80,45,695,892,109
96710,650,46,604,280,3,5,139,28,8
96712,8259,778,7481,4042,39,33,941,534,89
96713,2264,142,2122,705,3,1,72,842,6
96714,1557,102,1455,970,1,12,92,155,7
96716,2784,231,2553,466,2,9,1058,345,6
96717,5441,476,4965,1172,24,5,405,1427,20
96719,2020,279,1741,685,6,2,268,205,8
96720,46615,5317,41298,7415,250,66,14005,6545,150
96722,2328,164,2164,1754,17,2,123,35,18
96725,4094,456,3638,1773,14,21,620,345,31
96726,136,22,114,32,1,0,4,47,0
96727,4990,436,4554,1419,26,14,1318,470,21
96728,606,91,515,195,6,2,110,36,11
96729,1358,61,1297,22,0,1,45,829,0
96730,1584,161,1423,572,22,0,139,199,5
96731,3309,224,3085,523,10,4,652,993,11
96732,27507,2371,25136,2604,117,31,14447,3468,98
96734,49922,5377,44545,21849,686,63,8007,2440,322
96737,4806,462,4344,2378,47,44,276,951,32
96738,7447,746,6701,3230,35,25,1163,834,26
96740,38234,3648,34586,16470,217,106,5462,4969,201
96741,6424,743,5681,2523,28,16,1293,402,26
96742,82,18,64,27,0,0,9,15,4
96743,13339,1151,12188,4584,33,43,1825,2060,70
96744,57746,5667,52079,11101,366,70,18120,5407,163
96746,19991,2391,17600,6747,119,56,4525,1739,92
96747,666,48,618,25,2,0,485,45,0
96748,4441,281,4160,712,14,4,657,1378,23
96749,20503,2681,17822,5995,132,77,4260,2326,116
96750,3806,430,3376,981,18,27,1136,405,16
96751,152,26,126,37,0,0,51,11,4
96752,3900,425,3475,660,8,3,1122,583,18
96753,27611,2869,24742,14369,256,81,4946,1575,149
96754,4378,415,3963,2347,21,8,696,189,33
96755,3613,541,3072,1053,17,12,794,392,11
96756,5766,634,5132,2333,29,13,1241,343,18
96757,768,54,714,114,0,3,157,165,6
96759,479,82,397,6,5,1,220,113,1
96760,3923,414,3509,1588,24,15,571,431,19
96761,23167,2754,20413,8538,192,61,6554,1804,139
96762,6316,305,6011,1357,24,11,924,2214,19
96763,3367,306,3061,475,14,7,1600,343,8
96764,649,77,572,283,5,4,106,47,2
96765,767,109,658,277,8,1,175,30,1
96766,16937,1389,15548,2866,89,24,7468,1415,40
96768,18512,2284,16228,6564,78,41,3105,1712,88
96769,296,17,279,29,1,1,90,121,0
96770,720,58,662,263,5,4,45,143,4
96771,8483,1242,7241,2757,75,30,704,1383,76
96772,2579,227,2352,1019,21,2,483,277,16
96773,412,34,378,225,5,2,58,20,1
96774,281,46,235,84,0,0,36,22,0
96776,1782,166,1616,638,12,10,338,109,1
96777,1559,189,1370,178,7,2,567,218,8
96778,14687,2055,12632,5500,114,83,1516,2137,105
96779,2992,350,2642,1406,26,20,425,209,25
96780,548,68,480,135,2,2,179,31,0
96781,1670,172,1498,468,5,1,509,173,2
96782,37437,3252,34185,3342,619,23,19335,2940,89
96783,2222,189,2033,447,5,0,690,461,12
96785,4125,429,3696,2039,32,33,296,387,25
96786,41217,7188,34029,9585,2795,92,10859,3579,131
96789,54732,5808,48924,7101,1051,50,24215,2423,137
96790,9115,797,8318,4027,37,29,1055,969,79
96791,7987,829,7158,2450,35,6,2500,387,41
96792,51965,7696,44269,4796,701,93,6959,15051,145
96793,31939,3355,28584,6098,188,72,9481,4637,88
96795,11064,1058,10006,1248,51,9,1338,3847,26
96796,2057,209,1848,367,16,5,580,319,7
96797,78109,4893,73216,3704,731,33,50400,7457,99
96813,27372,1903,25469,4640,308,38,13007,2348,62
96814,24870,1218,23652,3930,356,29,14779,1261,80
96815,28786,1985,26801,9894,563,55,11355,1018,180
96816,51586,2963,48623,8622,332,42,26323,3728,181
96817,56823,2751,54072,4344,472,38,34760,6646,126
96818,51851,5482,46369,13152,2865,83,20418,2731,145
96819,53334,2723,50611,3627,756,37,30883,8527,69
96820,16,2,14,12,0,0,0,0,0
96821,19727,915,18812,3927,75,9,10303,529,85
96822,42231,2758,39473,8056,561,35,20554,2615,165
96825,31147,1833,29314,7935,199,15,13804,901,75
96826,30092,2173,27919,4052,447,42,15610,3150,73
96848,475,46,429,169,28,0,97,69,0
96850,6,0,6,0,0,0,0,4,0
96853,347,60,287,228,15,2,25,0,1
96857,4058,1090,2968,2311,376,5,122,74,65
96858,424,77,347,271,15,0,31,4,2
96859,0,0,0,0,0,0,0,0,0
96860,5025,962,4063,3112,387,11,341,10,22
96863,2458,662,1796,1408,226,0,77,35,39
97001,131,12,119,113,0,0,0,0,1
97002,5874,946,4928,4522,24,37,58,6,17
97003,29270,6958,22312,14930,1100,123,3781,252,160
97004,4543,198,4345,3997,21,27,52,0,21
97005,26873,8067,18806,13923,759,129,2040,166,133
97006,46853,8239,38614,24197,1620,199,9104,298,268
97007,48280,5980,42300,30499,1124,161,6507,206,256
97008,29632,5571,24061,18923,717,85,2034,163,175
97009,8399,897,7502,6770,19,57,159,4,34
97011,652,51,601,544,0,6,2,2,5
97013,24512,4639,19873,17881,94,163,295,25,120
97014,1558,201,1357,1139,5,38,26,5,8
97015,23265,3202,20063,14829,421,120,2974,98,86
97016,6162,352,5810,5229,20,80,55,12,34
97017,2869,113,2756,2528,5,20,23,0,12
97018,1956,113,1843,1678,7,11,25,1,8
97019,3221,124,3097,2846,11,9,40,9,4
97020,1009,232,777,697,8,10,13,0,0
97021,1170,40,1130,1071,9,0,2,2,4
97022,3731,350,3381,3078,8,33,47,1,32
97023,11676,821,10855,9811,68,71,167,12,47
97024,11980,2824,9156,6835,584,109,686,121,46
97026,4076,2127,1949,1701,24,16,33,2,23
97027,12599,1263,11336,9922,113,82,267,54,63
97028,230,13,217,200,2,2,4,0,1
97029,328,11,317,297,0,1,0,0,0
97030,39492,8185,31307,24379,1639,372,1717,409,191
97031,19656,6019,13637,12102,38,94,332,24,103
97032,5188,1967,3221,2915,10,36,42,6,27
97033,85,0,85,82,0,0,0,0,0
97034,21396,1012,20384,17735,122,39,1189,29,94
97035,25770,1595,24175,19341,248,58,2581,43,154
97037,875,33,842,750,4,22,3,2,4
97038,17173,2094,15079,13670,59,112,132,44,107
97039,485,15,470,431,0,6,0,0,2
97040,1335,257,1078,974,3,9,11,0,11
97041,2894,947,1947,1782,4,17,28,4,9
97042,3134,134,3000,2762,10,27,43,3,6
97045,57403,4615,52788,47006,440,334,1106,101,327
97048,6965,305,6660,6047,35,90,45,9,21
97049,1810,92,1718,1571,1,14,13,6,20
97050,296,53,243,223,0,3,4,0,0
97051,17012,1157,15855,14011,121,202,195,43,117
97053,3463,164,3299,2999,7,36,27,9,32
97054,1494,67,1427,1264,1,24,19,0,9
97055,20606,1621,18985,17194,108,154,255,35,70
97056,12926,807,12119,10785,90,136,181,43,42
97057,30,2,28,23,0,2,0,0,0
97058,21124,4555,16569,14639,97,313,231,177,86
97060,21792,4353,17439,14269,441,134,1058,137,91
97062,29146,5210,23936,20051,321,86,1193,304,129
97063,1236,62,1174,1067,2,32,1,3,4
97064,3802,188,3614,3248,20,47,22,6,14
97065,676,40,636,577,0,9,3,0,1
97067,2146,209,1937,1790,11,16,14,2,10
97068,30712,1698,29014,24982,242,81,1488,37,162
97070,26443,3532,22911,19384,318,127,1331,103,104
97071,30777,17750,13027,11516,149,112,297,47,134
97078,25234,6738,18496,13457,818,112,2284,165,140
97080,45647,6656,38991,31884,1106,278,2520,184,188
97086,32612,3188,29424,20722,751,156,5497,204,186
97089,14111,1116,12995,11058,146,68,791,42,75
97101,4055,450,3605,3203,13,34,40,5,32
97102,305,10,295,272,1,0,2,0,5
97103,18080,1515,16565,14968,71,167,224,41,102
97106,4664,358,4306,3948,4,18,70,7,16
97107,1670,173,1497,1348,2,15,23,4,8
97108,563,56,507,454,2,3,1,0,1
97109,563,17,546,493,0,10,7,0,0
97110,1290,174,1116,1017,3,8,15,0,15
97111,3435,283,3152,2787,10,33,24,7,38
97112,2168,217,1951,1750,7,32,21,3,14
97113,15075,7366,7709,6559,125,84,273,53,58
97114,5008,1169,3839,3476,21,44,38,5,25
97115,4391,550,3841,3452,16,25,63,8,23
97116,29351,7467,21884,18886,258,137,737,70,128
97117,693,53,640,555,2,5,17,1,8
97118,825,42,783,712,5,10,7,1,2
97119,4722,462,4260,3804,11,25,71,4,19
97121,1539,115,1424,1244,9,13,14,5,14
97122,434,56,378,324,0,5,2,1,0
97123,48369,13866,34503,25894,1046,198,4108,219,253
97124,53487,9938,43549,31112,1237,236,7346,225,308
97125,216,14,202,180,0,3,5,0,0
97127,4432,1090,3342,2899,13,69,52,10,39
97128,38394,8571,29823,26556,201,309,495,94,222
97130,813,23,790,726,5,4,21,1,5
97131,2908,214,2694,2433,6,14,31,7,21
97132,32028,4174,27854,24777,245,165,584,50,168
97133,5577,535,5042,4106,65,31,383,7,41
97134,185,7,178,158,2,0,4,0,2
97135,959,53,906,840,2,13,4,1,4
97136,1948,71,1877,1685,2,12,30,6,19
97137,1360,349,1011,950,0,1,5,1,8
97138,11248,1389,9859,8875,105,88,156,21,45
97140,28365,2557,25808,22208,252,224,1254,90,105
97141,13951,2000,11951,10709,41,123,128,59,58
97144,188,8,180,164,1,2,0,0,0
97145,321,17,304,290,0,1,1,0,1
97146,7299,557,6742,6012,34,61,128,19,42
97147,422,13,409,375,1,6,3,2,5
97148,3589,218,3371,3110,6,13,25,2,14
97149,583,20,563,522,1,2,6,0,2
97201,17352,1438,15914,12102,529,100,1761,47,156
97202,43193,2940,40253,33709,729,152,2209,72,256
97203,33763,6195,27568,19724,2772,262,1578,373,212
97204,1001,114,887,599,153,16,33,2,7
97205,8593,819,7774,6132,341,72,562,9,68
97206,51072,5239,45833,35179,1369,289,4723,195,359
97208,22,1,21,6,6,2,1,0,1
97209,22755,2069,20686,16013,955,238,1677,59,145
97210,13016,993,12023,10071,228,47,743,24,99
97211,33762,3511,30251,21896,4234,182,1115,141,242
97212,26568,1762,24806,20038,1653,103,840,54,131
97213,31260,2263,28997,23484,1022,172,1885,53,179
97214,28403,2280,26123,21922,554,124,1185,31,236
97215,18221,1276,16945,14036,318,52,1006,48,158
97216,17488,2197,15291,10349,1280,177,2192,109,95
97217,36086,3912,32174,24487,2950,238,1251,252,271
97218,14748,3256,11492,8037,1501,118,763,80,95
97219,42474,2942,39532,32818,1165,181,1805,130,272
97220,29357,3890,25467,16823,2558,236,3262,324,183
97221,12821,734,12087,10243,219,31,577,15,77
97222,36316,4202,32114,27383,641,275,1004,138,222
97223,49967,6719,43248,34357,912,178,3717,435,235
97224,37365,4483,32882,26306,763,127,2879,348,175
97225,26247,2167,24080,20061,485,83,1588,58,126
97227,6058,666,5392,3895,676,46,273,10,38
97229,73602,5531,68071,40734,1250,170,20550,174,437
97230,41562,6767,34795,21612,4746,282,4624,718,234
97231,4399,321,4078,3519,28,41,191,9,28
97232,15382,1329,14053,11264,636,92,828,32,100
97233,41625,10493,31132,19415,3792,378,4510,579,187
97236,40193,6929,33264,20562,2912,296,6388,620,163
97239,18323,1248,17075,13740,378,260,1286,29,134
97258,0,0,0,0,0,0,0,0,0
97266,36095,5865,30230,18301,2238,359,6588,369,177
97267,31851,2982,28869,25109,453,190,882,71,152
97301,56393,20017,36376,29642,1067,652,1126,966,297
97302,39776,5109,34667,29895,470,344,900,304,209
97303,41441,9251,32190,27749,376,414,791,413,201
97304,34102,4793,29309,25136,402,320,1033,192,178
97305,44535,19608,24927,19171,562,401,1571,1195,176
97306,34715,3989,30726,25818,424,309,1475,334,168
97310,1150,142,1008,830,117,39,17,3,0
97317,25852,7282,18570,15880,332,235,537,302,157
97321,30291,2808,27483,24451,199,219,587,62,183
97322,37148,5942,31206,27550,274,400,536,113,152
97324,1100,59,1041,947,2,7,10,0,8
97325,7284,843,6441,5797,23,87,50,21,35
97326,827,53,774,701,1,20,7,1,3
97327,3053,95,2958,2689,18,20,38,3,26
97329,69,0,69,61,0,1,0,1,1
97330,43947,4179,39768,32293,463,228,3597,138,263
97331,4131,365,3766,3172,64,0,371,21,28
97333,22941,2221,20720,16647,267,122,1965,82,146
97335,180,3,177,167,0,0,3,0,0
97336,133,2,131,116,0,2,0,0,0
97338,22741,1649,21092,18979,69,391,221,23,105
97341,2659,158,2501,2254,17,35,37,7,9
97342,303,24,279,257,0,3,0,0,4
97343,524,19,505,434,0,19,2,0,1
97344,1189,52,1137,993,1,23,6,1,3
97345,669,17,652,586,1,13,7,3,2
97346,973,47,926,838,5,12,5,0,14
97347,2187,162,2025,1143,11,678,11,0,13
97348,1723,145,1578,1461,2,10,5,6,4
97350,215,24,191,175,0,2,0,0,0
97351,11292,3583,7709,6716,63,85,103,29,43
97352,6111,840,5271,4698,21,73,46,18,39
97355,32413,2126,30287,27363,124,341,321,77,150
97357,307,24,283,232,0,19,1,1,5
97358,2680,141,2539,2316,5,30,23,2,21
97360,2362,186,2176,1982,6,30,9,2,5
97361,13412,2299,11113,9570,129,138,304,93,53
97362,4397,1231,3166,2921,13,23,19,6,23
97364,513,42,471,366,0,55,11,0,2
97365,10806,1975,8831,7681,46,150,203,36,67
97366,1687,111,1576,1461,3,7,11,5,14
97367,11095,1290,9805,8574,68,231,212,22,56
97368,3566,248,3318,2967,0,97,21,0,8
97369,259,4,255,242,1,0,8,1,0
97370,9320,645,8675,7801,50,73,131,10,43
97371,719,53,666,598,4,13,3,2,1
97373,141,34,107,78,13,1,12,1,1
97374,5543,287,5256,4835,19,57,31,2,39
97375,1371,68,1303,1183,1,10,6,1,8
97376,1351,45,1306,1144,1,11,15,0,12
97377,958,49,909,838,4,4,13,0,6
97378,9195,1067,8128,6684,315,364,187,5,34
97380,2470,119,2351,1483,16,584,3,5,7
97381,16313,1908,14405,13228,76,117,95,14,80
97383,10079,1547,8532,7620,52,105,88,20,47
97384,69,8,61,54,0,0,0,0,0
97385,3552,191,3361,3096,12,21,29,5,21
97386,14611,732,13879,12510,41,176,86,16,83
97388,917,42,875,774,3,10,11,7,11
97389,1803,226,1577,1405,4,11,22,2,14
97390,662,9,653,604,2,9,0,0,6
97391,5610,338,5272,4554,10,182,33,1,36
97392,6092,524,5568,4971,14,72,91,8,39
97394,5361,244,5117,4538,17,80,44,8,22
97396,3426,254,3172,2659,6,215,24,7,31
97401,45634,4306,41328,33990,893,309,2461,154,258
97402,56610,8259,48351,40906,969,631,1119,181,368
97403,15275,1425,13850,11177,231,64,1021,36,99
97404,34345,3415,30930,27033,315,265,655,83,253
97405,46303,3161,43142,36949,533,297,1686,67,360
97406,177,14,163,126,0,8,3,0,6
97408,14655,1001,13654,11727,234,77,623,51,91
97410,783,46,737,654,0,8,11,4,1
97411,7572,416,7156,6495,27,73,66,7,35
97412,536,21,515,479,1,0,2,0,6
97413,1012,67,945,856,8,10,2,0,9
97414,237,9,228,214,2,1,0,1,0
97415,14648,1270,13378,11793,53,312,150,13,82
97416,976,27,949,822,2,8,3,1,4
97417,2175,143,2032,1744,21,55,72,3,16
97419,1239,92,1147,1036,12,10,8,0,18
97420,27454,2194,25260,21997,129,671,314,58,159
97423,6986,422,6564,5911,21,97,23,6,30
97424,18750,1607,17143,15328,63,186,168,27,108
97426,10521,779,9742,8767,26,112,82,12,59
97429,609,21,588,527,2,17,14,0,1
97430,397,23,374,314,1,9,6,0,2
97431,2420,121,2299,2059,7,42,11,5,12
97432,162,4,158,142,0,3,0,0,0
97434,849,38,811,662,2,8,5,3,6
97435,2326,113,2213,1955,5,27,12,0,11
97436,789,41,748,666,2,11,4,0,3
97437,2504,86,2418,2250,4,19,14,1,12
97438,1278,90,1188,1042,9,22,7,1,7
97439,15634,811,14823,13452,54,144,179,21,85
97441,268,17,251,230,1,2,2,2,1
97442,2096,140,1956,1745,4,42,7,0,16
97443,2138,95,2043,1764,3,42,4,2,14
97444,5471,287,5184,4696,16,105,43,6,11
97446,5067,485,4582,4160,9,46,24,11,21
97447,732,45,687,601,2,11,5,0,5
97448,13709,1108,12601,11437,75,92,128,11,69
97449,2225,97,2128,1945,5,37,4,2,9
97450,691,29,662,619,0,10,3,0,2
97451,397,14,383,344,2,3,1,1,3
97452,1613,87,1526,1373,4,18,5,2,18
97453,979,34,945,855,1,6,4,1,2
97454,1382,70,1312,1164,2,19,12,5,24
97455,2774,116,2658,2451,8,29,26,1,15
97456,3097,314,2783,2531,7,26,21,3,7
97457,10363,584,9779,8645,25,285,74,20,41
97458,4729,251,4478,3965,6,127,24,3,10
97459,14932,872,14060,12379,69,275,293,40,62
97461,739,34,705,632,1,7,7,2,5
97462,4130,198,3932,3532,14,53,34,0,44
97463,3886,234,3652,3198,63,61,23,4,28
97465,2134,66,2068,1893,7,23,13,6,21
97466,854,32,822,686,0,42,4,3,11
97467,5602,338,5264,4790,10,56,54,12,51
97469,2712,137,2575,2336,5,62,21,1,17
97470,20160,1460,18700,16758,81,290,214,46,100
97471,30900,1767,29133,26221,120,332,400,40,116
97473,326,20,306,283,0,4,1,0,1
97476,321,8,313,297,1,0,2,0,3
97477,37602,5409,32193,27892,490,388,574,139,201
97478,39155,4495,34660,30563,272,394,465,119,199
97479,10161,756,9405,8422,28,160,77,11,25
97480,338,18,320,281,0,6,3,0,1
97481,715,21,694,648,2,8,0,0,0
97484,242,12,230,198,2,4,5,0,0
97486,776,51,725,616,7,10,11,1,7
97487,9286,660,8626,7699,61,85,79,15,40
97488,1026,43,983,903,2,4,11,0,3
97489,848,47,801,734,1,11,7,0,9
97490,361,28,333,263,2,9,1,0,6
97492,651,35,616,554,2,6,3,0,2
97493,506,45,461,367,4,15,7,6,5
97494,24,0,24,21,0,2,0,0,0
97495,1706,95,1611,1415,5,31,57,0,5
97496,7875,397,7478,6700,38,136,87,4,38
97497,1460,105,1355,1220,1,8,15,3,7
97498,2251,159,2092,1890,3,23,31,0,20
97499,1961,110,1851,1664,2,25,14,2,8
97501,47519,10629,36890,32162,460,434,565,215,222
97502,29558,3338,26220,23419,147,239,340,94,145
97503,12349,3574,8775,7697,62,90,106,38,54
97504,49942,5899,44043,38207,387,324,1249,308,261
97520,25970,1908,24062,21101,254,149,512,69,358
97522,606,23,583,510,2,7,0,2,32
97523,6548,497,6051,5424,33,68,55,1,46
97524,15970,1400,14570,13095,73,140,128,22,124
97525,5392,353,5039,4479,25,88,40,9,35
97526,36561,2935,33626,30182,176,319,422,61,164
97527,36358,2988,33370,30003,115,399,313,55,227
97530,7464,404,7060,6453,18,39,71,4,47
97531,628,43,585,499,5,10,5,1,2
97532,2480,167,2313,2061,11,20,24,2,15
97534,664,59,605,528,0,6,1,0,8
97535,5015,812,4203,3706,47,46,66,7,21
97536,975,32,943,867,3,12,3,1,3
97537,7371,427,6944,6389,45,61,56,13,29
97538,2051,132,1919,1720,9,33,20,3,17
97539,3526,202,3324,3029,10,37,25,4,56
97540,8234,1233,7001,6252,33,52,115,16,83
97541,1593,60,1533,1384,0,32,8,2,8
97543,775,54,721,640,8,8,11,1,6
97544,2304,153,2151,1915,18,37,13,0,17
97601,23264,2761,20503,17464,209,755,342,37,179
97603,31302,4321,26981,23294,237,860,336,43,133
97604,8,0,8,8,0,0,0,0,0
97620,108,9,99,91,0,2,0,1,1
97621,334,34,300,215,5,47,0,0,4
97622,498,11,487,423,4,20,8,0,2
97623,2372,271,2101,1869,6,45,9,9,23
97624,3996,181,3815,2813,20,659,30,6,22
97625,186,24,162,149,0,1,0,1,1
97626,135,32,103,93,0,1,0,0,1
97627,734,36,698,619,2,18,8,0,2
97630,5389,654,4735,4170,49,83,42,5,19
97632,1378,460,918,845,2,22,2,2,4
97633,1350,491,859,777,4,6,8,4,13
97634,311,13,298,277,0,1,0,0,0
97635,285,23,262,237,0,7,1,0,4
97636,383,22,361,337,0,1,0,0,2
97637,70,5,65,60,0,0,0,0,0
97638,454,31,423,374,0,5,4,0,3
97639,231,17,214,187,2,12,2,0,2
97640,104,0,104,102,0,0,0,0,0
97641,1313,58,1255,1093,0,15,4,4,14
97701,42159,4178,37981,34132,212,222,614,65,256
97702,51161,4985,46176,41882,206,276,735,62,272
97703,32475,1554,30921,28465,112,116,433,35,185
97707,7833,317,7516,6953,20,50,55,7,39
97709,2,0,2,1,0,0,0,0,0
97710,127,6,121,117,0,0,0,0,0
97711,77,4,73,70,0,0,0,0,1
97712,47,5,42,36,0,1,0,0,0
97720,4518,237,4281,3799,5,186,29,0,17
97721,217,10,207,195,0,1,0,0,0
97722,89,5,84,80,0,0,0,0,0
97730,275,13,262,246,0,3,1,0,0
97731,257,14,243,203,1,1,3,1,3
97732,117,3,114,112,0,0,0,0,0
97733,893,25,868,793,1,10,3,0,1
97734,3167,656,2511,2224,5,59,17,1,7
97735,170,8,162,147,0,4,0,0,3
97736,74,10,64,56,0,1,0,0,0
97737,501,21,480,431,0,1,1,0,0
97738,2055,115,1940,1801,0,30,6,0,1
97739,13102,591,12511,11270,29,143,95,16,66
97741,13753,3933,9820,8306,115,622,97,14,41
97750,409,29,380,363,1,1,0,0,0
97751,103,10,93,88,0,1,0,0,0
97752,72,5,67,58,1,0,0,0,0
97753,2640,54,2586,2297,12,22,14,3,11
97754,21627,1705,19922,18207,62,237,98,20,86
97756,42168,5134,37034,33726,185,286,431,65,151
97758,123,4,119,109,0,0,1,0,3
97759,7787,350,7437,6848,15,52,57,8,42
97760,8071,396,7675,7075,17,73,28,2,44
97761,3348,260,3088,95,7,2833,1,4,2
97801,21882,2154,19728,16128,255,1852,203,35,86
97810,887,23,864,661,1,151,3,0,5
97812,940,57,883,807,0,23,5,8,1
97813,1386,70,1316,1185,1,34,4,0,12
97814,12780,671,12109,11215,63,122,64,12,66
97817,52,1,51,47,0,4,0,0,0
97818,4950,3261,1689,1508,20,21,4,1,19
97819,34,0,34,29,0,1,0,0,1
97820,1020,35,985,916,2,6,0,1,1
97823,1014,46,968,907,2,4,1,1,2
97824,1732,59,1673,1562,3,11,8,2,8
97825,253,15,238,225,0,1,0,1,0
97826,1116,127,989,912,3,12,6,1,5
97827,2713,91,2622,2323,4,17,13,2,9
97828,3283,113,3170,2939,7,14,13,4,15
97830,708,44,664,606,0,15,3,0,1
97833,953,47,906,823,0,23,0,2,14
97834,1061,32,1029,946,2,7,0,0,7
97835,373,21,352,325,2,6,2,0,1
97836,1985,134,1851,1740,6,9,9,0,2
97837,51,1,50,49,0,1,0,0,0
97838,28387,11409,16978,15103,134,183,337,73,81
97839,432,36,396,379,0,2,2,0,1
97840,128,3,125,121,0,0,0,0,0
97841,397,6,391,354,0,3,2,5,1
97842,203,12,191,169,0,2,0,0,4
97843,705,107,598,559,3,3,1,0,4
97844,4049,1438,2611,2359,9,49,13,4,18
97845,2653,96,2557,2320,6,30,20,6,15
97846,2018,68,1950,1820,2,17,10,0,12
97848,195,7,188,181,0,1,0,0,0
97850,17197,1035,16162,14133,128,157,173,478,89
97856,409,26,383,352,0,4,0,0,2
97857,514,18,496,462,0,0,5,0,2
97859,170,10,160,129,0,21,0,1,1
97862,11512,3996,7516,6861,46,61,73,9,44
97864,227,15,212,200,0,2,0,0,0
97865,1092,32,1060,1016,0,2,0,1,0
97867,773,50,723,677,1,5,3,0,4
97868,1756,78,1678,1486,6,84,0,1,7
97869,1028,48,980,905,0,7,3,1,0
97870,584,19,565,534,4,4,0,1,3
97873,221,6,215,201,0,0,0,0,0
97874,344,12,332,296,0,1,5,0,0
97875,2875,871,2004,1813,6,20,9,6,15
97876,863,25,838,772,0,7,1,1,1
97877,307,10,297,266,1,3,0,0,1
97880,241,6,235,221,1,3,0,0,2
97882,8271,3770,4501,3914,195,125,44,3,31
97883,2540,78,2462,2271,9,23,15,0,17
97884,154,9,145,134,0,2,0,0,5
97885,1370,46,1324,1206,0,16,3,0,21
97886,1241,89,1152,1041,2,15,4,1,5
97901,687,99,588,543,0,3,8,0,2
97902,24,0,24,24,0,0,0,0,0
97903,111,9,102,98,0,1,0,0,1
97904,181,5,176,168,0,1,1,0,0
97905,98,2,96,94,1,0,1,0,0
97906,267,16,251,234,0,4,1,0,0
97907,587,23,564,509,0,6,0,0,1
97908,75,7,68,64,0,1,0,0,0
97909,40,7,33,29,0,2,0,0,0
97910,591,45,546,515,0,0,6,3,0
97911,70,8,62,60,0,0,2,0,0
97913,5597,2667,2930,2668,6,24,37,1,21
97914,19534,6758,12776,11103,433,237,299,23,78
97917,10,2,8,8,0,0,0,0,0
97918,4514,696,3818,3586,8,23,32,13,13
97920,58,8,50,49,0,0,0,0,0
98001,36073,4722,31351,18990,2376,210,6396,706,219
98002,38474,9574,28900,17498,3000,708,3174,1730,226
98003,51751,11411,40340,18447,8464,313,7471,2066,286
98004,39136,2100,37036,19196,748,56,14720,63,191
98005,20961,1253,19708,9344,455,24,8588,34,121
98006,40871,1951,38920,17536,819,53,18040,43,237
98007,29476,3447,26029,9718,1238,54,13587,61,150
98008,26518,2483,24035,13511,663,70,8008,53,146
98010,5699,568,5131,4458,48,32,156,20,33
98011,27897,2830,25067,17711,583,102,4428,53,224
98012,74956,7018,67938,38829,2200,232,20807,291,500
98014,7651,561,7090,6115,58,33,306,15,61
98019,12284,1195,11089,9532,85,52,551,0,73
98020,20236,1073,19163,16153,266,80,1178,31,102
98021,34001,2226,31775,19281,516,137,9473,71,201
98022,22874,2108,20766,18532,134,343,227,58,111
98023,51713,9248,42465,22296,5713,271,7975,2006,312
98024,5141,335,4806,4247,21,46,138,9,23
98025,40,2,38,36,0,0,0,0,0
98026,38610,3352,35258,26099,1568,199,4290,189,221
98027,29089,2143,26946,20137,396,75,4182,48,179
98028,23914,2171,21743,15585,506,72,3559,71,168
98029,31432,2033,29399,15958,606,60,10720,38,132
98030,38933,5954,32979,14670,4768,142,9582,965,278
98031,43055,5505,37550,15316,5120,195,12925,963,245
98032,38744,9154,29590,13052,6056,267,6060,1402,230
98033,41763,2631,39132,27153,614,90,8137,77,303
98034,51464,4750,46714,32323,1238,167,8468,90,627
98036,42248,5464,36784,23096,2603,221,7455,214,231
98037,29584,3780,25804,14752,1914,138,6643,220,178
98038,37487,2828,34659,27494,875,162,2759,94,165
98039,2915,93,2822,1820,11,4,847,0,11
98040,25748,1175,24573,16383,275,30,5908,29,177
98042,49031,5538,43493,30342,2424,234,6159,410,267
98043,21285,2680,18605,12646,1107,149,2639,199,162
98045,15749,1023,14726,12956,91,122,439,30,64
98047,6966,1468,5498,3416,407,81,731,307,46
98050,223,6,217,205,0,0,4,0,0
98051,3802,193,3609,3232,14,27,62,4,33
98052,77176,5502,71674,34410,1601,186,30845,98,541
98053,22523,1294,21229,13453,322,33,6041,18,104
98055,24458,2825,21633,8890,3224,106,7235,275,116
98056,36344,6359,29985,15817,2430,118,8914,184,218
98057,13493,2140,11353,5063,2256,120,2556,137,124
98058,43630,5037,38593,22436,3468,181,8466,320,306
98059,41672,4430,37242,20641,1551,143,11525,145,206
98065,16292,1038,15254,11715,202,112,1932,15,59
98068,530,38,492,441,0,4,14,2,4
98070,11055,631,10424,9296,73,27,226,11,128
98072,24939,1893,23046,17665,310,76,3026,29,131
98074,30534,1483,29051,15810,350,45,11051,28,139
98075,26022,1315,24707,13389,313,42,9358,14,103
98077,13522,726,12796,10465,98,16,1158,9,98
98087,40711,5244,35467,18534,3418,169,9883,353,322
98092,50258,6615,43643,26968,3184,1678,7108,871,219
98101,16237,1309,14928,8837,973,136,3950,38,96
98102,25066,1935,23131,17338,654,74,3093,37,174
98103,53056,3657,49399,38021,1237,201,5483,68,320
98104,16157,1397,14760,7086,2205,174,4191,56,94
98105,49151,3611,45540,27524,1357,179,12601,99,280
98106,26295,3832,22463,12278,3046,221,4432,195,145
98107,28557,1926,26631,20653,557,126,2980,52,169
98108,25009,3091,21918,6766,4096,128,9136,130,116
98109,34551,2502,32049,18904,1377,139,9378,45,185
98110,24825,1140,23685,20899,122,80,824,33,152
98112,23152,1328,21824,17224,902,52,1775,15,129
98115,54322,3346,50976,37334,1305,152,7188,104,360
98116,27691,1834,25857,21170,597,112,1810,43,124
98117,35608,2062,33546,27314,466,123,2626,37,223
98118,47504,4415,43089,15526,10211,140,13522,240,304
98119,26238,2038,24200,18163,682,87,3166,59,155
98121,21411,1590,19821,10627,1158,96,6623,53,172
98122,41646,3785,37861,23690,4178,170,6150,146,262
98125,42965,4213,38752,23975,3739,198,7163,109,291
98126,23727,2056,21671,14374,2816,99,2301,100,147
98133,50720,5273,45447,28540,4204,325,8222,212,288
98134,1216,167,1049,577,168,48,112,13,14
98136,16424,1162,15262,12581,325,79,912,40,111
98144,32178,3600,28578,14186,4362,198,6935,89,160
98146,28845,6329,22516,12756,2364,214,4921,329,155
98148,11092,2749,8343,4701,1100,75,1388,269,52
98154,0,0,0,0,0,0,0,0,0
98155,35948,3003,32945,22740,1996,174,4999,89,225
98158,0,0,0,0,0,0,0,0,0
98164,176,5,171,123,5,2,29,0,2
98166,22152,3559,18593,14337,789,124,1569,184,125
98168,36389,8727,27662,11742,4683,264,7880,766,169
98174,0,0,0,0,0,0,0,0,0
98177,20160,1116,19044,15078,395,77,1930,29,122
98178,26122,2523,23599,6960,6469,175,7783,220,136
98188,27851,4917,22934,8059,6897,140,5499,837,132
98195,3710,468,3242,1685,108,18,1112,16,10
98198,38727,7391,31336,16779,5519,318,4914,1122,190
98199,22549,1571,20978,16635,320,67,2079,59,125
98201,30421,3672,26749,21024,1133,341,1431,435,172
98203,37491,5734,31757,23367,1482,282,3341,334,208
98204,44810,11450,33360,19020,4075,323,6264,716,208
98207,741,151,590,332,133,10,55,5,2
98208,60019,7969,52050,35581,2703,301,8572,459,353
98220,612,24,588,548,1,6,2,1,0
98221,22853,1277,21576,19239,125,174,490,42,138
98222,41,6,35,32,0,0,0,0,0
98223,45139,3922,41217,36010,317,518,994,161,231
98224,298,15,283,234,2,2,1,0,0
98225,49078,3968,45110,38292,644,396,1921,125,299
98226,47011,4545,42466,32234,484,3096,3264,140,270
98229,33664,2653,31011,26387,395,301,1361,84,174
98230,18754,1489,17265,14613,201,204,845,119,139
98232,4053,312,3741,3404,11,20,78,3,24
98233,16034,4468,11566,10047,123,151,352,58,86
98235,436,64,372,306,5,7,5,1,5
98236,6157,227,5930,5299,31,35,104,9,53
98237,4304,206,4098,3786,7,74,26,7,21
98238,83,18,65,63,0,0,1,0,0
98239,7394,475,6919,6012,82,33,160,35,67
98240,3118,330,2788,2545,8,30,64,2,16
98241,2344,112,2232,1900,8,101,17,2,9
98243,340,5,335,307,0,3,1,0,3
98244,3134,182,2952,2414,20,237,20,10,14
98245,4372,296,4076,3735,19,8,54,3,39
98247,9067,1749,7318,6245,43,321,158,3,60
98248,26784,3501,23283,19353,215,637,1253,113,171
98249,5056,212,4844,4336,36,23,76,22,36
98250,8632,727,7905,7158,24,43,117,10,53
98251,5071,520,4551,4064,43,50,49,4,11
98252,10645,792,9853,8684,78,115,180,28,60
98253,2037,68,1969,1804,3,10,33,2,9
98255,213,32,181,162,0,0,3,0,6
98256,446,31,415,340,2,7,3,0,17
98257,4467,195,4272,3182,21,753,55,3,14
98258,51995,5056,46939,38824,935,241,2431,221,271
98260,5844,224,5620,5100,23,30,91,7,51
98261,2752,182,2570,2374,3,27,29,5,12
98262,934,27,907,829,1,6,10,0,10
98263,186,9,177,155,0,1,1,0,0
98264,23170,3140,20030,17818,158,103,867,41,99
98266,4097,421,3676,3143,18,65,47,15,24
98267,545,36,509,445,5,13,7,1,5
98270,51969,7605,44364,33795,1248,766,4118,386,269
98271,32068,3701,28367,20669,613,2684,1434,206,156
98272,31127,4571,26556,22297,730,250,1006,43,190
98273,31243,9885,21358,18065,253,240,995,185,186
98274,18949,3785,15164,13441,112,122,486,19,74
98275,21642,1582,20060,13498,526,91,4215,53,169
98276,1434,213,1221,1096,2,7,14,3,19
98277,41517,4866,36651,27524,1747,290,3032,290,274
98278,1496,328,1168,731,242,3,105,9,7
98279,651,27,624,578,0,0,8,1,11
98280,474,12,462,415,0,6,7,2,4
98281,1191,57,1134,1013,3,3,51,4,7
98282,17356,718,16638,15050,101,119,315,40,65
98283,473,6,467,419,1,7,5,0,6
98284,27293,3583,23710,21071,139,470,292,73,162
98286,253,19,234,213,0,0,5,1,0
98288,344,18,326,269,3,3,8,3,0
98290,37535,2967,34568,30869,204,225,674,90,222
98292,24098,1723,22375,19853,188,216,386,63,156
98294,7494,1067,6427,5579,54,53,170,18,34
98295,2899,420,2479,2239,18,20,44,8,29
98296,27713,1811,25902,20598,301,127,2703,54,133
98297,142,9,133,119,2,4,0,0,0
98303,1302,62,1240,1063,12,15,29,2,10
98304,810,40,770,666,6,9,8,2,10
98305,481,17,464,395,0,11,8,4,10
98310,21580,2462,19118,13931,990,191,1690,369,134
98311,28059,2755,25304,17668,921,213,2803,588,164
98312,33405,3489,29916,23232,1312,317,1412,340,227
98314,991,217,774,519,114,12,35,15,6
98315,5482,1002,4480,3265,494,34,208,32,29
98320,1341,47,1294,1160,0,24,16,1,5
98321,16924,1048,15876,14165,89,163,203,34,106
98323,877,26,851,787,5,15,2,0,3
98325,1837,70,1767,1631,4,18,15,1,6
98326,1374,221,1153,721,187,117,5,0,4
98327,10222,1351,8871,5484,815,67,1331,117,79
98328,10727,574,10153,9019,65,112,113,34,57
98329,10960,672,10288,8920,84,85,188,50,70
98330,76,6,70,65,0,2,1,0,1
98331,5952,1008,4944,3914,88,476,51,9,24
98332,20704,1236,19468,16710,278,163,818,55,121
98333,3921,209,3712,3336,21,23,75,7,27
98335,27307,1808,25499,22188,268,121,883,101,166
98336,906,18,888,832,3,13,2,0,1
98337,9653,1474,8179,5684,953,75,555,99,48
98338,30147,2790,27357,22537,756,319,787,296,167
98339,3805,196,3609,3198,26,61,45,15,21
98340,2707,121,2586,2343,16,43,49,1,7
98342,1571,64,1507,1270,6,97,18,6,15
98345,576,49,527,451,20,3,16,1,1
98346,10402,750,9652,7707,65,741,223,23,57
98349,5000,312,4688,4060,44,62,57,17,45
98350,404,28,376,33,1,316,1,1,0
98351,1330,79,1251,1028,14,34,29,9,14
98353,25,5,20,8,0,0,0,4,0
98354,8264,886,7378,5701,294,68,497,128,39
98355,626,21,605,550,0,17,3,0,1
98356,2179,115,2064,1870,11,31,14,2,17
98357,1708,149,1559,131,4,1306,7,3,0
98358,995,23,972,910,1,3,5,1,0
98359,5358,315,5043,4346,38,57,97,45,60
98360,15332,1244,14088,11982,249,134,317,104,82
98361,1000,25,975,903,6,10,5,0,4
98362,23571,1138,22433,19741,133,491,404,39,126
98363,14086,671,13415,11055,84,903,172,20,106
98364,72,15,57,44,0,2,1,0,0
98365,5058,179,4879,4436,17,28,94,7,35
98366,36969,3095,33874,27026,877,362,1512,549,239
98367,30981,1977,29004,24141,404,256,1031,320,255
98368,16567,669,15898,14206,91,148,279,23,126
98370,32857,2627,30230,25738,303,479,1204,126,182
98371,23965,2377,21588,17132,722,325,1283,214,98
98372,26652,2537,24115,19137,848,233,1372,375,173
98373,28165,3092,25073,17746,1704,255,1949,579,181
98374,45367,5059,40308,30136,2105,418,2718,701,255
98375,33316,4986,28330,18581,2308,296,2716,876,199
98376,2130,49,2081,1870,7,23,27,0,35
98377,2103,96,2007,1824,4,32,15,0,7
98380,5297,276,5021,4388,47,38,87,20,64
98381,318,12,306,263,1,24,3,1,4
98382,30505,1560,28945,25716,134,504,589,37,159
98383,21565,2102,19463,14163,638,122,2154,226,129
98385,455,11,444,380,5,2,2,0,4
98387,51630,7152,44478,28848,4383,515,3031,2070,293
98388,7096,683,6413,4643,389,59,482,56,37
98390,11727,1570,10157,8473,177,87,347,119,62
98391,56427,4655,51772,43197,917,515,1804,307,327
98392,3092,238,2854,2081,18,369,95,12,13
98394,1194,55,1139,980,2,8,26,5,9
98396,649,34,615,544,1,4,5,2,10
98402,8053,901,7152,4649,963,157,601,122,56
98403,8341,692,7649,6138,370,36,338,28,47
98404,35172,7729,27443,12907,4008,933,5257,1081,232
98405,24617,2609,22008,14090,3338,304,1258,301,209
98406,22768,1545,21223,16891,1052,164,1045,103,147
98407,21931,1386,20545,16879,693,149,872,82,103
98408,20566,2907,17659,10401,2119,275,2041,415,163
98409,27840,4388,23452,12758,4046,329,2423,803,182
98416,1478,160,1318,1014,54,12,206,8,0
98418,10371,1503,8868,5505,962,127,818,249,64
98421,1239,627,612,280,86,27,131,23,4
98422,21343,2345,18998,12625,1310,274,2577,336,97
98424,12132,1771,10361,4914,1192,265,1842,920,63
98430,0,0,0,0,0,0,0,0,0
98433,20814,4945,15869,9846,2758,206,970,551,99
98438,582,113,469,305,83,1,21,7,4
98439,5474,1208,4266,2682,636,58,192,171,31
98443,5733,466,5267,4349,100,160,218,17,23
98444,36885,7508,29377,14915,4836,399,3666,1830,270
98445,33927,4932,28995,16933,3614,411,3055,1415,215
98446,12800,1514,11286,8151,735,165,721,264,81
98447,1053,101,952,636,49,6,126,7,3
98465,7524,675,6849,4744,590,55,662,108,41
98466,29769,2712,27057,18902,2602,169,2042,307,144
98467,16512,1715,14797,8775,1773,93,2347,214,70
98498,29982,3716,26266,16340,3101,227,2573,817,209
98499,33188,7354,25834,12721,4700,313,3218,1553,250
98501,45274,3605,41669,33815,905,357,2666,239,242
98502,35698,2836,32862,26008,1020,403,2318,177,218
98503,40346,4961,35385,25625,1979,390,2759,1011,233
98505,561,74,487,392,32,26,32,0,0
98506,19198,1472,17726,14655,380,173,798,104,144
98512,31422,2525,28897,24158,555,373,1236,158,173
98513,36059,4503,31556,22100,1700,837,2788,695,213
98516,29443,3407,26036,17793,1486,292,3311,435,144
98520,24086,3700,20386,16909,648,673,398,49,136
98524,3551,227,3324,2976,19,31,48,9,33
98526,276,64,212,142,1,41,2,0,1
98527,332,50,282,207,1,32,5,0,1
98528,11052,1215,9837,8541,97,126,142,59,71
98530,641,45,596,536,2,10,2,3,7
98531,26669,5046,21623,18893,240,278,312,61,123
98532,25572,2111,23461,21070,203,251,297,49,121
98533,558,13,545,505,0,9,2,0,9
98535,529,17,512,463,1,20,5,0,6
98536,153,11,142,121,3,6,1,1,1
98537,2181,153,2028,1809,4,58,36,3,17
98538,425,23,402,365,0,4,0,0,4
98539,164,5,159,139,0,5,0,0,0
98541,10509,1056,9453,8393,62,194,107,14,68
98542,668,51,617,538,1,16,7,6,6
98544,68,3,65,50,0,3,0,1,0
98546,3013,137,2876,2603,23,35,31,6,17
98547,1433,69,1364,1218,8,25,10,1,12
98548,2375,111,2264,1987,11,55,34,3,18
98550,11502,1271,10231,8685,89,459,118,17,61
98552,196,49,147,109,0,15,0,0,0
98555,586,30,556,491,1,5,19,2,5
98556,453,35,418,269,110,15,2,0,0
98557,3695,207,3488,3110,11,43,38,12,17
98558,134,34,100,91,0,0,1,0,1
98559,60,7,53,47,0,0,3,0,0
98560,154,1,153,139,0,3,3,0,0
98562,174,14,160,116,1,30,1,0,1
98563,8235,442,7793,6963,37,133,131,12,53
98564,2581,404,2177,1955,3,32,14,2,11
98565,448,51,397,348,7,0,8,2,0
98566,299,78,221,184,1,20,0,2,2
98568,2768,163,2605,1774,24,552,34,8,6
98569,6964,284,6680,5922,71,149,132,9,45
98570,4489,224,4265,3910,10,39,27,1,43
98571,483,20,463,387,1,37,4,2,3
98572,795,32,763,650,2,20,6,6,2
98575,129,8,121,102,0,7,4,2,0
98576,5388,335,5053,4441,45,59,75,18,33
98577,6708,753,5955,5129,19,157,219,9,32
98579,13648,1416,12232,10717,79,227,188,43,60
98580,12164,860,11304,9627,131,156,202,96,74
98581,421,6,415,379,1,3,3,2,0
98582,640,25,615,569,1,7,6,0,4
98583,144,10,134,115,0,2,0,0,0
98584,39266,5564,33702,28107,513,1608,410,121,228
98585,826,52,774,714,0,10,1,4,9
98586,1981,442,1539,1255,10,55,99,4,15
98587,1186,68,1118,59,9,1027,2,0,0
98588,1970,83,1887,1644,4,19,28,7,19
98589,8091,485,7606,6747,58,82,70,12,45
98590,376,18,358,250,2,78,3,0,5
98591,4419,228,4191,3761,21,97,33,3,14
98592,2090,123,1967,1763,9,39,32,5,15
98593,1185,83,1102,953,8,26,15,7,2
98595,2995,276,2719,2377,13,59,21,1,12
98596,6990,651,6339,5678,22,89,46,15,34
98597,27233,2882,24351,19978,532,369,613,344,259
98601,3312,134,3178,2989,6,20,25,12,30
98602,250,17,233,211,0,3,0,1,2
98603,1018,49,969,865,2,19,11,2,2
98604,38245,2615,35630,32084,252,201,621,107,186
98605,1267,349,918,798,4,42,11,6,6
98606,9868,502,9366,8511,41,37,147,20,54
98607,35054,2480,32574,26229,315,129,3259,102,156
98609,65,3,62,50,0,7,0,0,0
98610,3017,251,2766,2455,3,39,12,0,14
98611,10165,465,9700,8771,25,166,59,25,49
98612,3032,131,2901,2629,8,29,28,2,14
98613,543,24,519,470,0,7,5,0,8
98614,651,38,613,571,3,15,2,0,0
98616,200,10,190,176,0,0,2,0,0
98617,1183,130,1053,932,0,30,13,1,3
98619,465,35,430,372,1,42,2,0,0
98620,7655,522,7133,6376,28,224,47,17,38
98621,253,7,246,222,3,3,3,0,0
98623,41,0,41,39,0,0,0,0,0
98624,1305,122,1183,1036,5,24,14,2,5
98625,7413,456,6957,6299,35,66,78,14,31
98626,26291,2697,23594,20605,149,394,358,300,110
98628,356,13,343,294,0,5,2,0,8
98629,9586,508,9078,8294,22,53,111,29,50
98631,3704,269,3435,3108,13,35,40,8,10
98632,50721,5374,45347,39413,485,670,1052,271,198
98635,1865,120,1745,1570,8,39,3,4,15
98638,1555,102,1453,1276,25,13,24,6,6
98639,1397,115,1282,1046,46,55,12,13,10
98640,5140,284,4856,4444,12,61,36,5,30
98641,204,10,194,176,0,3,3,0,0
98642,23685,1734,21951,19185,199,137,765,86,146
98643,403,17,386,344,5,7,6,0,0
98644,887,74,813,722,8,7,6,4,1
98645,1811,48,1763,1637,3,23,9,4,3
98647,499,26,473,413,4,16,6,0,10
98648,3075,142,2933,2660,1,43,36,2,24
98649,1134,82,1052,916,1,16,10,5,13
98650,1158,82,1076,953,3,13,11,2,4
98651,872,106,766,697,3,7,7,2,9
98660,12735,1653,11082,9133,405,123,320,124,81
98661,48983,9407,39576,30872,1982,347,1796,1091,269
98662,37134,4838,32296,26169,980,210,1900,504,160
98663,15188,2108,13080,11009,358,125,345,96,106
98664,24120,3997,20123,16160,603,158,1128,366,91
98665,28780,4250,24530,19776,873,192,1237,339,142
98670,113,4,109,93,0,2,0,0,1
98671,24857,1732,23125,20399,219,152,518,67,110
98672,7370,1414,5956,5417,22,67,44,8,29
98673,371,13,358,283,0,37,1,1,0
98674,14415,1827,12588,11408,55,76,178,29,95
98675,7688,316,7372,6728,87,53,48,1,65
98682,65434,8913,56521,44887,1672,427,3962,993,309
98683,33884,4362,29522,22492,943,198,3145,369,144
98684,33659,4843,28816,22219,1049,190,2301,644,187
98685,29797,2363,27434,23303,489,151,1272,98,162
98686,21462,1926,19536,16537,362,135,1020,77,92
98801,44970,13743,31227,28265,178,258,563,70,194
98802,32378,9673,22705,20431,89,214,377,46,129
98811,76,3,73,61,0,1,6,1,0
98812,5161,3328,1833,1603,12,68,19,4,24
98813,2769,2247,522,403,8,61,2,0,8
98814,525,35,490,461,0,3,1,0,3
98815,7804,2168,5636,5185,15,27,66,13,62
98816,7067,1987,5080,4763,13,16,55,8,28
98817,366,226,140,126,0,1,5,0,3
98819,280,28,252,219,1,6,1,0,0
98821,434,209,225,206,0,5,1,0,0
98822,2253,496,1757,1599,1,22,12,7,1
98823,12393,3426,8967,8141,72,94,85,0,51
98824,160,131,29,26,1,0,1,0,0
98826,7280,566,6714,6256,24,36,36,2,48
98827,337,76,261,228,0,6,4,0,10
98828,2419,659,1760,1582,8,15,18,3,24
98829,716,173,543,370,0,142,0,2,6
98830,531,92,439,416,6,1,0,0,1
98831,3955,1363,2592,2445,6,18,12,0,18
98832,349,35,314,298,2,3,1,1,2
98833,240,8,232,214,0,3,8,0,0
98834,246,17,229,206,0,3,1,1,11
98836,515,94,421,382,1,4,2,2,1
98837,46262,14978,31284,27403,471,301,849,74,230
98840,4731,697,4034,3291,19,346,34,5,41
98841,8984,1318,7666,5102,54,1829,80,6,40
98843,2074,1017,1057,959,6,12,4,0,14
98844,4599,979,3620,3244,19,98,34,4,25
98845,138,14,124,124,0,0,0,0,0
98846,1074,361,713,652,3,10,12,0,1
98847,1885,567,1318,1205,7,5,11,2,2
98848,13392,8994,4398,3995,18,26,100,5,45
98849,1220,134,1086,978,7,25,5,0,11
98850,1964,976,988,874,9,7,10,9,15
98851,4472,781,3691,3356,15,43,45,4,14
98852,91,15,76,66,1,0,0,1,0
98853,79,3,76,74,2,0,0,0,0
98855,6115,1031,5084,4554,24,91,31,6,52
98856,2776,160,2616,2402,4,26,13,1,26
98857,3999,2349,1650,1498,18,14,25,1,6
98858,1620,182,1438,1328,0,18,8,0,23
98859,230,10,220,190,0,10,0,0,1
98860,259,26,233,218,2,0,0,0,0
98862,2764,88,2676,2517,7,5,17,7,17
98901,32351,17640,14711,12412,374,453,308,24,124
98902,47589,25255,22334,18641,569,709,470,59,213
98903,17491,6395,11096,9687,100,313,274,17,62
98908,38205,8924,29281,25907,330,330,743,52,212
98921,544,512,32,20,0,6,0,0,0
98922,6817,273,6544,6019,8,51,70,7,41
98923,1281,618,663,606,3,12,7,0,0
98925,608,69,539,485,0,1,2,2,8
98926,32085,3717,28368,24846,358,319,802,72,176
98930,15339,11982,3357,2946,23,64,69,3,37
98932,5409,4405,1004,752,11,168,10,0,13
98933,1292,579,713,298,11,335,9,0,6
98934,1164,235,929,869,3,4,3,0,4
98935,4049,3394,655,538,11,51,7,1,3
98936,6846,2995,3851,3369,42,78,64,9,34
98937,4423,781,3642,3364,14,42,16,0,13
98938,2112,1520,592,509,3,16,2,5,13
98939,194,111,83,47,2,24,0,0,1
98940,933,27,906,851,0,9,4,1,4
98941,988,55,933,875,5,3,9,0,2
98942,18511,3660,14851,13443,93,155,185,24,92
98943,574,21,553,491,0,12,0,0,3
98944,22412,18314,4098,3602,38,84,84,5,82
98946,488,25,463,434,1,2,3,3,3
98947,3133,1829,1304,1170,5,15,14,0,12
98948,13416,9540,3876,1325,24,2133,59,7,49
98950,209,144,65,49,4,1,1,0,1
98951,13821,8374,5447,1838,45,2775,428,6,48
98952,2347,571,1776,261,6,1394,8,1,7
98953,6841,3164,3677,3176,17,195,28,8,26
99001,8859,1032,7827,5763,439,357,364,184,41
99003,5302,169,5133,4696,15,42,36,10,56
99004,23064,2237,20827,17616,584,261,572,105,104
99005,10253,382,9871,8990,54,96,145,3,43
99006,13711,470,13241,12106,74,149,78,28,69
99008,634,12,622,574,2,5,1,0,11
99009,4096,149,3947,3676,9,24,20,1,21
99011,2695,531,2164,1614,167,9,67,21,14
99012,1018,29,989,887,0,20,5,0,8
99013,1914,80,1834,846,10,828,7,2,8
99014,72,8,64,47,0,2,3,0,0
99016,18496,976,17520,15704,108,99,459,46,89
99017,167,9,158,154,0,0,1,0,0
99018,285,12,273,249,0,8,1,0,1
99019,12813,694,12119,10930,89,86,327,22,54
99020,52,8,44,41,0,0,0,0,0
99021,9690,440,9250,8322,50,71,95,23,45
99022,8867,443,8424,7438,115,105,107,14,61
99023,685,19,666,620,2,0,6,0,3
99025,5272,220,5052,4626,17,31,60,5,27
99026,9347,326,9021,8134,46,106,81,30,56
99027,6556,273,6283,5704,26,43,82,23,36
99029,1785,91,1694,1517,4,33,14,1,10
99030,1131,33,1098,992,4,25,9,1,4
99031,1441,64,1377,1253,14,13,15,1,12
99032,773,18,755,676,7,10,4,0,2
99033,954,40,914,832,4,18,2,1,2
99034,327,2,325,299,1,4,0,0,4
99036,1579,48,1531,1406,4,3,8,1,7
99037,15907,976,14931,13132,200,142,470,83,86
99039,121,3,118,108,1,3,0,0,1
99040,825,27,798,63,1,679,2,0,2
99101,1517,48,1469,1335,5,17,5,1,1
99102,544,23,521,481,0,0,2,0,3
99103,495,14,481,445,2,1,2,0,1
99105,62,13,49,46,0,0,0,0,0
99109,5016,173,4843,4416,12,69,22,11,26
99110,1853,76,1777,1657,2,29,5,1,4
99111,4029,128,3901,3612,14,22,54,3,17
99113,722,10,712,669,5,0,7,0,1
99114,12649,495,12154,11071,30,164,85,23,53
99115,1227,58,1169,1100,4,8,9,0,8
99116,1476,74,1402,537,6,717,12,3,7
99117,472,19,453,397,0,15,6,0,7
99118,786,32,754,667,5,11,4,1,3
99119,1293,54,1239,980,4,158,2,0,8
99121,135,10,125,104,0,11,0,1,0
99122,3989,155,3834,3439,2,129,25,6,15
99123,1063,59,1004,806,1,109,6,2,3
99124,244,5,239,94,0,125,0,1,3
99125,495,22,473,429,1,8,6,1,5
99126,900,16,884,811,1,9,2,0,11
99128,315,10,305,290,1,4,1,0,0
99129,808,32,776,345,0,361,1,0,0
99130,805,29,776,721,2,6,4,1,0
99131,144,8,136,124,0,0,0,0,0
99133,1476,91,1385,1037,21,189,12,2,6
99134,598,25,573,533,0,6,5,0,6
99135,288,6,282,268,0,0,1,0,1
99136,24,2,22,21,0,0,0,0,0
99137,391,10,381,359,1,0,2,0,0
99138,1212,14,1198,282,3,854,8,0,0
99139,1178,57,1121,1039,4,22,1,0,5
99140,479,19,460,91,0,344,3,0,1
99141,5737,199,5538,4984,27,107,41,7,54
99143,602,20,582,547,2,4,3,0,2
99144,26,4,22,22,0,0,0,0,0
99146,81,1,80,73,0,0,0,2,1
99147,236,3,233,219,0,6,0,1,0
99148,2324,90,2234,2062,4,29,13,1,16
99149,219,3,216,197,0,7,0,1,0
99150,373,18,355,325,0,3,3,0,1
99151,215,13,202,184,0,5,1,0,1
99152,177,3,174,168,2,0,0,0,0
99153,499,10,489,451,0,14,2,0,1
99154,24,2,22,21,0,0,0,0,1
99155,1257,30,1227,90,0,1097,0,0,2
99156,8478,266,8212,7530,42,85,64,8,37
99157,683,24,659,595,5,10,3,0,10
99158,595,7,588,544,3,5,4,1,5
99159,1424,59,1365,1264,5,6,4,1,9
99160,86,0,86,73,0,3,0,0,1
99161,1450,35,1415,1326,4,9,6,0,3
99163,34416,3619,30797,23375,1113,166,3510,127,207
99166,3011,100,2911,2552,1,52,19,4,22
99167,794,22,772,704,6,6,12,0,2
99169,2487,156,2331,2142,7,22,14,0,21
99170,1135,52,1083,982,2,17,8,2,6
99171,975,24,951,885,9,4,8,2,3
99173,1892,81,1811,1518,12,91,19,3,29
99174,66,1,65,61,0,0,0,0,0
99176,169,5,164,159,1,2,0,0,0
99179,541,24,517,474,4,1,2,0,1
99180,926,38,888,738,3,89,2,1,4
99181,2057,79,1978,1808,5,31,6,5,21
99185,1374,35,1339,1208,1,46,9,6,8
99201,15716,1285,14431,11697,563,602,249,113,110
99202,21969,2093,19876,15368,906,470,872,501,122
99203,21072,989,20083,17950,203,111,390,37,117
99204,7000,543,6457,5342,260,84,179,93,50
99205,44036,2985,41051,35005,809,670,663,220,202
99206,39842,2712,37130,32452,699,381,595,260,171
99207,32059,2553,29506,23271,1042,775,852,710,167
99208,58531,3678,54853,46474,1129,658,1754,748,254
99212,21672,1388,20284,17634,418,218,397,109,131
99216,28379,2091,26288,22927,480,331,486,243,80
99217,19298,1224,18074,14988,402,240,813,243,84
99218,15591,891,14700,12662,263,135,340,133,71
99223,34201,1900,32301,27773,808,230,1091,79,172
99224,24085,1542,22543,19303,458,317,666,104,126
99251,1133,38,1095,832,50,14,85,27,1
99258,530,77,453,379,0,2,10,13,0
99301,85272,47023,38249,32278,1162,314,1639,192,327
99320,10215,2501,7714,6958,41,81,74,13,58
99321,669,600,69,58,3,0,0,0,0
99322,234,45,189,177,0,0,0,0,1
99323,3882,874,3008,2781,19,38,22,4,11
99324,10226,2173,8053,6970,163,44,181,54,68
99326,6277,2525,3752,2828,434,111,118,2,1
99328,3620,293,3327,3059,6,38,18,0,16
99329,206,14,192,169,1,5,0,0,2
99330,1061,402,659,608,7,4,6,0,3
99333,39,0,39,37,0,0,0,0,2
99335,240,36,204,188,0,1,1,0,2
99336,51127,18362,32765,27041,1075,319,1406,249,241
99337,33458,8759,24699,21936,273,231,519,72,131
99338,19117,2556,16561,14624,188,96,603,29,112
99341,788,97,691,624,1,5,9,0,14
99343,3206,2093,1113,1010,0,7,29,1,5
99344,18948,14236,4712,4283,15,43,110,6,55
99345,159,96,63,59,0,0,2,0,0
99346,345,140,205,197,0,2,1,0,0
99347,2342,112,2230,2099,3,18,10,0,7
99348,1685,982,703,638,5,9,15,0,3
99349,7960,6616,1344,1177,12,41,20,3,15
99350,13240,6131,7109,6378,59,67,150,13,51
99352,35762,4548,31214,26413,464,162,1914,81,178
99353,17934,2358,15576,13857,137,112,369,19,104
99354,24839,3456,21383,18051,381,108,1206,60,173
99356,290,97,193,184,0,0,0,0,0
99357,4240,3299,941,898,8,7,2,1,10
99359,155,5,150,135,0,3,1,0,1
99360,1428,355,1073,976,6,6,9,3,5
99361,1908,137,1771,1615,4,16,5,0,19
99362,43249,9614,33635,29484,781,303,687,73,172
99363,169,71,98,87,2,1,0,0,0
99371,346,24,322,300,1,2,2,0,5
99401,286,8,278,262,0,0,0,3,0
99402,1814,45,1769,1639,1,17,2,6,8
99403,20224,862,19362,17611,112,245,204,25,80
99501,18590,1732,16858,8974,1425,2272,1185,1098,171
99502,24183,1731,22452,13633,635,1814,2581,679,170
99503,13550,1477,12073,5596,860,1536,1831,798,74
99504,42375,3946,38429,18476,3465,4090,4806,2130,271
99505,4743,840,3903,2741,572,43,172,22,25
99506,6297,1090,5207,3792,607,65,259,53,24
99507,38199,3575,34624,19694,1372,3154,4991,945,216
99508,34394,3648,30746,13570,2505,3829,4067,2588,189
99513,0,0,0,0,0,0,0,0,0
99515,22532,2305,20227,12536,589,1490,2676,411,146
99516,21786,1217,20569,16206,289,774,1061,47,160
99517,16307,1166,15141,9399,432,1222,1778,503,95
99518,9861,999,8862,5054,408,773,958,432,65
99519,1533,218,1315,1097,46,88,25,22,7
99530,0,0,0,0,0,0,0,0,0
99540,336,24,312,246,2,20,6,0,2
99546,171,38,133,58,10,32,7,7,0
99547,53,0,53,0,1,50,0,0,0
99548,65,2,63,4,0,55,0,0,0
99549,100,1,99,14,0,79,0,0,0
99550,170,1,169,55,0,105,0,3,0
99551,677,3,674,26,1,639,0,0,0
99552,462,0,462,18,0,442,0,0,0
99553,1589,563,1026,146,266,57,499,11,6
99554,756,2,754,20,0,718,0,0,9
99555,211,4,207,38,0,131,2,0,0
99556,2877,101,2776,2386,10,104,38,0,27
99557,698,14,684,96,1,526,4,0,0
99558,70,0,70,3,0,62,0,0,0
99559,7985,153,7832,1208,75,5715,188,2,18
99561,506,2,504,17,0,458,0,0,0
99563,954,1,953,18,1,894,1,0,0
99564,97,5,92,19,0,58,3,0,0
99565,72,3,69,9,0,48,0,0,0
99566,259,7,252,179,0,42,4,0,6
99567,9036,523,8513,6709,62,400,219,13,91
99568,367,4,363,312,0,19,0,0,1
99569,69,0,69,6,0,62,0,0,0
99571,91,8,83,17,3,51,1,0,0
99572,345,6,339,314,1,0,5,0,0
99573,960,33,927,616,2,203,2,0,2
99574,2691,116,2575,1648,11,271,371,8,11
99575,90,1,89,1,0,85,0,0,0
99576,2647,114,2533,636,17,1498,41,9,7
99577,26947,2082,24865,19758,547,974,646,125,216
99578,404,5,399,6,0,366,0,0,0
99579,39,1,38,14,0,23,0,0,0
99580,111,7,104,9,1,89,1,0,0
99581,825,2,823,23,1,759,2,0,0
99583,394,41,353,175,18,23,109,5,1
99585,492,1,491,8,2,464,0,0,0
99586,469,18,451,238,0,174,2,0,0
99587,2167,92,2075,1885,8,26,48,0,7
99588,815,22,793,557,2,139,0,10,4
99589,258,1,257,13,0,233,0,0,0
99590,210,1,209,5,0,187,0,0,0
99591,67,2,65,2,0,60,0,0,0
99602,176,2,174,7,0,140,0,0,0
99603,10766,332,10434,8742,36,638,95,24,58
99604,1375,1,1374,23,2,1330,10,0,2
99605,176,1,175,156,0,11,0,0,0
99606,428,3,425,52,0,315,3,0,0
99607,212,1,211,15,0,182,0,0,0
99608,27,1,26,1,0,24,0,0,0
99609,623,0,623,21,1,597,0,0,0
99610,2261,47,2214,1861,6,113,20,5,21
99611,15827,718,15109,11471,96,1430,227,55,120
99612,757,43,714,208,10,324,109,6,0
99613,375,18,357,191,4,95,1,0,1
99614,704,2,702,15,2,680,0,0,0
99615,12495,1004,11491,6157,85,1342,2780,102,73
99620,655,0,655,1,0,653,0,0,0
99621,812,0,812,15,0,773,4,0,0
99622,380,1,379,3,0,369,0,0,0
99623,23878,1247,22631,17113,342,1997,396,134,164
99624,34,0,34,5,0,27,0,0,1
99625,69,0,69,1,0,65,0,0,0
99626,278,2,276,4,0,262,0,0,0
99627,305,7,298,104,3,173,0,0,0
99628,488,5,483,16,0,443,0,0,0
99630,206,1,205,9,0,193,0,0,0
99631,238,6,232,215,0,5,2,0,0
99632,621,0,621,19,6,585,3,0,1
99633,470,24,446,163,2,216,5,3,1
99634,358,0,358,14,2,325,1,0,0
99635,24,0,24,12,0,10,1,0,0
99636,512,6,506,24,1,457,0,0,0
99637,658,1,657,18,0,635,0,0,0
99638,39,4,35,6,0,27,0,0,1
99639,1072,32,1040,818,3,102,12,2,5
99640,122,3,119,10,0,102,0,0,0
99641,594,0,594,13,0,581,0,0,0
99643,216,6,210,22,0,176,1,2,0
99644,126,8,118,29,0,78,0,0,0
99645,28818,1370,27448,22215,275,1569,375,106,256
99647,43,0,43,20,0,21,0,0,0
99648,88,1,87,7,0,77,0,0,0
99649,74,1,73,11,0,53,0,0,0
99650,615,0,615,8,2,590,2,0,0
99651,55,1,54,1,0,46,0,0,0
99652,4821,155,4666,3797,33,323,41,56,25
99653,186,7,179,119,1,41,0,0,0
99654,40726,2254,38472,30633,378,2235,620,172,271
99655,776,3,773,13,0,730,0,0,0
99656,23,1,22,2,0,15,0,0,1
99657,425,0,425,10,0,398,1,0,0
99658,716,2,714,22,0,675,1,0,0
99659,456,3,453,25,3,410,0,0,0
99660,413,5,408,24,1,358,6,2,1
99661,579,17,562,106,0,342,53,10,3
99662,600,0,600,4,0,593,0,0,0
99663,451,16,435,292,1,60,6,0,6
99664,5155,253,4902,3669,115,525,107,27,16
99665,100,3,97,4,0,90,0,0,0
99666,217,1,216,2,2,203,0,0,0
99667,77,2,75,69,0,2,0,0,0
99668,95,2,93,13,1,62,0,0,0
99669,15531,678,14853,12296,82,867,234,42,92
99670,67,3,64,16,0,33,0,0,0
99671,634,5,629,31,2,577,0,0,0
99672,3503,114,3389,2965,10,106,42,14,26
99674,1650,49,1601,1290,5,104,15,1,19
99675,56,7,49,26,0,14,0,2,0
99676,1748,56,1692,1501,4,26,21,0,16
99677,90,0,90,12,0,74,0,0,0
99678,818,10,808,41,0,732,1,0,0
99679,444,1,443,13,0,416,0,0,0
99680,469,0,469,8,0,457,1,0,0
99681,411,1,410,11,0,389,0,0,0
99682,185,19,166,24,1,114,3,4,0
99683,576,18,558,474,1,36,3,0,1
99684,806,7,799,117,1,671,2,0,0
99685,3555,506,3049,1200,193,174,1088,190,5
99686,4007,269,3738,2925,33,301,103,30,14
99688,3077,49,3028,2600,16,141,25,1,27
99689,657,28,629,246,2,250,32,1,0
99690,306,0,306,8,0,294,0,0,0
99691,108,3,105,14,0,85,0,0,0
99692,699,88,611,126,28,8,395,31,3
99693,293,12,281,165,2,10,52,23,1
99694,1635,39,1596,1305,5,92,19,6,6
99695,1,0,1,0,0,0,0,0,0
99701,18357,1448,16909,9534,1258,2640,883,250,155
99702,2616,423,2193,1647,196,22,91,13,21
99703,8749,1791,6958,4865,927,69,330,110,51
99704,7,0,7,7,0,0,0,0,0
99705,22040,1334,20706,15818,515,1245,507,84,253
99706,24,1,23,1,0,20,0,0,0
99707,11,2,9,6,0,0,2,0,0
99709,28613,1620,26993,19491,782,2542,906,86,192
99712,13309,586,12723,10306,106,660,245,38,137
99714,1230,61,1169,1023,8,30,19,2,1
99720,192,0,192,21,0,163,1,0,0
99721,425,7,418,71,0,309,0,0,0
99722,151,0,151,6,0,140,0,0,0
99723,4934,173,4761,671,70,2593,591,286,6
99724,48,1,47,1,0,46,0,0,0
99725,261,5,256,238,0,12,0,0,0
99726,36,2,34,23,0,9,0,0,1
99727,550,2,548,6,2,524,1,0,0
99729,211,2,209,143,2,36,0,0,0
99730,101,1,100,55,0,39,0,1,0
99732,21,1,20,20,0,0,0,0,0
99733,91,0,91,7,0,84,0,0,0
99734,1035,116,919,784,24,59,12,13,11
99736,182,0,182,6,0,168,1,0,0
99737,4808,333,4475,3920,63,134,82,13,19
99738,172,2,170,133,0,30,0,0,0
99739,366,5,361,16,0,325,2,0,0
99740,428,3,425,34,0,359,0,0,0
99741,472,4,468,114,0,326,2,0,7
99742,640,4,636,19,1,614,1,0,0
99743,949,21,928,822,7,16,8,2,4
99744,170,3,167,147,0,5,0,0,0
99745,85,1,84,5,0,76,0,0,0
99746,304,4,300,13,0,275,0,0,0
99747,283,0,283,12,0,269,0,0,0
99748,158,0,158,11,0,132,0,0,0
99749,449,1,448,21,1,401,2,0,0
99750,444,1,443,8,0,434,0,0,0
99751,191,5,186,20,1,156,1,0,0
99752,3276,83,3193,524,63,2238,48,11,0
99753,312,4,308,12,1,277,2,0,0
99754,98,1,97,0,0,97,0,0,0
99755,217,4,213,200,0,1,2,1,0
99756,197,5,192,66,0,118,1,0,1
99757,30,5,25,18,1,2,0,0,0
99758,150,0,150,7,0,138,0,0,0
99759,330,1,329,19,0,304,0,0,0
99760,796,20,776,536,2,215,3,0,0
99761,570,2,568,25,1,531,0,0,0
99762,4143,136,4007,1065,33,2162,85,3,20
99763,694,0,694,15,0,672,0,0,0
99764,270,3,267,51,1,211,1,0,0
99765,239,4,235,17,0,167,2,0,0
99766,830,3,827,59,5,730,0,0,0
99767,57,0,57,6,0,44,0,0,0
99768,148,1,147,9,0,131,0,0,1
99769,835,5,830,18,1,803,3,0,0
99770,810,1,809,16,0,786,0,0,0
99771,212,1,211,20,4,185,0,0,0
99772,580,3,577,15,4,555,0,0,0
99773,272,1,271,6,0,259,0,0,0
99774,37,0,37,0,0,37,0,0,0
99775,402,28,374,217,12,76,42,1,3
99776,144,5,139,13,0,119,0,0,0
99777,246,4,242,41,0,194,1,0,0
99778,249,2,247,9,0,224,5,0,0
99780,1516,36,1480,879,5,374,12,0,7
99781,206,1,205,12,0,192,0,0,0
99782,628,3,625,21,4,599,0,0,0
99783,168,3,165,8,0,146,3,2,1
99784,185,0,185,12,0,171,0,0,0
99785,428,5,423,22,2,378,3,0,4
99786,274,2,272,17,3,236,0,0,0
99788,56,1,55,1,0,52,0,0,0
99789,512,0,512,35,1,474,0,0,0
99790,30,1,29,19,0,6,1,0,0
99791,276,1,275,21,1,240,0,0,0
99801,30088,1919,28169,18376,295,3164,2009,433,173
99820,364,26,338,26,0,269,6,1,4
99824,2111,142,1969,1279,31,223,74,36,7
99825,24,0,24,23,0,0,0,0,0
99826,657,18,639,555,1,36,0,0,4
99827,2165,68,2097,1586,2,272,14,2,8
99829,956,66,890,317,1,435,3,3,6
99830,545,8,537,64,2,414,3,2,1
99832,108,4,104,66,2,20,3,0,0
99833,3393,164,3229,2444,45,227,117,13,21
99835,8446,500,7946,5047,37,1202,573,14,53
99836,78,1,77,70,0,1,0,0,3
99840,1240,41,1199,1056,6,23,39,0,6
99841,122,3,119,99,2,4,1,0,2
99850,2,0,2,1,0,0,0,0,1
99901,13942,649,13293,8216,100,2264,1118,26,93
99903,48,1,47,20,0,7,0,0,0
99918,127,1,126,113,0,8,0,0,0
99919,515,12,503,422,3,35,0,5,1
99921,1626,60,1566,1117,4,247,13,1,8
99922,380,13,367,25,1,318,1,12,0
99923,66,2,64,59,0,0,0,0,3
99925,784,14,770,293,4,345,8,0,0
99926,1562,46,1516,151,4,1161,0,4,0
99927,49,2,47,42,0,0,0,1,0
99929,2079,75,2004,1321,0,361,25,2,11
